account_id,amount,payment_date,downpayment_amount,prev_account_id,global_amount,is_downpayment,prev_is_downpayment,downpayment,installments
003bd701,4999,1/30/2020,4999,,4999,equal to downpayment,,4999,0
0061e46b,9000,10/2/2019,9900,,9000,less than downpayment,,9000,0
0061e46b,900,10/4/2019,9900,0061e46b,9900,equal to downpayment,less than downpayment,900,0
00661fce,8900,1/17/2020,8900,,8900,equal to downpayment,,8900,0
00aok0H0,10000,9/17/2018,10000,,10000,equal to downpayment,,10000,0
00aok0H0,3000,10/17/2018,10000,00aok0H0,13000,more than downpayment,equal to downpayment,0,3000
00aok0H0,1500,10/18/2018,10000,00aok0H0,14500,more than downpayment,more than downpayment,0,1500
00aok0H0,4500,11/16/2018,10000,00aok0H0,19000,more than downpayment,more than downpayment,0,4500
00aok0H0,4500,12/18/2018,10000,00aok0H0,23500,more than downpayment,more than downpayment,0,4500
00aok0H0,4500,1/21/2019,10000,00aok0H0,28000,more than downpayment,more than downpayment,0,4500
00aok0H0,3000,3/11/2019,10000,00aok0H0,31000,more than downpayment,more than downpayment,0,3000
00cc3ce9,8000,9/30/2019,7900,,8000,more than downpayment,,7900,100
00cc3ce9,3500,12/1/2019,7900,00cc3ce9,11500,more than downpayment,more than downpayment,0,3500
00cc3ce9,1600,1/20/2020,7900,00cc3ce9,13100,more than downpayment,more than downpayment,0,1600
00cc3ce9,7000,1/27/2020,7900,00cc3ce9,20100,more than downpayment,more than downpayment,0,7000
0119d931,8900,12/23/2019,8900,,8900,equal to downpayment,,8900,0
012f09c9,150,1/25/2020,9900,,150,less than downpayment,,150,0
012f09c9,100,1/31/2020,9900,012f09c9,250,less than downpayment,less than downpayment,100,0
012f09c9,200,2/6/2020,9900,012f09c9,450,less than downpayment,less than downpayment,200,0
01GZZ1SG,10000,8/6/2017,10000,,10000,equal to downpayment,,10000,0
01GZZ1SG,3000,9/15/2017,10000,01GZZ1SG,13000,more than downpayment,equal to downpayment,0,3000
01GZZ1SG,3500,10/16/2017,10000,01GZZ1SG,16500,more than downpayment,more than downpayment,0,3500
01GZZ1SG,3500,11/15/2017,10000,01GZZ1SG,20000,more than downpayment,more than downpayment,0,3500
01GZZ1SG,3500,12/12/2017,10000,01GZZ1SG,23500,more than downpayment,more than downpayment,0,3500
01GZZ1SG,3500,1/16/2018,10000,01GZZ1SG,27000,more than downpayment,more than downpayment,0,3500
01GZZ1SG,4000,2/20/2018,10000,01GZZ1SG,31000,more than downpayment,more than downpayment,0,4000
01GZZ1SG,3500,3/15/2018,10000,01GZZ1SG,34500,more than downpayment,more than downpayment,0,3500
01GZZ1SG,3500,4/5/2018,10000,01GZZ1SG,38000,more than downpayment,more than downpayment,0,3500
01GZZ1SG,3500,5/18/2018,10000,01GZZ1SG,41500,more than downpayment,more than downpayment,0,3500
01GZZ1SG,3500,6/19/2018,10000,01GZZ1SG,45000,more than downpayment,more than downpayment,0,3500
0257ab67,4999,12/18/2019,4999,,4999,equal to downpayment,,4999,0
0283aef7,9900,10/16/2019,9900,,9900,equal to downpayment,,9900,0
0283aef7,4000,12/4/2019,9900,0283aef7,13900,more than downpayment,equal to downpayment,0,4000
0283aef7,4000,1/2/2020,9900,0283aef7,17900,more than downpayment,more than downpayment,0,4000
0283aef7,4000,2/5/2020,9900,0283aef7,21900,more than downpayment,more than downpayment,0,4000
02a24969,9900,11/26/2019,9900,,9900,equal to downpayment,,9900,0
033fbccf,9900,10/26/2019,8900,,9900,more than downpayment,,8900,1000
033fbccf,10000,11/21/2019,8900,033fbccf,19900,more than downpayment,more than downpayment,0,10000
043cf9a6,9900,10/2/2019,9900,,9900,equal to downpayment,,9900,0
043cf9a6,3900,11/16/2019,9900,043cf9a6,13800,more than downpayment,equal to downpayment,0,3900
043cf9a6,1500,12/15/2019,9900,043cf9a6,15300,more than downpayment,more than downpayment,0,1500
043cf9a6,2400,1/7/2020,9900,043cf9a6,17700,more than downpayment,more than downpayment,0,2400
043cf9a6,3900,1/16/2020,9900,043cf9a6,21600,more than downpayment,more than downpayment,0,3900
0459ac36,9900,9/25/2019,9900,,9900,equal to downpayment,,9900,0
0459ac36,3900,10/31/2019,9900,0459ac36,13800,more than downpayment,equal to downpayment,0,3900
0459ac36,3900,12/5/2019,9900,0459ac36,17700,more than downpayment,more than downpayment,0,3900
0459ac36,3200,1/6/2020,9900,0459ac36,20900,more than downpayment,more than downpayment,0,3200
0459ac36,700,1/23/2020,9900,0459ac36,21600,more than downpayment,more than downpayment,0,700
0459ac36,3900,2/6/2020,9900,0459ac36,25500,more than downpayment,more than downpayment,0,3900
046c3140,7900,11/18/2019,7900,,7900,equal to downpayment,,7900,0
046c3140,5000,1/2/2020,7900,046c3140,12900,more than downpayment,equal to downpayment,0,5000
046c3140,1200,1/30/2020,7900,046c3140,14100,more than downpayment,more than downpayment,0,1200
04dd4e46,8900,1/12/2020,9900,,8900,less than downpayment,,8900,0
052yV8nO,8900,12/20/2018,8900,,8900,equal to downpayment,,8900,0
052yV8nO,3900,1/31/2019,8900,052yV8nO,12800,more than downpayment,equal to downpayment,0,3900
052yV8nO,3900,3/22/2019,8900,052yV8nO,16700,more than downpayment,more than downpayment,0,3900
052yV8nO,7800,6/6/2019,8900,052yV8nO,24500,more than downpayment,more than downpayment,0,7800
052yV8nO,3900,6/24/2019,8900,052yV8nO,28400,more than downpayment,more than downpayment,0,3900
052yV8nO,15600,10/3/2019,8900,052yV8nO,44000,more than downpayment,more than downpayment,0,15600
052yV8nO,20000,11/28/2019,8900,052yV8nO,64000,more than downpayment,more than downpayment,0,20000
05694a45,23500,9/12/2019,23400,,23500,more than downpayment,,23400,100
05694a45,7300,11/7/2019,23400,05694a45,30800,more than downpayment,more than downpayment,0,7300
05694a45,7200,12/7/2019,23400,05694a45,38000,more than downpayment,more than downpayment,0,7200
05694a45,7300,1/8/2020,23400,05694a45,45300,more than downpayment,more than downpayment,0,7300
066e1815,9900,10/15/2019,9900,,9900,equal to downpayment,,9900,0
06923a80,9900,12/21/2019,9900,,9900,equal to downpayment,,9900,0
06ce4cfc,8900,9/19/2019,8900,,8900,equal to downpayment,,8900,0
06ce4cfc,4900,11/5/2019,8900,06ce4cfc,13800,more than downpayment,equal to downpayment,0,4900
06ce4cfc,3900,12/8/2019,8900,06ce4cfc,17700,more than downpayment,more than downpayment,0,3900
06ce4cfc,3900,1/10/2020,8900,06ce4cfc,21600,more than downpayment,more than downpayment,0,3900
06ce4cfc,3900,2/5/2020,8900,06ce4cfc,25500,more than downpayment,more than downpayment,0,3900
076c02ed,9900,12/19/2019,9900,,9900,equal to downpayment,,9900,0
0782ff87,1612,10/14/2019,1594,,1612,more than downpayment,,1594,18
0782ff87,3100,12/15/2019,1594,0782ff87,4712,more than downpayment,more than downpayment,0,3100
0782ff87,3100,1/15/2020,1594,0782ff87,7812,more than downpayment,more than downpayment,0,3100
0782ff87,3100,2/5/2020,1594,0782ff87,10912,more than downpayment,more than downpayment,0,3100
078bc6f4,4999,12/17/2019,4999,,4999,equal to downpayment,,4999,0
078bc6f4,3100,1/24/2020,4999,078bc6f4,8099,more than downpayment,equal to downpayment,0,3100
8280668,5000,9/27/2019,9900,,5000,less than downpayment,,5000,0
8280668,4900,9/30/2019,9900,8280668,9900,equal to downpayment,less than downpayment,4900,0
8280668,3900,11/22/2019,9900,8280668,13800,more than downpayment,equal to downpayment,0,3900
8280668,3900,12/9/2019,9900,8280668,17700,more than downpayment,more than downpayment,0,3900
8280668,3900,1/9/2020,9900,8280668,21600,more than downpayment,more than downpayment,0,3900
8280668,3900,2/9/2020,9900,8280668,25500,more than downpayment,more than downpayment,0,3900
0833d4e0,1594,10/14/2019,1594,,1594,equal to downpayment,,1594,0
08828fe4,8900,10/16/2019,8900,,8900,equal to downpayment,,8900,0
08828fe4,3900,11/27/2019,8900,08828fe4,12800,more than downpayment,equal to downpayment,0,3900
08828fe4,3900,1/7/2020,8900,08828fe4,16700,more than downpayment,more than downpayment,0,3900
08828fe4,3900,2/6/2020,8900,08828fe4,20600,more than downpayment,more than downpayment,0,3900
096ef9d7,8900,12/20/2019,8900,,8900,equal to downpayment,,8900,0
099cbc3f,23500,10/29/2019,23400,,23500,more than downpayment,,23400,100
099cbc3f,7300,12/19/2019,23400,099cbc3f,30800,more than downpayment,more than downpayment,0,7300
099cbc3f,7300,1/28/2020,23400,099cbc3f,38100,more than downpayment,more than downpayment,0,7300
0a1f401a,40000,12/5/2019,40000,,40000,equal to downpayment,,40000,0
0a1f401a,30000,1/10/2020,40000,0a1f401a,70000,more than downpayment,equal to downpayment,0,30000
0a1f401a,30000,2/7/2020,40000,0a1f401a,100000,more than downpayment,more than downpayment,0,30000
0a5711c3,7900,1/24/2020,7900,,7900,equal to downpayment,,7900,0
0aa439f9,1594,10/14/2019,1594,,1594,equal to downpayment,,1594,0
0aa439f9,3100,1/9/2020,1594,0aa439f9,4694,more than downpayment,equal to downpayment,0,3100
0aa439f9,3100,1/30/2020,1594,0aa439f9,7794,more than downpayment,more than downpayment,0,3100
0afb55e2,9900,10/31/2019,9900,,9900,equal to downpayment,,9900,0
0afb55e2,100,11/16/2019,9900,0afb55e2,10000,more than downpayment,equal to downpayment,0,100
0afb55e2,700,12/8/2019,9900,0afb55e2,10700,more than downpayment,more than downpayment,0,700
0afb55e2,2000,12/24/2019,9900,0afb55e2,12700,more than downpayment,more than downpayment,0,2000
0afb55e2,1200,1/16/2020,9900,0afb55e2,13900,more than downpayment,more than downpayment,0,1200
0afb55e2,1500,1/29/2020,9900,0afb55e2,15400,more than downpayment,more than downpayment,0,1500
0b10c3cf,9900,9/19/2019,9900,,9900,equal to downpayment,,9900,0
0b9f78a3,7900,11/15/2019,7900,,7900,equal to downpayment,,7900,0
0b9f78a3,3100,1/9/2020,7900,0b9f78a3,11000,more than downpayment,equal to downpayment,0,3100
0b9f78a3,3100,2/6/2020,7900,0b9f78a3,14100,more than downpayment,more than downpayment,0,3100
0b9fbf82,8900,1/4/2020,8900,,8900,equal to downpayment,,8900,0
0Bi0CuTh,8900,1/11/2019,8900,,8900,equal to downpayment,,8900,0
0Bi0CuTh,3900,2/21/2019,8900,0Bi0CuTh,12800,more than downpayment,equal to downpayment,0,3900
0Bi0CuTh,2000,5/10/2019,8900,0Bi0CuTh,14800,more than downpayment,more than downpayment,0,2000
0Bi0CuTh,1000,11/1/2019,8900,0Bi0CuTh,15800,more than downpayment,more than downpayment,0,1000
0Bi0CuTh,2900,11/4/2019,8900,0Bi0CuTh,18700,more than downpayment,more than downpayment,0,2900
0Bi0CuTh,2000,12/9/2019,8900,0Bi0CuTh,20700,more than downpayment,more than downpayment,0,2000
0BkSNx2w,9000,6/10/2019,8900,,9000,more than downpayment,,8900,100
0BkSNx2w,3900,8/4/2019,8900,0BkSNx2w,12900,more than downpayment,more than downpayment,0,3900
0BkSNx2w,3900,9/6/2019,8900,0BkSNx2w,16800,more than downpayment,more than downpayment,0,3900
0BkSNx2w,3900,10/7/2019,8900,0BkSNx2w,20700,more than downpayment,more than downpayment,0,3900
0BkSNx2w,3900,11/7/2019,8900,0BkSNx2w,24600,more than downpayment,more than downpayment,0,3900
0BkSNx2w,3900,12/12/2019,8900,0BkSNx2w,28500,more than downpayment,more than downpayment,0,3900
0c86510e,8900,10/4/2019,8900,,8900,equal to downpayment,,8900,0
0c86510e,3900,11/2/2019,8900,0c86510e,12800,more than downpayment,equal to downpayment,0,3900
0c86510e,3900,12/4/2019,8900,0c86510e,16700,more than downpayment,more than downpayment,0,3900
0c86510e,3900,1/5/2020,8900,0c86510e,20600,more than downpayment,more than downpayment,0,3900
0c86510e,3900,2/7/2020,8900,0c86510e,24500,more than downpayment,more than downpayment,0,3900
0cc57dda,5000,12/17/2019,8900,,5000,less than downpayment,,5000,0
0cc57dda,3900,12/20/2019,8900,0cc57dda,8900,equal to downpayment,less than downpayment,3900,0
0ccdb635,9900,2/7/2020,9900,,9900,equal to downpayment,,9900,0
0d4176db,7900,11/22/2019,7900,,7900,equal to downpayment,,7900,0
0d4176db,3100,2/4/2020,7900,0d4176db,11000,more than downpayment,equal to downpayment,0,3100
0d519b56,9900,9/16/2019,9900,,9900,equal to downpayment,,9900,0
0d519b56,3900,11/6/2019,9900,0d519b56,13800,more than downpayment,equal to downpayment,0,3900
0d519b56,2000,12/15/2019,9900,0d519b56,15800,more than downpayment,more than downpayment,0,2000
0d519b56,2000,1/9/2020,9900,0d519b56,17800,more than downpayment,more than downpayment,0,2000
0d519b56,1250,1/24/2020,9900,0d519b56,19050,more than downpayment,more than downpayment,0,1250
0d519b56,2550,2/3/2020,9900,0d519b56,21600,more than downpayment,more than downpayment,0,2550
0d519b56,200,2/5/2020,9900,0d519b56,21800,more than downpayment,more than downpayment,0,200
0de74165,9900,1/23/2020,9900,,9900,equal to downpayment,,9900,0
0deb7264,34000,10/3/2019,34000,,34000,equal to downpayment,,34000,0
0deb7264,8500,12/5/2019,34000,0deb7264,42500,more than downpayment,equal to downpayment,0,8500
0deb7264,8500,1/6/2020,34000,0deb7264,51000,more than downpayment,more than downpayment,0,8500
0deb7264,8500,2/4/2020,34000,0deb7264,59500,more than downpayment,more than downpayment,0,8500
0e0ZdO1M,9900,6/29/2019,9900,,9900,equal to downpayment,,9900,0
0e0ZdO1M,3900,8/20/2019,9900,0e0ZdO1M,13800,more than downpayment,equal to downpayment,0,3900
0e0ZdO1M,3900,9/23/2019,9900,0e0ZdO1M,17700,more than downpayment,more than downpayment,0,3900
0e0ZdO1M,3900,10/24/2019,9900,0e0ZdO1M,21600,more than downpayment,more than downpayment,0,3900
0e0ZdO1M,3900,11/29/2019,9900,0e0ZdO1M,25500,more than downpayment,more than downpayment,0,3900
0e0ZdO1M,3900,1/10/2020,9900,0e0ZdO1M,29400,more than downpayment,more than downpayment,0,3900
0e0ZdO1M,3900,1/27/2020,9900,0e0ZdO1M,33300,more than downpayment,more than downpayment,0,3900
0eb618c0,23400,12/19/2019,23400,,23400,equal to downpayment,,23400,0
0f00e0f8,9900,11/20/2019,9900,,9900,equal to downpayment,,9900,0
0f00e0f8,3900,12/31/2019,9900,0f00e0f8,13800,more than downpayment,equal to downpayment,0,3900
0f00e0f8,3900,2/1/2020,9900,0f00e0f8,17700,more than downpayment,more than downpayment,0,3900
0f09WcwK,9900,11/5/2018,9900,,9900,equal to downpayment,,9900,0
0f09WcwK,4500,12/24/2018,9900,0f09WcwK,14400,more than downpayment,equal to downpayment,0,4500
0f09WcwK,4500,1/28/2019,9900,0f09WcwK,18900,more than downpayment,more than downpayment,0,4500
0f09WcwK,4500,2/23/2019,9900,0f09WcwK,23400,more than downpayment,more than downpayment,0,4500
0f09WcwK,4500,3/28/2019,9900,0f09WcwK,27900,more than downpayment,more than downpayment,0,4500
0f09WcwK,4500,4/26/2019,9900,0f09WcwK,32400,more than downpayment,more than downpayment,0,4500
0f09WcwK,4500,5/29/2019,9900,0f09WcwK,36900,more than downpayment,more than downpayment,0,4500
0f09WcwK,4500,6/26/2019,9900,0f09WcwK,41400,more than downpayment,more than downpayment,0,4500
0f09WcwK,4500,7/26/2019,9900,0f09WcwK,45900,more than downpayment,more than downpayment,0,4500
0f09WcwK,4500,8/29/2019,9900,0f09WcwK,50400,more than downpayment,more than downpayment,0,4500
0f09WcwK,4500,9/26/2019,9900,0f09WcwK,54900,more than downpayment,more than downpayment,0,4500
0f09WcwK,9000,11/22/2019,9900,0f09WcwK,63900,more than downpayment,more than downpayment,0,9000
0f608a1d,9900,11/19/2019,9900,,9900,equal to downpayment,,9900,0
0f608a1d,4000,1/23/2020,9900,0f608a1d,13900,more than downpayment,equal to downpayment,0,4000
0ffefc6c,2000,11/14/2019,9900,,2000,less than downpayment,,2000,0
0ffefc6c,7900,12/31/2019,9900,0ffefc6c,9900,equal to downpayment,less than downpayment,7900,0
0JvxQp9J,9900,8/7/2019,9900,,9900,equal to downpayment,,9900,0
0JvxQp9J,4000,9/25/2019,9900,0JvxQp9J,13900,more than downpayment,equal to downpayment,0,4000
0JvxQp9J,4000,10/15/2019,9900,0JvxQp9J,17900,more than downpayment,more than downpayment,0,4000
0JvxQp9J,4000,11/15/2019,9900,0JvxQp9J,21900,more than downpayment,more than downpayment,0,4000
0JvxQp9J,4000,12/16/2019,9900,0JvxQp9J,25900,more than downpayment,more than downpayment,0,4000
0JvxQp9J,4000,1/17/2020,9900,0JvxQp9J,29900,more than downpayment,more than downpayment,0,4000
0MdhOtD5,9500,2/21/2019,8900,,9500,more than downpayment,,8900,600
0MdhOtD5,1000,3/6/2019,8900,0MdhOtD5,10500,more than downpayment,more than downpayment,0,1000
0MdhOtD5,3900,3/25/2019,8900,0MdhOtD5,14400,more than downpayment,more than downpayment,0,3900
0MdhOtD5,3900,4/23/2019,8900,0MdhOtD5,18300,more than downpayment,more than downpayment,0,3900
0MdhOtD5,3900,5/25/2019,8900,0MdhOtD5,22200,more than downpayment,more than downpayment,0,3900
0MdhOtD5,1000,6/28/2019,8900,0MdhOtD5,23200,more than downpayment,more than downpayment,0,1000
0MdhOtD5,2400,7/3/2019,8900,0MdhOtD5,25600,more than downpayment,more than downpayment,0,2400
0MdhOtD5,3900,7/22/2019,8900,0MdhOtD5,29500,more than downpayment,more than downpayment,0,3900
0MdhOtD5,3900,8/25/2019,8900,0MdhOtD5,33400,more than downpayment,more than downpayment,0,3900
0MdhOtD5,3900,9/26/2019,8900,0MdhOtD5,37300,more than downpayment,more than downpayment,0,3900
0MdhOtD5,1000,10/25/2019,8900,0MdhOtD5,38300,more than downpayment,more than downpayment,0,1000
0MdhOtD5,2900,10/27/2019,8900,0MdhOtD5,41200,more than downpayment,more than downpayment,0,2900
0MdhOtD5,3900,12/1/2019,8900,0MdhOtD5,45100,more than downpayment,more than downpayment,0,3900
0MdhOtD5,2800,1/7/2020,8900,0MdhOtD5,47900,more than downpayment,more than downpayment,0,2800
0MdhOtD5,3900,1/27/2020,8900,0MdhOtD5,51800,more than downpayment,more than downpayment,0,3900
0MENPd2A,8900,4/8/2019,8900,,8900,equal to downpayment,,8900,0
0MENPd2A,3900,5/16/2019,8900,0MENPd2A,12800,more than downpayment,equal to downpayment,0,3900
0MENPd2A,3900,6/13/2019,8900,0MENPd2A,16700,more than downpayment,more than downpayment,0,3900
0MENPd2A,3900,7/13/2019,8900,0MENPd2A,20600,more than downpayment,more than downpayment,0,3900
0MENPd2A,3900,8/26/2019,8900,0MENPd2A,24500,more than downpayment,more than downpayment,0,3900
0MENPd2A,3900,9/28/2019,8900,0MENPd2A,28400,more than downpayment,more than downpayment,0,3900
0MENPd2A,3900,10/17/2019,8900,0MENPd2A,32300,more than downpayment,more than downpayment,0,3900
0MENPd2A,3900,11/28/2019,8900,0MENPd2A,36200,more than downpayment,more than downpayment,0,3900
0MENPd2A,3900,12/26/2019,8900,0MENPd2A,40100,more than downpayment,more than downpayment,0,3900
0MENPd2A,3900,1/27/2020,8900,0MENPd2A,44000,more than downpayment,more than downpayment,0,3900
0NWOX9pZ,8900,7/23/2019,8900,,8900,equal to downpayment,,8900,0
0NWOX9pZ,3900,9/5/2019,8900,0NWOX9pZ,12800,more than downpayment,equal to downpayment,0,3900
0NWOX9pZ,3900,10/5/2019,8900,0NWOX9pZ,16700,more than downpayment,more than downpayment,0,3900
0NWOX9pZ,5000,12/3/2019,8900,0NWOX9pZ,21700,more than downpayment,more than downpayment,0,5000
0NWOX9pZ,3900,1/2/2020,8900,0NWOX9pZ,25600,more than downpayment,more than downpayment,0,3900
0NWOX9pZ,3900,2/4/2020,8900,0NWOX9pZ,29500,more than downpayment,more than downpayment,0,3900
0PD3IaMG,10000,8/24/2017,10000,,10000,equal to downpayment,,10000,0
0PD3IaMG,5000,9/7/2017,10000,0PD3IaMG,15000,more than downpayment,equal to downpayment,0,5000
0PD3IaMG,20000,9/20/2017,10000,0PD3IaMG,35000,more than downpayment,more than downpayment,0,20000
0PD3IaMG,5000,10/7/2017,10000,0PD3IaMG,40000,more than downpayment,more than downpayment,0,5000
0PD3IaMG,5000,11/1/2017,10000,0PD3IaMG,45000,more than downpayment,more than downpayment,0,5000
0Q2VYZ2h,10000,7/18/2017,10000,,10000,equal to downpayment,,10000,0
0Q2VYZ2h,3000,9/8/2017,10000,0Q2VYZ2h,13000,more than downpayment,equal to downpayment,0,3000
0Q2VYZ2h,5000,10/4/2017,10000,0Q2VYZ2h,18000,more than downpayment,more than downpayment,0,5000
0Q2VYZ2h,5000,10/31/2017,10000,0Q2VYZ2h,23000,more than downpayment,more than downpayment,0,5000
0Q2VYZ2h,7000,11/13/2017,10000,0Q2VYZ2h,30000,more than downpayment,more than downpayment,0,7000
0Q2VYZ2h,5000,12/15/2017,10000,0Q2VYZ2h,35000,more than downpayment,more than downpayment,0,5000
0Q2VYZ2h,5000,1/8/2018,10000,0Q2VYZ2h,40000,more than downpayment,more than downpayment,0,5000
0rnrKWXf,10000,1/7/2019,10000,,10000,equal to downpayment,,10000,0
0rnrKWXf,4500,2/8/2019,10000,0rnrKWXf,14500,more than downpayment,equal to downpayment,0,4500
0rnrKWXf,4500,3/6/2019,10000,0rnrKWXf,19000,more than downpayment,more than downpayment,0,4500
0rnrKWXf,4500,4/11/2019,10000,0rnrKWXf,23500,more than downpayment,more than downpayment,0,4500
0rnrKWXf,4500,5/10/2019,10000,0rnrKWXf,28000,more than downpayment,more than downpayment,0,4500
0rnrKWXf,4500,6/11/2019,10000,0rnrKWXf,32500,more than downpayment,more than downpayment,0,4500
0rnrKWXf,4500,7/4/2019,10000,0rnrKWXf,37000,more than downpayment,more than downpayment,0,4500
0rnrKWXf,4500,8/15/2019,10000,0rnrKWXf,41500,more than downpayment,more than downpayment,0,4500
0rnrKWXf,4500,9/13/2019,10000,0rnrKWXf,46000,more than downpayment,more than downpayment,0,4500
0rnrKWXf,4500,10/14/2019,10000,0rnrKWXf,50500,more than downpayment,more than downpayment,0,4500
0rnrKWXf,4500,11/14/2019,10000,0rnrKWXf,55000,more than downpayment,more than downpayment,0,4500
0rnrKWXf,4500,12/14/2019,10000,0rnrKWXf,59500,more than downpayment,more than downpayment,0,4500
0rnrKWXf,4500,1/14/2020,10000,0rnrKWXf,64000,more than downpayment,more than downpayment,0,4500
0T0vlaoz,9900,7/10/2019,9900,,9900,equal to downpayment,,9900,0
0T0vlaoz,4500,8/19/2019,9900,0T0vlaoz,14400,more than downpayment,equal to downpayment,0,4500
0T0vlaoz,4000,9/20/2019,9900,0T0vlaoz,18400,more than downpayment,more than downpayment,0,4000
0T0vlaoz,4000,10/20/2019,9900,0T0vlaoz,22400,more than downpayment,more than downpayment,0,4000
0T0vlaoz,3100,11/21/2019,9900,0T0vlaoz,25500,more than downpayment,more than downpayment,0,3100
0T0vlaoz,3900,12/13/2019,9900,0T0vlaoz,29400,more than downpayment,more than downpayment,0,3900
0T0vlaoz,3900,1/20/2020,9900,0T0vlaoz,33300,more than downpayment,more than downpayment,0,3900
0uJskTX7,30000,3/5/2019,8900,,30000,more than downpayment,,8900,21100
0uJskTX7,4000,8/26/2019,8900,0uJskTX7,34000,more than downpayment,more than downpayment,0,4000
0uJskTX7,3900,9/25/2019,8900,0uJskTX7,37900,more than downpayment,more than downpayment,0,3900
0uJskTX7,2000,10/25/2019,8900,0uJskTX7,39900,more than downpayment,more than downpayment,0,2000
0uJskTX7,2000,11/4/2019,8900,0uJskTX7,41900,more than downpayment,more than downpayment,0,2000
0uJskTX7,3900,12/1/2019,8900,0uJskTX7,45800,more than downpayment,more than downpayment,0,3900
0uJskTX7,1500,12/28/2019,8900,0uJskTX7,47300,more than downpayment,more than downpayment,0,1500
0uJskTX7,2400,12/29/2019,8900,0uJskTX7,49700,more than downpayment,more than downpayment,0,2400
0uOm7Xgv,12000,5/28/2019,8900,,12000,more than downpayment,,8900,3100
0uOm7Xgv,4100,8/6/2019,8900,0uOm7Xgv,16100,more than downpayment,more than downpayment,0,4100
0uOm7Xgv,4500,10/20/2019,8900,0uOm7Xgv,20600,more than downpayment,more than downpayment,0,4500
0uOm7Xgv,4500,12/12/2019,8900,0uOm7Xgv,25100,more than downpayment,more than downpayment,0,4500
0uOm7Xgv,8000,2/4/2020,8900,0uOm7Xgv,33100,more than downpayment,more than downpayment,0,8000
0vZ9dpt3,8900,11/20/2018,8900,,8900,equal to downpayment,,8900,0
0vZ9dpt3,3900,1/15/2019,8900,0vZ9dpt3,12800,more than downpayment,equal to downpayment,0,3900
0vZ9dpt3,3900,2/15/2019,8900,0vZ9dpt3,16700,more than downpayment,more than downpayment,0,3900
0vZ9dpt3,3900,3/15/2019,8900,0vZ9dpt3,20600,more than downpayment,more than downpayment,0,3900
0vZ9dpt3,3900,4/15/2019,8900,0vZ9dpt3,24500,more than downpayment,more than downpayment,0,3900
0vZ9dpt3,3900,5/13/2019,8900,0vZ9dpt3,28400,more than downpayment,more than downpayment,0,3900
0vZ9dpt3,3900,6/13/2019,8900,0vZ9dpt3,32300,more than downpayment,more than downpayment,0,3900
0vZ9dpt3,3900,7/16/2019,8900,0vZ9dpt3,36200,more than downpayment,more than downpayment,0,3900
0vZ9dpt3,3900,8/14/2019,8900,0vZ9dpt3,40100,more than downpayment,more than downpayment,0,3900
0vZ9dpt3,3900,9/18/2019,8900,0vZ9dpt3,44000,more than downpayment,more than downpayment,0,3900
0vZ9dpt3,3900,10/18/2019,8900,0vZ9dpt3,47900,more than downpayment,more than downpayment,0,3900
0vZ9dpt3,3900,11/16/2019,8900,0vZ9dpt3,51800,more than downpayment,more than downpayment,0,3900
0vZ9dpt3,3900,12/15/2019,8900,0vZ9dpt3,55700,more than downpayment,more than downpayment,0,3900
0vZ9dpt3,3900,1/31/2020,8900,0vZ9dpt3,59600,more than downpayment,more than downpayment,0,3900
0WsnUSSr,8900,2/8/2019,8900,,8900,equal to downpayment,,8900,0
0WsnUSSr,3900,3/16/2019,8900,0WsnUSSr,12800,more than downpayment,equal to downpayment,0,3900
0WsnUSSr,3900,4/16/2019,8900,0WsnUSSr,16700,more than downpayment,more than downpayment,0,3900
0WsnUSSr,3900,5/20/2019,8900,0WsnUSSr,20600,more than downpayment,more than downpayment,0,3900
0WsnUSSr,3900,6/14/2019,8900,0WsnUSSr,24500,more than downpayment,more than downpayment,0,3900
0WsnUSSr,3900,7/12/2019,8900,0WsnUSSr,28400,more than downpayment,more than downpayment,0,3900
0WsnUSSr,3900,8/26/2019,8900,0WsnUSSr,32300,more than downpayment,more than downpayment,0,3900
0WsnUSSr,7800,10/10/2019,8900,0WsnUSSr,40100,more than downpayment,more than downpayment,0,7800
0WsnUSSr,3900,11/4/2019,8900,0WsnUSSr,44000,more than downpayment,more than downpayment,0,3900
0WsnUSSr,3900,12/5/2019,8900,0WsnUSSr,47900,more than downpayment,more than downpayment,0,3900
0WsnUSSr,3900,1/3/2020,8900,0WsnUSSr,51800,more than downpayment,more than downpayment,0,3900
0WsnUSSr,3900,2/5/2020,8900,0WsnUSSr,55700,more than downpayment,more than downpayment,0,3900
0ynBpqi8,9900,9/6/2019,8900,,9900,more than downpayment,,8900,1000
0ynBpqi8,3900,10/7/2019,8900,0ynBpqi8,13800,more than downpayment,more than downpayment,0,3900
0ynBpqi8,3900,11/20/2019,8900,0ynBpqi8,17700,more than downpayment,more than downpayment,0,3900
0ynBpqi8,3900,12/28/2019,8900,0ynBpqi8,21600,more than downpayment,more than downpayment,0,3900
0ynBpqi8,3900,1/11/2020,8900,0ynBpqi8,25500,more than downpayment,more than downpayment,0,3900
0Zq4P4HF,8900,3/27/2019,8900,,8900,equal to downpayment,,8900,0
0Zq4P4HF,3900,4/24/2019,8900,0Zq4P4HF,12800,more than downpayment,equal to downpayment,0,3900
0Zq4P4HF,3900,5/25/2019,8900,0Zq4P4HF,16700,more than downpayment,more than downpayment,0,3900
0Zq4P4HF,3900,6/25/2019,8900,0Zq4P4HF,20600,more than downpayment,more than downpayment,0,3900
0Zq4P4HF,3900,7/25/2019,8900,0Zq4P4HF,24500,more than downpayment,more than downpayment,0,3900
0Zq4P4HF,3900,8/26/2019,8900,0Zq4P4HF,28400,more than downpayment,more than downpayment,0,3900
0Zq4P4HF,3900,9/25/2019,8900,0Zq4P4HF,32300,more than downpayment,more than downpayment,0,3900
0Zq4P4HF,3900,10/24/2019,8900,0Zq4P4HF,36200,more than downpayment,more than downpayment,0,3900
0Zq4P4HF,3900,11/26/2019,8900,0Zq4P4HF,40100,more than downpayment,more than downpayment,0,3900
0Zq4P4HF,3900,12/28/2019,8900,0Zq4P4HF,44000,more than downpayment,more than downpayment,0,3900
0Zq4P4HF,3900,1/27/2020,8900,0Zq4P4HF,47900,more than downpayment,more than downpayment,0,3900
10glv6zA,20000,11/20/2018,10000,,20000,more than downpayment,,10000,10000
10glv6zA,4400,11/26/2018,10000,10glv6zA,24400,more than downpayment,more than downpayment,0,4400
10glv6zA,4500,1/17/2019,10000,10glv6zA,28900,more than downpayment,more than downpayment,0,4500
10glv6zA,4500,2/7/2019,10000,10glv6zA,33400,more than downpayment,more than downpayment,0,4500
10glv6zA,4500,3/12/2019,10000,10glv6zA,37900,more than downpayment,more than downpayment,0,4500
10glv6zA,4500,4/11/2019,10000,10glv6zA,42400,more than downpayment,more than downpayment,0,4500
10glv6zA,4500,5/9/2019,10000,10glv6zA,46900,more than downpayment,more than downpayment,0,4500
10glv6zA,4500,6/20/2019,10000,10glv6zA,51400,more than downpayment,more than downpayment,0,4500
10glv6zA,4500,7/13/2019,10000,10glv6zA,55900,more than downpayment,more than downpayment,0,4500
10glv6zA,4500,8/9/2019,10000,10glv6zA,60400,more than downpayment,more than downpayment,0,4500
10glv6zA,4500,9/7/2019,10000,10glv6zA,64900,more than downpayment,more than downpayment,0,4500
10glv6zA,4500,10/5/2019,10000,10glv6zA,69400,more than downpayment,more than downpayment,0,4500
10glv6zA,5100,11/6/2019,10000,10glv6zA,74500,more than downpayment,more than downpayment,0,5100
1146dVSE,8900,8/29/2019,8900,,8900,equal to downpayment,,8900,0
1146dVSE,7800,10/25/2019,8900,1146dVSE,16700,more than downpayment,equal to downpayment,0,7800
1146dVSE,3915,11/25/2019,8900,1146dVSE,20615,more than downpayment,more than downpayment,0,3915
1146dVSE,3900,12/23/2019,8900,1146dVSE,24515,more than downpayment,more than downpayment,0,3900
1146dVSE,3900,1/24/2020,8900,1146dVSE,28415,more than downpayment,more than downpayment,0,3900
118c1341,8900,11/27/2019,8900,,8900,equal to downpayment,,8900,0
118c1341,3900,2/4/2020,8900,118c1341,12800,more than downpayment,equal to downpayment,0,3900
124dda57,8900,11/14/2019,8900,,8900,equal to downpayment,,8900,0
124DM364,8900,1/13/2020,8900,,8900,equal to downpayment,,8900,0
125N2R1K,3,12/22/2019,9900,,3,less than downpayment,,3,0
12762b61,1594,10/14/2019,1594,,1594,equal to downpayment,,1594,0
127O8H9S,9900,1/3/2020,9900,,9900,equal to downpayment,,9900,0
12AOUYBT,9900,10/31/2019,9900,,9900,equal to downpayment,,9900,0
12AOUYBT,50,11/11/2019,9900,12AOUYBT,9950,more than downpayment,equal to downpayment,0,50
12AOUYBT,940,12/4/2019,9900,12AOUYBT,10890,more than downpayment,more than downpayment,0,940
12AOUYBT,2910,12/5/2019,9900,12AOUYBT,13800,more than downpayment,more than downpayment,0,2910
12AOUYBT,3900,1/5/2020,9900,12AOUYBT,17700,more than downpayment,more than downpayment,0,3900
12BnDLtU,9900,11/7/2018,9900,,9900,equal to downpayment,,9900,0
12BnDLtU,4500,12/31/2018,9900,12BnDLtU,14400,more than downpayment,equal to downpayment,0,4500
12BnDLtU,4500,1/27/2019,9900,12BnDLtU,18900,more than downpayment,more than downpayment,0,4500
12BnDLtU,4500,2/27/2019,9900,12BnDLtU,23400,more than downpayment,more than downpayment,0,4500
12BnDLtU,4500,3/25/2019,9900,12BnDLtU,27900,more than downpayment,more than downpayment,0,4500
12BnDLtU,4500,4/26/2019,9900,12BnDLtU,32400,more than downpayment,more than downpayment,0,4500
12BnDLtU,4500,5/26/2019,9900,12BnDLtU,36900,more than downpayment,more than downpayment,0,4500
12BnDLtU,4500,6/26/2019,9900,12BnDLtU,41400,more than downpayment,more than downpayment,0,4500
12BnDLtU,4500,7/29/2019,9900,12BnDLtU,45900,more than downpayment,more than downpayment,0,4500
12BnDLtU,4500,8/27/2019,9900,12BnDLtU,50400,more than downpayment,more than downpayment,0,4500
12BnDLtU,4500,9/26/2019,9900,12BnDLtU,54900,more than downpayment,more than downpayment,0,4500
12BnDLtU,4500,10/26/2019,9900,12BnDLtU,59400,more than downpayment,more than downpayment,0,4500
12BnDLtU,4500,11/25/2019,9900,12BnDLtU,63900,more than downpayment,more than downpayment,0,4500
12BnDLtU,4500,12/28/2019,9900,12BnDLtU,68400,more than downpayment,more than downpayment,0,4500
12dbcfd0,9900,1/28/2020,9900,,9900,equal to downpayment,,9900,0
133f13a9,9900,12/27/2019,9900,,9900,equal to downpayment,,9900,0
13450a97,8900,12/6/2019,8900,,8900,equal to downpayment,,8900,0
13450a97,3900,2/4/2020,8900,13450a97,12800,more than downpayment,equal to downpayment,0,3900
13a75a5d,8900,11/11/2019,8900,,8900,equal to downpayment,,8900,0
13a75a5d,3900,12/20/2019,8900,13a75a5d,12800,more than downpayment,equal to downpayment,0,3900
13K8ARPN,9900,11/26/2019,9900,,9900,equal to downpayment,,9900,0
13K8ARPN,3900,2/4/2020,9900,13K8ARPN,13800,more than downpayment,equal to downpayment,0,3900
13NLVP9F,9900,11/22/2019,9900,,9900,equal to downpayment,,9900,0
13QXMWU7,10000,11/21/2019,9900,,10000,more than downpayment,,9900,100
13QXMWU7,3900,1/15/2020,9900,13QXMWU7,13900,more than downpayment,more than downpayment,0,3900
13QXMWU7,700,1/29/2020,9900,13QXMWU7,14600,more than downpayment,more than downpayment,0,700
13QXMWU7,500,2/8/2020,9900,13QXMWU7,15100,more than downpayment,more than downpayment,0,500
144e5007,9900,11/12/2019,9900,,9900,equal to downpayment,,9900,0
144e5007,1900,12/27/2019,9900,144e5007,11800,more than downpayment,equal to downpayment,0,1900
144e5007,1400,12/31/2019,9900,144e5007,13200,more than downpayment,more than downpayment,0,1400
144e5007,400,1/2/2020,9900,144e5007,13600,more than downpayment,more than downpayment,0,400
144e5007,250,1/14/2020,9900,144e5007,13850,more than downpayment,more than downpayment,0,250
14d95352,9900,12/9/2019,9900,,9900,equal to downpayment,,9900,0
14DTUCO5,9900,9/29/2019,9900,,9900,equal to downpayment,,9900,0
14DTUCO5,3900,11/7/2019,9900,14DTUCO5,13800,more than downpayment,equal to downpayment,0,3900
14DTUCO5,3900,12/4/2019,9900,14DTUCO5,17700,more than downpayment,more than downpayment,0,3900
14DTUCO5,2000,1/16/2020,9900,14DTUCO5,19700,more than downpayment,more than downpayment,0,2000
14DTUCO5,1900,1/22/2020,9900,14DTUCO5,21600,more than downpayment,more than downpayment,0,1900
14DTUCO5,3900,2/5/2020,9900,14DTUCO5,25500,more than downpayment,more than downpayment,0,3900
150546f7,9900,1/21/2020,9900,,9900,equal to downpayment,,9900,0
15722113,9900,1/21/2020,9900,,9900,equal to downpayment,,9900,0
15A8ABYH,9900,1/25/2020,9900,,9900,equal to downpayment,,9900,0
15HTJPFJ,9900,1/25/2020,9900,,9900,equal to downpayment,,9900,0
16196W7R,9900,9/26/2019,8900,,9900,more than downpayment,,8900,1000
16196W7R,3900,10/30/2019,8900,16196W7R,13800,more than downpayment,more than downpayment,0,3900
16196W7R,3900,11/28/2019,8900,16196W7R,17700,more than downpayment,more than downpayment,0,3900
16196W7R,3900,12/30/2019,8900,16196W7R,21600,more than downpayment,more than downpayment,0,3900
16196W7R,3900,1/30/2020,8900,16196W7R,25500,more than downpayment,more than downpayment,0,3900
16a035ed,8900,9/13/2019,8900,,8900,equal to downpayment,,8900,0
16a035ed,3900,11/1/2019,8900,16a035ed,12800,more than downpayment,equal to downpayment,0,3900
16a035ed,3900,12/4/2019,8900,16a035ed,16700,more than downpayment,more than downpayment,0,3900
16a035ed,3900,1/5/2020,8900,16a035ed,20600,more than downpayment,more than downpayment,0,3900
16a035ed,3900,2/5/2020,8900,16a035ed,24500,more than downpayment,more than downpayment,0,3900
16bba0bc,9900,12/21/2019,9900,,9900,equal to downpayment,,9900,0
16FDRPLC,9900,8/6/2019,9900,,9900,equal to downpayment,,9900,0
16FDRPLC,3400,10/15/2019,9900,16FDRPLC,13300,more than downpayment,equal to downpayment,0,3400
16FDRPLC,500,10/21/2019,9900,16FDRPLC,13800,more than downpayment,more than downpayment,0,500
16FDRPLC,3900,11/4/2019,9900,16FDRPLC,17700,more than downpayment,more than downpayment,0,3900
16FDRPLC,3900,12/3/2019,9900,16FDRPLC,21600,more than downpayment,more than downpayment,0,3900
16FDRPLC,3900,1/6/2020,9900,16FDRPLC,25500,more than downpayment,more than downpayment,0,3900
16FDRPLC,3900,2/4/2020,9900,16FDRPLC,29400,more than downpayment,more than downpayment,0,3900
175c9872,8900,10/8/2019,8900,,8900,equal to downpayment,,8900,0
175c9872,3900,10/24/2019,8900,175c9872,12800,more than downpayment,equal to downpayment,0,3900
175c9872,3900,11/6/2019,8900,175c9872,16700,more than downpayment,more than downpayment,0,3900
175c9872,3900,1/7/2020,8900,175c9872,20600,more than downpayment,more than downpayment,0,3900
175d8e46,1600,10/14/2019,1594,,1600,more than downpayment,,1594,6
175d8e46,3100,12/4/2019,1594,175d8e46,4700,more than downpayment,more than downpayment,0,3100
175d8e46,3100,1/3/2020,1594,175d8e46,7800,more than downpayment,more than downpayment,0,3100
175d8e46,3100,2/6/2020,1594,175d8e46,10900,more than downpayment,more than downpayment,0,3100
176f4549,9900,11/14/2019,9900,,9900,equal to downpayment,,9900,0
176f4549,3900,1/3/2020,9900,176f4549,13800,more than downpayment,equal to downpayment,0,3900
176f4549,3900,2/4/2020,9900,176f4549,17700,more than downpayment,more than downpayment,0,3900
178c20e1,1594,10/14/2019,1594,,1594,equal to downpayment,,1594,0
17NIWAYB,8900,8/8/2019,8900,,8900,equal to downpayment,,8900,0
17NIWAYB,4000,10/9/2019,8900,17NIWAYB,12900,more than downpayment,equal to downpayment,0,4000
182K7EXD,9900,12/2/2019,9900,,9900,equal to downpayment,,9900,0
182K7EXD,3900,2/3/2020,9900,182K7EXD,13800,more than downpayment,equal to downpayment,0,3900
184sO0th,10000,1/28/2019,10000,,10000,equal to downpayment,,10000,0
184sO0th,4500,2/25/2019,10000,184sO0th,14500,more than downpayment,equal to downpayment,0,4500
184sO0th,4500,3/27/2019,10000,184sO0th,19000,more than downpayment,more than downpayment,0,4500
184sO0th,4500,4/30/2019,10000,184sO0th,23500,more than downpayment,more than downpayment,0,4500
184sO0th,4500,5/27/2019,10000,184sO0th,28000,more than downpayment,more than downpayment,0,4500
184sO0th,4500,7/3/2019,10000,184sO0th,32500,more than downpayment,more than downpayment,0,4500
184sO0th,4500,7/31/2019,10000,184sO0th,37000,more than downpayment,more than downpayment,0,4500
184sO0th,4500,8/28/2019,10000,184sO0th,41500,more than downpayment,more than downpayment,0,4500
184sO0th,4500,9/27/2019,10000,184sO0th,46000,more than downpayment,more than downpayment,0,4500
184sO0th,4500,10/30/2019,10000,184sO0th,50500,more than downpayment,more than downpayment,0,4500
184sO0th,4500,11/27/2019,10000,184sO0th,55000,more than downpayment,more than downpayment,0,4500
184sO0th,4500,1/23/2020,10000,184sO0th,59500,more than downpayment,more than downpayment,0,4500
18dqBvey,10000,6/20/2017,10000,,10000,equal to downpayment,,10000,0
18dqBvey,35000,7/25/2017,10000,18dqBvey,45000,more than downpayment,equal to downpayment,0,35000
18NEVZGE,9900,12/27/2019,9900,,9900,equal to downpayment,,9900,0
196dbd51,9900,9/12/2019,9900,,9900,equal to downpayment,,9900,0
198f32d9,8900,12/3/2019,8900,,8900,equal to downpayment,,8900,0
198f32d9,3900,12/18/2019,8900,198f32d9,12800,more than downpayment,equal to downpayment,0,3900
198f32d9,7800,1/27/2020,8900,198f32d9,20600,more than downpayment,more than downpayment,0,7800
19AHO6FO,9900,12/22/2019,9900,,9900,equal to downpayment,,9900,0
19bfdfea,7900,10/12/2019,7900,,7900,equal to downpayment,,7900,0
19bfdfea,3100,11/23/2019,7900,19bfdfea,11000,more than downpayment,equal to downpayment,0,3100
19bfdfea,3100,12/23/2019,7900,19bfdfea,14100,more than downpayment,more than downpayment,0,3100
19bfdfea,3100,2/6/2020,7900,19bfdfea,17200,more than downpayment,more than downpayment,0,3100
19cef014,9900,11/27/2019,9900,,9900,equal to downpayment,,9900,0
19ERR2nP,8900,11/6/2018,8900,,8900,equal to downpayment,,8900,0
19ERR2nP,3900,12/4/2018,8900,19ERR2nP,12800,more than downpayment,equal to downpayment,0,3900
19ERR2nP,3900,12/29/2018,8900,19ERR2nP,16700,more than downpayment,more than downpayment,0,3900
19ERR2nP,3900,1/27/2019,8900,19ERR2nP,20600,more than downpayment,more than downpayment,0,3900
19ERR2nP,3900,3/4/2019,8900,19ERR2nP,24500,more than downpayment,more than downpayment,0,3900
19ERR2nP,3900,4/1/2019,8900,19ERR2nP,28400,more than downpayment,more than downpayment,0,3900
19ERR2nP,3900,4/29/2019,8900,19ERR2nP,32300,more than downpayment,more than downpayment,0,3900
19ERR2nP,3900,5/27/2019,8900,19ERR2nP,36200,more than downpayment,more than downpayment,0,3900
19ERR2nP,3900,7/4/2019,8900,19ERR2nP,40100,more than downpayment,more than downpayment,0,3900
19ERR2nP,3900,8/2/2019,8900,19ERR2nP,44000,more than downpayment,more than downpayment,0,3900
19ERR2nP,3900,9/1/2019,8900,19ERR2nP,47900,more than downpayment,more than downpayment,0,3900
19ERR2nP,3900,10/6/2019,8900,19ERR2nP,51800,more than downpayment,more than downpayment,0,3900
19ERR2nP,3900,11/4/2019,8900,19ERR2nP,55700,more than downpayment,more than downpayment,0,3900
19ERR2nP,3900,12/4/2019,8900,19ERR2nP,59600,more than downpayment,more than downpayment,0,3900
19ERR2nP,3900,12/25/2019,8900,19ERR2nP,63500,more than downpayment,more than downpayment,0,3900
19ERR2nP,3900,1/31/2020,8900,19ERR2nP,67400,more than downpayment,more than downpayment,0,3900
1A2BndTN,9900,12/27/2018,8900,,9900,more than downpayment,,8900,1000
1A2BndTN,2900,2/14/2019,8900,1A2BndTN,12800,more than downpayment,more than downpayment,0,2900
1A2BndTN,3900,3/15/2019,8900,1A2BndTN,16700,more than downpayment,more than downpayment,0,3900
1A2BndTN,3900,4/15/2019,8900,1A2BndTN,20600,more than downpayment,more than downpayment,0,3900
1A2BndTN,3900,5/15/2019,8900,1A2BndTN,24500,more than downpayment,more than downpayment,0,3900
1A2BndTN,3900,6/12/2019,8900,1A2BndTN,28400,more than downpayment,more than downpayment,0,3900
1A2BndTN,2900,7/15/2019,8900,1A2BndTN,31300,more than downpayment,more than downpayment,0,2900
1A2BndTN,700,7/20/2019,8900,1A2BndTN,32000,more than downpayment,more than downpayment,0,700
1A2BndTN,300,7/28/2019,8900,1A2BndTN,32300,more than downpayment,more than downpayment,0,300
1A2BndTN,3900,8/15/2019,8900,1A2BndTN,36200,more than downpayment,more than downpayment,0,3900
1A2BndTN,1500,9/15/2019,8900,1A2BndTN,37700,more than downpayment,more than downpayment,0,1500
1A2BndTN,1000,9/19/2019,8900,1A2BndTN,38700,more than downpayment,more than downpayment,0,1000
1A2BndTN,800,9/29/2019,8900,1A2BndTN,39500,more than downpayment,more than downpayment,0,800
1A2BndTN,600,10/4/2019,8900,1A2BndTN,40100,more than downpayment,more than downpayment,0,600
1A2BndTN,3900,10/14/2019,8900,1A2BndTN,44000,more than downpayment,more than downpayment,0,3900
1A2BndTN,3900,11/15/2019,8900,1A2BndTN,47900,more than downpayment,more than downpayment,0,3900
1A2BndTN,1200,12/15/2019,8900,1A2BndTN,49100,more than downpayment,more than downpayment,0,1200
1A2BndTN,1700,12/17/2019,8900,1A2BndTN,50800,more than downpayment,more than downpayment,0,1700
1A2BndTN,1000,12/24/2019,8900,1A2BndTN,51800,more than downpayment,more than downpayment,0,1000
1A2BndTN,2500,1/15/2020,8900,1A2BndTN,54300,more than downpayment,more than downpayment,0,2500
1A2BndTN,1000,1/22/2020,8900,1A2BndTN,55300,more than downpayment,more than downpayment,0,1000
1A2BndTN,100,2/2/2020,8900,1A2BndTN,55400,more than downpayment,more than downpayment,0,100
1A2BndTN,200,2/3/2020,8900,1A2BndTN,55600,more than downpayment,more than downpayment,0,200
1A2BndTN,100,2/4/2020,8900,1A2BndTN,55700,more than downpayment,more than downpayment,0,100
1a41a77c,1594,10/14/2019,1594,,1594,equal to downpayment,,1594,0
1a41a77c,3500,11/21/2019,1594,1a41a77c,5094,more than downpayment,equal to downpayment,0,3500
1a41a77c,4000,12/19/2019,1594,1a41a77c,9094,more than downpayment,more than downpayment,0,4000
1a41a77c,4000,1/24/2020,1594,1a41a77c,13094,more than downpayment,more than downpayment,0,4000
1a763aea,9900,1/3/2020,8900,,9900,more than downpayment,,8900,1000
1A8ov2Wm,10000,6/13/2017,10000,,10000,equal to downpayment,,10000,0
1A8ov2Wm,4000,8/13/2017,10000,1A8ov2Wm,14000,more than downpayment,equal to downpayment,0,4000
1A8ov2Wm,3000,2/18/2018,10000,1A8ov2Wm,17000,more than downpayment,more than downpayment,0,3000
1A8ov2Wm,2000,6/26/2018,10000,1A8ov2Wm,19000,more than downpayment,more than downpayment,0,2000
1A8ov2Wm,1000,11/30/2019,10000,1A8ov2Wm,20000,more than downpayment,more than downpayment,0,1000
1ad3d60f,10000,12/6/2019,9900,,10000,more than downpayment,,9900,100
1ae8fa14,10000,10/12/2019,9900,,10000,more than downpayment,,9900,100
1ae8fa14,4000,11/30/2019,9900,1ae8fa14,14000,more than downpayment,more than downpayment,0,4000
1ae8fa14,4000,12/13/2019,9900,1ae8fa14,18000,more than downpayment,more than downpayment,0,4000
1ae8fa14,4000,1/8/2020,9900,1ae8fa14,22000,more than downpayment,more than downpayment,0,4000
1AL1JP5E,1594,10/14/2019,1594,,1594,equal to downpayment,,1594,0
1AL1JP5E,3100,11/26/2019,1594,1AL1JP5E,4694,more than downpayment,equal to downpayment,0,3100
1AL1JP5E,3100,12/28/2019,1594,1AL1JP5E,7794,more than downpayment,more than downpayment,0,3100
1AL1JP5E,3100,1/30/2020,1594,1AL1JP5E,10894,more than downpayment,more than downpayment,0,3100
1AZ2VQYB,6000,6/10/2019,9900,,6000,less than downpayment,,6000,0
1AZ2VQYB,3900,6/11/2019,9900,1AZ2VQYB,9900,equal to downpayment,less than downpayment,3900,0
1AZ2VQYB,3900,8/6/2019,9900,1AZ2VQYB,13800,more than downpayment,equal to downpayment,0,3900
1AZ2VQYB,3900,9/5/2019,9900,1AZ2VQYB,17700,more than downpayment,more than downpayment,0,3900
1AZ2VQYB,3900,10/6/2019,9900,1AZ2VQYB,21600,more than downpayment,more than downpayment,0,3900
1AZ2VQYB,2000,11/12/2019,9900,1AZ2VQYB,23600,more than downpayment,more than downpayment,0,2000
1AZ2VQYB,1300,11/16/2019,9900,1AZ2VQYB,24900,more than downpayment,more than downpayment,0,1300
1AZ2VQYB,600,11/19/2019,9900,1AZ2VQYB,25500,more than downpayment,more than downpayment,0,600
1AZ2VQYB,1200,12/11/2019,9900,1AZ2VQYB,26700,more than downpayment,more than downpayment,0,1200
1AZ2VQYB,3000,12/17/2019,9900,1AZ2VQYB,29700,more than downpayment,more than downpayment,0,3000
1AZ2VQYB,1000,1/9/2020,9900,1AZ2VQYB,30700,more than downpayment,more than downpayment,0,1000
1AZ2VQYB,2900,1/13/2020,9900,1AZ2VQYB,33600,more than downpayment,more than downpayment,0,2900
1Azom6fq,8900,7/1/2019,8900,,8900,equal to downpayment,,8900,0
1Azom6fq,3900,8/30/2019,8900,1Azom6fq,12800,more than downpayment,equal to downpayment,0,3900
1Azom6fq,3900,10/3/2019,8900,1Azom6fq,16700,more than downpayment,more than downpayment,0,3900
1b8f2936,6900,10/16/2019,7900,,6900,less than downpayment,,6900,0
1b8f2936,1000,10/22/2019,7900,1b8f2936,7900,equal to downpayment,less than downpayment,1000,0
1b8f2936,1000,10/26/2019,7900,1b8f2936,8900,more than downpayment,equal to downpayment,0,1000
1b8f2936,650,11/3/2019,7900,1b8f2936,9550,more than downpayment,more than downpayment,0,650
1b8f2936,250,11/10/2019,7900,1b8f2936,9800,more than downpayment,more than downpayment,0,250
1b8f2936,150,11/18/2019,7900,1b8f2936,9950,more than downpayment,more than downpayment,0,150
1b8f2936,1050,11/24/2019,7900,1b8f2936,11000,more than downpayment,more than downpayment,0,1050
1b8f2936,500,12/2/2019,7900,1b8f2936,11500,more than downpayment,more than downpayment,0,500
1b8f2936,200,12/8/2019,7900,1b8f2936,11700,more than downpayment,more than downpayment,0,200
1b8f2936,300,12/30/2019,7900,1b8f2936,12000,more than downpayment,more than downpayment,0,300
1b8f2936,3450,1/31/2020,7900,1b8f2936,15450,more than downpayment,more than downpayment,0,3450
1b8f2936,1350,2/5/2020,7900,1b8f2936,16800,more than downpayment,more than downpayment,0,1350
1b8f2936,6200,2/9/2020,7900,1b8f2936,23000,more than downpayment,more than downpayment,0,6200
1BBOtO34,8900,3/16/2019,8900,,8900,equal to downpayment,,8900,0
1BBOtO34,3900,4/24/2019,8900,1BBOtO34,12800,more than downpayment,equal to downpayment,0,3900
1BBOtO34,3900,6/26/2019,8900,1BBOtO34,16700,more than downpayment,more than downpayment,0,3900
1BBOtO34,900,7/17/2019,8900,1BBOtO34,17600,more than downpayment,more than downpayment,0,900
1BBOtO34,3900,7/26/2019,8900,1BBOtO34,21500,more than downpayment,more than downpayment,0,3900
1BBOtO34,3900,9/27/2019,8900,1BBOtO34,25400,more than downpayment,more than downpayment,0,3900
1BBOtO34,1900,10/2/2019,8900,1BBOtO34,27300,more than downpayment,more than downpayment,0,1900
1BBOtO34,3900,11/21/2019,8900,1BBOtO34,31200,more than downpayment,more than downpayment,0,3900
1BBOtO34,3900,1/17/2020,8900,1BBOtO34,35100,more than downpayment,more than downpayment,0,3900
1BBOtO34,9800,1/22/2020,8900,1BBOtO34,44900,more than downpayment,more than downpayment,0,9800
1bdb541f,9900,1/27/2020,9900,,9900,equal to downpayment,,9900,0
1bdcc5b2,8900,10/9/2019,8900,,8900,equal to downpayment,,8900,0
1bdcc5b2,3900,11/25/2019,8900,1bdcc5b2,12800,more than downpayment,equal to downpayment,0,3900
1bdcc5b2,3900,12/19/2019,8900,1bdcc5b2,16700,more than downpayment,more than downpayment,0,3900
1bdcc5b2,3400,1/24/2020,8900,1bdcc5b2,20100,more than downpayment,more than downpayment,0,3400
1bdcc5b2,500,2/2/2020,8900,1bdcc5b2,20600,more than downpayment,more than downpayment,0,500
1bkTP88F,8900,4/18/2019,8900,,8900,equal to downpayment,,8900,0
1bkTP88F,3900,5/20/2019,8900,1bkTP88F,12800,more than downpayment,equal to downpayment,0,3900
1bkTP88F,3900,6/20/2019,8900,1bkTP88F,16700,more than downpayment,more than downpayment,0,3900
1bkTP88F,3900,7/24/2019,8900,1bkTP88F,20600,more than downpayment,more than downpayment,0,3900
1bkTP88F,3900,8/22/2019,8900,1bkTP88F,24500,more than downpayment,more than downpayment,0,3900
1bkTP88F,3900,9/24/2019,8900,1bkTP88F,28400,more than downpayment,more than downpayment,0,3900
1bkTP88F,3900,10/22/2019,8900,1bkTP88F,32300,more than downpayment,more than downpayment,0,3900
1bkTP88F,3900,11/21/2019,8900,1bkTP88F,36200,more than downpayment,more than downpayment,0,3900
1bkTP88F,3900,12/21/2019,8900,1bkTP88F,40100,more than downpayment,more than downpayment,0,3900
1bkTP88F,3900,1/20/2020,8900,1bkTP88F,44000,more than downpayment,more than downpayment,0,3900
1c1942ef,9900,10/30/2019,9900,,9900,equal to downpayment,,9900,0
1C26KJMX,9900,11/29/2019,9900,,9900,equal to downpayment,,9900,0
1C26KJMX,3900,2/6/2020,9900,1C26KJMX,13800,more than downpayment,equal to downpayment,0,3900
1c849098,10000,11/15/2019,9900,,10000,more than downpayment,,9900,100
1c849098,3900,12/27/2019,9900,1c849098,13900,more than downpayment,more than downpayment,0,3900
1c849098,4000,1/16/2020,9900,1c849098,17900,more than downpayment,more than downpayment,0,4000
1CCZGEBU,50000,7/24/2019,9900,,50000,more than downpayment,,9900,40100
1ce11520,8900,12/9/2019,8900,,8900,equal to downpayment,,8900,0
1ce11520,5000,1/6/2020,8900,1ce11520,13900,more than downpayment,equal to downpayment,0,5000
1D5PHDBG,9900,1/11/2020,9900,,9900,equal to downpayment,,9900,0
1dd452ab,50000,12/2/2019,9900,,50000,more than downpayment,,9900,40100
1DE9PYKY,8900,8/6/2019,8900,,8900,equal to downpayment,,8900,0
1DE9PYKY,9900,9/10/2019,8900,1DE9PYKY,18800,more than downpayment,equal to downpayment,0,9900
1DE9PYKY,3500,10/18/2019,8900,1DE9PYKY,22300,more than downpayment,more than downpayment,0,3500
1DE9PYKY,2200,12/30/2019,8900,1DE9PYKY,24500,more than downpayment,more than downpayment,0,2200
1DE9PYKY,1000,1/21/2020,8900,1DE9PYKY,25500,more than downpayment,more than downpayment,0,1000
1DE9PYKY,3200,1/24/2020,8900,1DE9PYKY,28700,more than downpayment,more than downpayment,0,3200
1e1191ec,1594,10/14/2019,1594,,1594,equal to downpayment,,1594,0
1e1191ec,3100,11/5/2019,1594,1e1191ec,4694,more than downpayment,equal to downpayment,0,3100
1e1191ec,3100,12/10/2019,1594,1e1191ec,7794,more than downpayment,more than downpayment,0,3100
1e1191ec,3100,1/16/2020,1594,1e1191ec,10894,more than downpayment,more than downpayment,0,3100
1e8750f5,34000,9/16/2019,9900,,34000,more than downpayment,,9900,24100
1ee0a496,9900,1/10/2020,9900,,9900,equal to downpayment,,9900,0
1eff04d4,8900,10/23/2019,8900,,8900,equal to downpayment,,8900,0
1eff04d4,3900,11/27/2019,8900,1eff04d4,12800,more than downpayment,equal to downpayment,0,3900
1eff04d4,3900,12/30/2019,8900,1eff04d4,16700,more than downpayment,more than downpayment,0,3900
1eff04d4,3900,1/29/2020,8900,1eff04d4,20600,more than downpayment,more than downpayment,0,3900
1EFRW4ER,9900,11/21/2019,9900,,9900,equal to downpayment,,9900,0
1EFRW4ER,3900,1/11/2020,9900,1EFRW4ER,13800,more than downpayment,equal to downpayment,0,3900
1EZTCMXF,8900,2/7/2020,8900,,8900,equal to downpayment,,8900,0
1F1L2YQQ,200,12/26/2019,9900,,200,less than downpayment,,200,0
1F1L2YQQ,900,12/28/2019,9900,1F1L2YQQ,1100,less than downpayment,less than downpayment,900,0
1F1L2YQQ,300,12/29/2019,9900,1F1L2YQQ,1400,less than downpayment,less than downpayment,300,0
1F1L2YQQ,200,1/2/2020,9900,1F1L2YQQ,1600,less than downpayment,less than downpayment,200,0
1F1L2YQQ,300,1/6/2020,9900,1F1L2YQQ,1900,less than downpayment,less than downpayment,300,0
1F1L2YQQ,380,1/9/2020,9900,1F1L2YQQ,2280,less than downpayment,less than downpayment,380,0
1F1L2YQQ,400,1/10/2020,9900,1F1L2YQQ,2680,less than downpayment,less than downpayment,400,0
1F1L2YQQ,400,1/13/2020,9900,1F1L2YQQ,3080,less than downpayment,less than downpayment,400,0
1F1L2YQQ,550,1/14/2020,9900,1F1L2YQQ,3630,less than downpayment,less than downpayment,550,0
1F1L2YQQ,500,1/15/2020,9900,1F1L2YQQ,4130,less than downpayment,less than downpayment,500,0
1F1L2YQQ,400,1/23/2020,9900,1F1L2YQQ,4530,less than downpayment,less than downpayment,400,0
1F1L2YQQ,500,1/25/2020,9900,1F1L2YQQ,5030,less than downpayment,less than downpayment,500,0
1F1L2YQQ,400,1/26/2020,9900,1F1L2YQQ,5430,less than downpayment,less than downpayment,400,0
1F1L2YQQ,2000,1/29/2020,9900,1F1L2YQQ,7430,less than downpayment,less than downpayment,2000,0
1F1L2YQQ,2475,1/31/2020,9900,1F1L2YQQ,9905,more than downpayment,less than downpayment,2470,5
1FJZMLHP,8900,1/21/2020,8900,,8900,equal to downpayment,,8900,0
1FXYJS3D,9900,10/14/2019,9900,,9900,equal to downpayment,,9900,0
1FXYJS3D,3900,12/2/2019,9900,1FXYJS3D,13800,more than downpayment,equal to downpayment,0,3900
1FXYJS3D,3900,1/4/2020,9900,1FXYJS3D,17700,more than downpayment,more than downpayment,0,3900
1FXYJS3D,3900,2/4/2020,9900,1FXYJS3D,21600,more than downpayment,more than downpayment,0,3900
1gJJfmmF,8900,5/21/2019,8900,,8900,equal to downpayment,,8900,0
1gJJfmmF,3900,6/16/2019,8900,1gJJfmmF,12800,more than downpayment,equal to downpayment,0,3900
1gJJfmmF,3900,7/22/2019,8900,1gJJfmmF,16700,more than downpayment,more than downpayment,0,3900
1gJJfmmF,3900,8/18/2019,8900,1gJJfmmF,20600,more than downpayment,more than downpayment,0,3900
1gJJfmmF,3900,9/17/2019,8900,1gJJfmmF,24500,more than downpayment,more than downpayment,0,3900
1gJJfmmF,3900,10/17/2019,8900,1gJJfmmF,28400,more than downpayment,more than downpayment,0,3900
1gJJfmmF,3900,11/16/2019,8900,1gJJfmmF,32300,more than downpayment,more than downpayment,0,3900
1gJJfmmF,3900,12/17/2019,8900,1gJJfmmF,36200,more than downpayment,more than downpayment,0,3900
1gJJfmmF,3900,1/19/2020,8900,1gJJfmmF,40100,more than downpayment,more than downpayment,0,3900
1GvHwgZF,8900,8/30/2019,8900,,8900,equal to downpayment,,8900,0
1GvHwgZF,1000,11/6/2019,8900,1GvHwgZF,9900,more than downpayment,equal to downpayment,0,1000
1GvHwgZF,2900,11/20/2019,8900,1GvHwgZF,12800,more than downpayment,more than downpayment,0,2900
1GvHwgZF,3900,12/4/2019,8900,1GvHwgZF,16700,more than downpayment,more than downpayment,0,3900
1GvHwgZF,3900,1/5/2020,8900,1GvHwgZF,20600,more than downpayment,more than downpayment,0,3900
1GvHwgZF,3900,2/5/2020,8900,1GvHwgZF,24500,more than downpayment,more than downpayment,0,3900
1gZUNrOn,9900,6/8/2019,8900,,9900,more than downpayment,,8900,1000
1gZUNrOn,3900,7/26/2019,8900,1gZUNrOn,13800,more than downpayment,more than downpayment,0,3900
1gZUNrOn,3900,9/5/2019,8900,1gZUNrOn,17700,more than downpayment,more than downpayment,0,3900
1gZUNrOn,3900,10/9/2019,8900,1gZUNrOn,21600,more than downpayment,more than downpayment,0,3900
1gZUNrOn,3900,11/5/2019,8900,1gZUNrOn,25500,more than downpayment,more than downpayment,0,3900
1gZUNrOn,3900,12/5/2019,8900,1gZUNrOn,29400,more than downpayment,more than downpayment,0,3900
1gZUNrOn,3900,1/5/2020,8900,1gZUNrOn,33300,more than downpayment,more than downpayment,0,3900
1gZUNrOn,3900,2/5/2020,8900,1gZUNrOn,37200,more than downpayment,more than downpayment,0,3900
1h4fw5No,8900,2/18/2019,8900,,8900,equal to downpayment,,8900,0
1h4fw5No,3900,3/25/2019,8900,1h4fw5No,12800,more than downpayment,equal to downpayment,0,3900
1h4fw5No,3900,4/25/2019,8900,1h4fw5No,16700,more than downpayment,more than downpayment,0,3900
1h4fw5No,3900,5/25/2019,8900,1h4fw5No,20600,more than downpayment,more than downpayment,0,3900
1h4fw5No,3900,6/29/2019,8900,1h4fw5No,24500,more than downpayment,more than downpayment,0,3900
1h4fw5No,3900,7/30/2019,8900,1h4fw5No,28400,more than downpayment,more than downpayment,0,3900
1h4fw5No,3900,9/3/2019,8900,1h4fw5No,32300,more than downpayment,more than downpayment,0,3900
1h4fw5No,3900,9/26/2019,8900,1h4fw5No,36200,more than downpayment,more than downpayment,0,3900
1h4fw5No,3900,10/29/2019,8900,1h4fw5No,40100,more than downpayment,more than downpayment,0,3900
1h4fw5No,3900,12/19/2019,8900,1h4fw5No,44000,more than downpayment,more than downpayment,0,3900
1h4fw5No,7800,2/3/2020,8900,1h4fw5No,51800,more than downpayment,more than downpayment,0,7800
1HKTX1RJ,9900,1/4/2020,9900,,9900,equal to downpayment,,9900,0
1HPG95JC,2000,6/30/2019,1999,,2000,more than downpayment,,1999,1
1HPG95JC,2000,8/6/2019,1999,1HPG95JC,4000,more than downpayment,more than downpayment,0,2000
1HPG95JC,2000,9/13/2019,1999,1HPG95JC,6000,more than downpayment,more than downpayment,0,2000
1HPG95JC,2000,11/1/2019,1999,1HPG95JC,8000,more than downpayment,more than downpayment,0,2000
1HPG95JC,1000,12/3/2019,1999,1HPG95JC,9000,more than downpayment,more than downpayment,0,1000
1HPG95JC,1500,12/18/2019,1999,1HPG95JC,10500,more than downpayment,more than downpayment,0,1500
1HPG95JC,2000,1/15/2020,1999,1HPG95JC,12500,more than downpayment,more than downpayment,0,2000
1IZKAkJb,8900,2/14/2019,8900,,8900,equal to downpayment,,8900,0
1IZKAkJb,3900,4/4/2019,8900,1IZKAkJb,12800,more than downpayment,equal to downpayment,0,3900
1IZKAkJb,3900,5/4/2019,8900,1IZKAkJb,16700,more than downpayment,more than downpayment,0,3900
1IZKAkJb,3900,6/4/2019,8900,1IZKAkJb,20600,more than downpayment,more than downpayment,0,3900
1IZKAkJb,3900,7/4/2019,8900,1IZKAkJb,24500,more than downpayment,more than downpayment,0,3900
1IZKAkJb,3900,8/4/2019,8900,1IZKAkJb,28400,more than downpayment,more than downpayment,0,3900
1IZKAkJb,3900,9/7/2019,8900,1IZKAkJb,32300,more than downpayment,more than downpayment,0,3900
1IZKAkJb,3900,10/11/2019,8900,1IZKAkJb,36200,more than downpayment,more than downpayment,0,3900
1IZKAkJb,3900,11/19/2019,8900,1IZKAkJb,40100,more than downpayment,more than downpayment,0,3900
1IZKAkJb,3900,12/24/2019,8900,1IZKAkJb,44000,more than downpayment,more than downpayment,0,3900
1IZKAkJb,3900,1/28/2020,8900,1IZKAkJb,47900,more than downpayment,more than downpayment,0,3900
1JB5HE8J,9900,12/20/2019,9900,,9900,equal to downpayment,,9900,0
1KBE14HW,2000,6/27/2019,1999,,2000,more than downpayment,,1999,1
1KBE14HW,2000,8/8/2019,1999,1KBE14HW,4000,more than downpayment,more than downpayment,0,2000
1KBE14HW,4000,9/26/2019,1999,1KBE14HW,8000,more than downpayment,more than downpayment,0,4000
1KBE14HW,4000,11/17/2019,1999,1KBE14HW,12000,more than downpayment,more than downpayment,0,4000
1KBE14HW,4000,12/10/2019,1999,1KBE14HW,16000,more than downpayment,more than downpayment,0,4000
1M9R7FXL,9900,6/7/2019,8900,,9900,more than downpayment,,8900,1000
1M9R7FXL,3900,7/5/2019,8900,1M9R7FXL,13800,more than downpayment,more than downpayment,0,3900
1M9R7FXL,3900,8/5/2019,8900,1M9R7FXL,17700,more than downpayment,more than downpayment,0,3900
1M9R7FXL,3900,9/4/2019,8900,1M9R7FXL,21600,more than downpayment,more than downpayment,0,3900
1M9R7FXL,3900,10/5/2019,8900,1M9R7FXL,25500,more than downpayment,more than downpayment,0,3900
1M9R7FXL,3900,11/4/2019,8900,1M9R7FXL,29400,more than downpayment,more than downpayment,0,3900
1M9R7FXL,3900,12/5/2019,8900,1M9R7FXL,33300,more than downpayment,more than downpayment,0,3900
1M9R7FXL,3900,1/5/2020,8900,1M9R7FXL,37200,more than downpayment,more than downpayment,0,3900
1M9R7FXL,3900,2/4/2020,8900,1M9R7FXL,41100,more than downpayment,more than downpayment,0,3900
1ng368cy,8900,5/3/2019,8900,,8900,equal to downpayment,,8900,0
1ng368cy,3900,6/25/2019,8900,1ng368cy,12800,more than downpayment,equal to downpayment,0,3900
1ng368cy,3900,7/25/2019,8900,1ng368cy,16700,more than downpayment,more than downpayment,0,3900
1ng368cy,3900,8/23/2019,8900,1ng368cy,20600,more than downpayment,more than downpayment,0,3900
1ng368cy,3900,9/24/2019,8900,1ng368cy,24500,more than downpayment,more than downpayment,0,3900
1ng368cy,3900,10/25/2019,8900,1ng368cy,28400,more than downpayment,more than downpayment,0,3900
1ng368cy,3900,11/25/2019,8900,1ng368cy,32300,more than downpayment,more than downpayment,0,3900
1ng368cy,3900,12/29/2019,8900,1ng368cy,36200,more than downpayment,more than downpayment,0,3900
1ng368cy,3900,1/30/2020,8900,1ng368cy,40100,more than downpayment,more than downpayment,0,3900
1NWYCDJZ,9900,12/16/2019,9900,,9900,equal to downpayment,,9900,0
1NWYCDJZ,4000,2/7/2020,9900,1NWYCDJZ,13900,more than downpayment,equal to downpayment,0,4000
1PSJNPUD,9900,11/18/2019,9900,,9900,equal to downpayment,,9900,0
1PSJNPUD,3900,1/15/2020,9900,1PSJNPUD,13800,more than downpayment,equal to downpayment,0,3900
1Q18oZPY,8900,12/21/2018,8900,,8900,equal to downpayment,,8900,0
1Q18oZPY,3900,1/5/2019,8900,1Q18oZPY,12800,more than downpayment,equal to downpayment,0,3900
1Q18oZPY,3900,2/18/2019,8900,1Q18oZPY,16700,more than downpayment,more than downpayment,0,3900
1Q18oZPY,3900,3/25/2019,8900,1Q18oZPY,20600,more than downpayment,more than downpayment,0,3900
1Q18oZPY,3900,4/24/2019,8900,1Q18oZPY,24500,more than downpayment,more than downpayment,0,3900
1Q18oZPY,3900,5/21/2019,8900,1Q18oZPY,28400,more than downpayment,more than downpayment,0,3900
1Q18oZPY,3900,6/28/2019,8900,1Q18oZPY,32300,more than downpayment,more than downpayment,0,3900
1Q18oZPY,3900,8/27/2019,8900,1Q18oZPY,36200,more than downpayment,more than downpayment,0,3900
1Q18oZPY,3900,10/2/2019,8900,1Q18oZPY,40100,more than downpayment,more than downpayment,0,3900
1Q18oZPY,7800,12/16/2019,8900,1Q18oZPY,47900,more than downpayment,more than downpayment,0,7800
1Q285qi6,8900,5/23/2019,8900,,8900,equal to downpayment,,8900,0
1Q285qi6,3900,7/23/2019,8900,1Q285qi6,12800,more than downpayment,equal to downpayment,0,3900
1Q285qi6,3900,8/26/2019,8900,1Q285qi6,16700,more than downpayment,more than downpayment,0,3900
1Q285qi6,3900,9/25/2019,8900,1Q285qi6,20600,more than downpayment,more than downpayment,0,3900
1Q285qi6,3900,10/28/2019,8900,1Q285qi6,24500,more than downpayment,more than downpayment,0,3900
1Q285qi6,3900,12/3/2019,8900,1Q285qi6,28400,more than downpayment,more than downpayment,0,3900
1Q285qi6,3900,1/2/2020,8900,1Q285qi6,32300,more than downpayment,more than downpayment,0,3900
1Q285qi6,3900,1/21/2020,8900,1Q285qi6,36200,more than downpayment,more than downpayment,0,3900
1qEJeqR9,8900,5/14/2019,8900,,8900,equal to downpayment,,8900,0
1qEJeqR9,3900,6/25/2019,8900,1qEJeqR9,12800,more than downpayment,equal to downpayment,0,3900
1qEJeqR9,3900,7/23/2019,8900,1qEJeqR9,16700,more than downpayment,more than downpayment,0,3900
1qEJeqR9,3900,8/24/2019,8900,1qEJeqR9,20600,more than downpayment,more than downpayment,0,3900
1qEJeqR9,3900,10/4/2019,8900,1qEJeqR9,24500,more than downpayment,more than downpayment,0,3900
1qEJeqR9,3900,10/20/2019,8900,1qEJeqR9,28400,more than downpayment,more than downpayment,0,3900
1qEJeqR9,3900,11/23/2019,8900,1qEJeqR9,32300,more than downpayment,more than downpayment,0,3900
1qEJeqR9,3900,12/30/2019,8900,1qEJeqR9,36200,more than downpayment,more than downpayment,0,3900
1qEJeqR9,3900,2/4/2020,8900,1qEJeqR9,40100,more than downpayment,more than downpayment,0,3900
1QMU5ODG,9900,6/14/2019,8900,,9900,more than downpayment,,8900,1000
1qPLuVEn,10000,9/2/2018,10000,,10000,equal to downpayment,,10000,0
1qPLuVEn,4500,10/20/2018,10000,1qPLuVEn,14500,more than downpayment,equal to downpayment,0,4500
1TMUZC1S,9900,7/31/2019,9900,,9900,equal to downpayment,,9900,0
1U7Q7B8B,3000,12/10/2019,9900,,3000,less than downpayment,,3000,0
1U7Q7B8B,2000,12/13/2019,9900,1U7Q7B8B,5000,less than downpayment,less than downpayment,2000,0
1U7Q7B8B,4900,12/20/2019,9900,1U7Q7B8B,9900,equal to downpayment,less than downpayment,4900,0
1ULJI68D,9900,11/13/2019,9900,,9900,equal to downpayment,,9900,0
1ULJI68D,3000,12/26/2019,9900,1ULJI68D,12900,more than downpayment,equal to downpayment,0,3000
1ULJI68D,900,1/7/2020,9900,1ULJI68D,13800,more than downpayment,more than downpayment,0,900
1ULJI68D,2000,2/1/2020,9900,1ULJI68D,15800,more than downpayment,more than downpayment,0,2000
1ULJI68D,1900,2/4/2020,9900,1ULJI68D,17700,more than downpayment,more than downpayment,0,1900
1vo6gpuH,8900,3/21/2019,8900,,8900,equal to downpayment,,8900,0
1vo6gpuH,3900,4/22/2019,8900,1vo6gpuH,12800,more than downpayment,equal to downpayment,0,3900
1vo6gpuH,3900,5/22/2019,8900,1vo6gpuH,16700,more than downpayment,more than downpayment,0,3900
1vo6gpuH,3900,6/21/2019,8900,1vo6gpuH,20600,more than downpayment,more than downpayment,0,3900
1vo6gpuH,3400,7/25/2019,8900,1vo6gpuH,24000,more than downpayment,more than downpayment,0,3400
1vo6gpuH,400,7/28/2019,8900,1vo6gpuH,24400,more than downpayment,more than downpayment,0,400
1vo6gpuH,100,7/30/2019,8900,1vo6gpuH,24500,more than downpayment,more than downpayment,0,100
1vo6gpuH,3900,8/25/2019,8900,1vo6gpuH,28400,more than downpayment,more than downpayment,0,3900
1vo6gpuH,3900,9/25/2019,8900,1vo6gpuH,32300,more than downpayment,more than downpayment,0,3900
1vo6gpuH,3900,11/3/2019,8900,1vo6gpuH,36200,more than downpayment,more than downpayment,0,3900
1vo6gpuH,3900,11/26/2019,8900,1vo6gpuH,40100,more than downpayment,more than downpayment,0,3900
1vo6gpuH,3900,1/7/2020,8900,1vo6gpuH,44000,more than downpayment,more than downpayment,0,3900
1vo6gpuH,3900,2/2/2020,8900,1vo6gpuH,47900,more than downpayment,more than downpayment,0,3900
1W6aFCnC,9900,1/11/2019,9900,,9900,equal to downpayment,,9900,0
1W6aFCnC,4500,2/22/2019,9900,1W6aFCnC,14400,more than downpayment,equal to downpayment,0,4500
1W6aFCnC,4500,3/23/2019,9900,1W6aFCnC,18900,more than downpayment,more than downpayment,0,4500
1W6aFCnC,4500,5/6/2019,9900,1W6aFCnC,23400,more than downpayment,more than downpayment,0,4500
1W6aFCnC,4500,6/4/2019,9900,1W6aFCnC,27900,more than downpayment,more than downpayment,0,4500
1W6aFCnC,4500,7/9/2019,9900,1W6aFCnC,32400,more than downpayment,more than downpayment,0,4500
1W6aFCnC,4500,8/6/2019,9900,1W6aFCnC,36900,more than downpayment,more than downpayment,0,4500
1W6aFCnC,4500,9/5/2019,9900,1W6aFCnC,41400,more than downpayment,more than downpayment,0,4500
1W6aFCnC,4500,10/5/2019,9900,1W6aFCnC,45900,more than downpayment,more than downpayment,0,4500
1W6aFCnC,9000,12/9/2019,9900,1W6aFCnC,54900,more than downpayment,more than downpayment,0,9000
1xd9JM5B,10000,2/6/2019,10000,,10000,equal to downpayment,,10000,0
1xd9JM5B,4500,3/4/2019,10000,1xd9JM5B,14500,more than downpayment,equal to downpayment,0,4500
1xd9JM5B,4500,4/5/2019,10000,1xd9JM5B,19000,more than downpayment,more than downpayment,0,4500
1xd9JM5B,4500,5/8/2019,10000,1xd9JM5B,23500,more than downpayment,more than downpayment,0,4500
1xd9JM5B,4500,6/6/2019,10000,1xd9JM5B,28000,more than downpayment,more than downpayment,0,4500
1xd9JM5B,4500,7/9/2019,10000,1xd9JM5B,32500,more than downpayment,more than downpayment,0,4500
1xd9JM5B,4500,8/13/2019,10000,1xd9JM5B,37000,more than downpayment,more than downpayment,0,4500
1xd9JM5B,4500,9/6/2019,10000,1xd9JM5B,41500,more than downpayment,more than downpayment,0,4500
1xd9JM5B,4500,11/22/2019,10000,1xd9JM5B,46000,more than downpayment,more than downpayment,0,4500
1xd9JM5B,4500,12/16/2019,10000,1xd9JM5B,50500,more than downpayment,more than downpayment,0,4500
1xd9JM5B,4500,1/8/2020,10000,1xd9JM5B,55000,more than downpayment,more than downpayment,0,4500
1xd9JM5B,4500,2/5/2020,10000,1xd9JM5B,59500,more than downpayment,more than downpayment,0,4500
1xENm7DM,8900,8/17/2019,8900,,8900,equal to downpayment,,8900,0
1xENm7DM,1000,9/5/2019,8900,1xENm7DM,9900,more than downpayment,equal to downpayment,0,1000
1xENm7DM,3900,10/26/2019,8900,1xENm7DM,13800,more than downpayment,more than downpayment,0,3900
1xENm7DM,2900,12/5/2019,8900,1xENm7DM,16700,more than downpayment,more than downpayment,0,2900
1xENm7DM,4900,12/17/2019,8900,1xENm7DM,21600,more than downpayment,more than downpayment,0,4900
1xENm7DM,3900,1/16/2020,8900,1xENm7DM,25500,more than downpayment,more than downpayment,0,3900
1YB224CT,10000,11/21/2019,9900,,10000,more than downpayment,,9900,100
1YB224CT,4000,2/2/2020,9900,1YB224CT,14000,more than downpayment,more than downpayment,0,4000
1YYNCA2D,9900,11/25/2019,9900,,9900,equal to downpayment,,9900,0
1ZDOOBS1,9900,12/30/2019,9900,,9900,equal to downpayment,,9900,0
1zewnIM5,10000,9/18/2017,10000,,10000,equal to downpayment,,10000,0
1zewnIM5,10000,10/12/2017,10000,1zewnIM5,20000,more than downpayment,equal to downpayment,0,10000
1zewnIM5,10000,10/13/2017,10000,1zewnIM5,30000,more than downpayment,more than downpayment,0,10000
1zewnIM5,15000,11/6/2017,10000,1zewnIM5,45000,more than downpayment,more than downpayment,0,15000
1zr8BLfu,10000,6/29/2019,9900,,10000,more than downpayment,,9900,100
1zr8BLfu,6000,8/1/2019,9900,1zr8BLfu,16000,more than downpayment,more than downpayment,0,6000
1zr8BLfu,3000,9/5/2019,9900,1zr8BLfu,19000,more than downpayment,more than downpayment,0,3000
1zr8BLfu,4000,10/4/2019,9900,1zr8BLfu,23000,more than downpayment,more than downpayment,0,4000
1zr8BLfu,3900,11/7/2019,9900,1zr8BLfu,26900,more than downpayment,more than downpayment,0,3900
1zr8BLfu,5000,12/25/2019,9900,1zr8BLfu,31900,more than downpayment,more than downpayment,0,5000
1zr8BLfu,1400,1/18/2020,9900,1zr8BLfu,33300,more than downpayment,more than downpayment,0,1400
1zr8BLfu,4000,2/6/2020,9900,1zr8BLfu,37300,more than downpayment,more than downpayment,0,4000
2012d059,7900,1/20/2020,7900,,7900,equal to downpayment,,7900,0
209d961a,23400,10/16/2019,23400,,23400,equal to downpayment,,23400,0
209d961a,7300,11/23/2019,23400,209d961a,30700,more than downpayment,equal to downpayment,0,7300
209d961a,7300,12/25/2019,23400,209d961a,38000,more than downpayment,more than downpayment,0,7300
209d961a,7300,1/23/2020,23400,209d961a,45300,more than downpayment,more than downpayment,0,7300
20e4fae3,9900,9/10/2019,9900,,9900,equal to downpayment,,9900,0
20e4fae3,3900,10/17/2019,9900,20e4fae3,13800,more than downpayment,equal to downpayment,0,3900
20e4fae3,3900,11/19/2019,9900,20e4fae3,17700,more than downpayment,more than downpayment,0,3900
20e4fae3,3900,12/19/2019,9900,20e4fae3,21600,more than downpayment,more than downpayment,0,3900
20e4fae3,3900,1/21/2020,9900,20e4fae3,25500,more than downpayment,more than downpayment,0,3900
20OVxNBX,10000,8/13/2018,10000,,10000,equal to downpayment,,10000,0
20OVxNBX,4500,9/1/2018,10000,20OVxNBX,14500,more than downpayment,equal to downpayment,0,4500
20OVxNBX,4500,9/29/2018,10000,20OVxNBX,19000,more than downpayment,more than downpayment,0,4500
20OVxNBX,4500,10/31/2018,10000,20OVxNBX,23500,more than downpayment,more than downpayment,0,4500
20OVxNBX,4500,12/1/2018,10000,20OVxNBX,28000,more than downpayment,more than downpayment,0,4500
20OVxNBX,4500,12/20/2018,10000,20OVxNBX,32500,more than downpayment,more than downpayment,0,4500
20OVxNBX,4500,1/31/2019,10000,20OVxNBX,37000,more than downpayment,more than downpayment,0,4500
20OVxNBX,4500,2/27/2019,10000,20OVxNBX,41500,more than downpayment,more than downpayment,0,4500
20OVxNBX,4500,3/30/2019,10000,20OVxNBX,46000,more than downpayment,more than downpayment,0,4500
20OVxNBX,4500,5/6/2019,10000,20OVxNBX,50500,more than downpayment,more than downpayment,0,4500
20OVxNBX,4500,5/30/2019,10000,20OVxNBX,55000,more than downpayment,more than downpayment,0,4500
20OVxNBX,4500,6/28/2019,10000,20OVxNBX,59500,more than downpayment,more than downpayment,0,4500
20OVxNBX,4500,7/31/2019,10000,20OVxNBX,64000,more than downpayment,more than downpayment,0,4500
2128f75f,8900,11/22/2019,8900,,8900,equal to downpayment,,8900,0
2128f75f,4000,1/24/2020,8900,2128f75f,12900,more than downpayment,equal to downpayment,0,4000
21e7a5e8,9900,11/26/2019,9900,,9900,equal to downpayment,,9900,0
21e7a5e8,3900,1/22/2020,9900,21e7a5e8,13800,more than downpayment,equal to downpayment,0,3900
21ZVIWUN,8900,9/11/2019,9900,,8900,less than downpayment,,8900,0
21ZVIWUN,1000,9/18/2019,9900,21ZVIWUN,9900,equal to downpayment,less than downpayment,1000,0
21ZVIWUN,3900,11/4/2019,9900,21ZVIWUN,13800,more than downpayment,equal to downpayment,0,3900
21ZVIWUN,3900,12/3/2019,9900,21ZVIWUN,17700,more than downpayment,more than downpayment,0,3900
21ZVIWUN,3900,12/31/2019,9900,21ZVIWUN,21600,more than downpayment,more than downpayment,0,3900
21ZVIWUN,3900,2/4/2020,9900,21ZVIWUN,25500,more than downpayment,more than downpayment,0,3900
222f87f1,15000,12/30/2019,4999,,15000,more than downpayment,,4999,10001
22715941,20600,2/5/2020,8900,,20600,more than downpayment,,8900,11700
22a52d36,9900,12/31/2019,9900,,9900,equal to downpayment,,9900,0
22C6IO85,9900,7/2/2019,9900,,9900,equal to downpayment,,9900,0
22C6IO85,3900,8/25/2019,9900,22C6IO85,13800,more than downpayment,equal to downpayment,0,3900
22C6IO85,3900,9/24/2019,9900,22C6IO85,17700,more than downpayment,more than downpayment,0,3900
22C6IO85,3900,10/24/2019,9900,22C6IO85,21600,more than downpayment,more than downpayment,0,3900
22C6IO85,3900,11/25/2019,9900,22C6IO85,25500,more than downpayment,more than downpayment,0,3900
22C6IO85,3900,12/24/2019,9900,22C6IO85,29400,more than downpayment,more than downpayment,0,3900
22C6IO85,3900,1/24/2020,9900,22C6IO85,33300,more than downpayment,more than downpayment,0,3900
22SPB43K,9900,10/21/2019,9900,,9900,equal to downpayment,,9900,0
22SPB43K,3900,12/4/2019,9900,22SPB43K,13800,more than downpayment,equal to downpayment,0,3900
22SPB43K,3900,12/31/2019,9900,22SPB43K,17700,more than downpayment,more than downpayment,0,3900
22SPB43K,3900,1/28/2020,9900,22SPB43K,21600,more than downpayment,more than downpayment,0,3900
23e12018,7000,11/18/2019,9900,,7000,less than downpayment,,7000,0
23e12018,2900,11/19/2019,9900,23e12018,9900,equal to downpayment,less than downpayment,2900,0
23e12018,5000,1/6/2020,9900,23e12018,14900,more than downpayment,equal to downpayment,0,5000
2428PZ8Z,7900,10/16/2019,7900,,7900,equal to downpayment,,7900,0
2428PZ8Z,3100,11/9/2019,7900,2428PZ8Z,11000,more than downpayment,equal to downpayment,0,3100
2428PZ8Z,3100,12/26/2019,7900,2428PZ8Z,14100,more than downpayment,more than downpayment,0,3100
2428PZ8Z,3100,1/22/2020,7900,2428PZ8Z,17200,more than downpayment,more than downpayment,0,3100
245099cb,5000,12/30/2019,4999,,5000,more than downpayment,,4999,1
247aa89e,9900,12/19/2019,9900,,9900,equal to downpayment,,9900,0
248VT5CG,5000,8/5/2019,9900,,5000,less than downpayment,,5000,0
248VT5CG,4900,8/22/2019,9900,248VT5CG,9900,equal to downpayment,less than downpayment,4900,0
248VT5CG,3900,11/8/2019,9900,248VT5CG,13800,more than downpayment,equal to downpayment,0,3900
248VT5CG,7800,12/25/2019,9900,248VT5CG,21600,more than downpayment,more than downpayment,0,7800
248VT5CG,3000,2/7/2020,9900,248VT5CG,24600,more than downpayment,more than downpayment,0,3000
24b7b489,9900,1/6/2020,8900,,9900,more than downpayment,,8900,1000
250b24d3,9900,12/25/2019,9900,,9900,equal to downpayment,,9900,0
25ZBRTE5,10000,7/29/2019,8900,,10000,more than downpayment,,8900,1100
25ZBRTE5,1000,7/30/2019,8900,25ZBRTE5,11000,more than downpayment,more than downpayment,0,1000
25ZBRTE5,4000,9/4/2019,8900,25ZBRTE5,15000,more than downpayment,more than downpayment,0,4000
25ZBRTE5,4000,10/5/2019,8900,25ZBRTE5,19000,more than downpayment,more than downpayment,0,4000
25ZBRTE5,4000,11/5/2019,8900,25ZBRTE5,23000,more than downpayment,more than downpayment,0,4000
25ZBRTE5,4000,11/29/2019,8900,25ZBRTE5,27000,more than downpayment,more than downpayment,0,4000
25ZBRTE5,4000,1/5/2020,8900,25ZBRTE5,31000,more than downpayment,more than downpayment,0,4000
25ZBRTE5,4000,2/5/2020,8900,25ZBRTE5,35000,more than downpayment,more than downpayment,0,4000
2615c60f,9900,1/13/2020,9900,,9900,equal to downpayment,,9900,0
26f27ef1,8900,1/28/2020,8900,,8900,equal to downpayment,,8900,0
27994ca7,12000,1/16/2020,9900,,12000,more than downpayment,,9900,2100
27a88ab8,8900,9/16/2019,8900,,8900,equal to downpayment,,8900,0
27a88ab8,7800,11/1/2019,8900,27a88ab8,16700,more than downpayment,equal to downpayment,0,7800
27a88ab8,7800,12/12/2019,8900,27a88ab8,24500,more than downpayment,more than downpayment,0,7800
27a88ab8,7800,1/20/2020,8900,27a88ab8,32300,more than downpayment,more than downpayment,0,7800
27b68121,9900,12/19/2019,9900,,9900,equal to downpayment,,9900,0
27b68121,3400,1/31/2020,9900,27b68121,13300,more than downpayment,equal to downpayment,0,3400
28678c79,8900,9/10/2019,8900,,8900,equal to downpayment,,8900,0
28678c79,3900,10/31/2019,8900,28678c79,12800,more than downpayment,equal to downpayment,0,3900
28678c79,3900,11/28/2019,8900,28678c79,16700,more than downpayment,more than downpayment,0,3900
28678c79,3900,12/25/2019,8900,28678c79,20600,more than downpayment,more than downpayment,0,3900
28678c79,3900,1/25/2020,8900,28678c79,24500,more than downpayment,more than downpayment,0,3900
28eb752a,10000,1/26/2020,8900,,10000,more than downpayment,,8900,1100
29c490d0,8900,10/25/2019,8900,,8900,equal to downpayment,,8900,0
29c490d0,3900,12/3/2019,8900,29c490d0,12800,more than downpayment,equal to downpayment,0,3900
29c490d0,3900,1/4/2020,8900,29c490d0,16700,more than downpayment,more than downpayment,0,3900
29c490d0,3900,2/4/2020,8900,29c490d0,20600,more than downpayment,more than downpayment,0,3900
29d782f8,9900,11/30/2019,9900,,9900,equal to downpayment,,9900,0
29d782f8,3900,1/5/2020,9900,29d782f8,13800,more than downpayment,equal to downpayment,0,3900
29d782f8,3900,2/6/2020,9900,29d782f8,17700,more than downpayment,more than downpayment,0,3900
29f0d233,1500,1/9/2020,9900,,1500,less than downpayment,,1500,0
29f0d233,4400,1/15/2020,9900,29f0d233,5900,less than downpayment,less than downpayment,4400,0
29f0d233,4000,1/16/2020,9900,29f0d233,9900,equal to downpayment,less than downpayment,4000,0
2a2bcfa4,8900,10/29/2019,8900,,8900,equal to downpayment,,8900,0
2a2bcfa4,3900,11/25/2019,8900,2a2bcfa4,12800,more than downpayment,equal to downpayment,0,3900
2a2bcfa4,3900,12/26/2019,8900,2a2bcfa4,16700,more than downpayment,more than downpayment,0,3900
2b055987,8900,11/22/2019,8900,,8900,equal to downpayment,,8900,0
2b055987,3900,2/4/2020,8900,2b055987,12800,more than downpayment,equal to downpayment,0,3900
2BADJRzU,10000,1/30/2019,10000,,10000,equal to downpayment,,10000,0
2BADJRzU,4500,3/4/2019,10000,2BADJRzU,14500,more than downpayment,equal to downpayment,0,4500
2BADJRzU,4500,4/4/2019,10000,2BADJRzU,19000,more than downpayment,more than downpayment,0,4500
2BADJRzU,4500,5/5/2019,10000,2BADJRzU,23500,more than downpayment,more than downpayment,0,4500
2BADJRzU,4500,6/3/2019,10000,2BADJRzU,28000,more than downpayment,more than downpayment,0,4500
2BADJRzU,4500,7/3/2019,10000,2BADJRzU,32500,more than downpayment,more than downpayment,0,4500
2BADJRzU,4500,8/5/2019,10000,2BADJRzU,37000,more than downpayment,more than downpayment,0,4500
2BADJRzU,4500,9/4/2019,10000,2BADJRzU,41500,more than downpayment,more than downpayment,0,4500
2BADJRzU,4500,10/4/2019,10000,2BADJRzU,46000,more than downpayment,more than downpayment,0,4500
2BADJRzU,4500,11/4/2019,10000,2BADJRzU,50500,more than downpayment,more than downpayment,0,4500
2BADJRzU,4500,12/3/2019,10000,2BADJRzU,55000,more than downpayment,more than downpayment,0,4500
2BADJRzU,4500,1/3/2020,10000,2BADJRzU,59500,more than downpayment,more than downpayment,0,4500
2BADJRzU,4500,1/30/2020,10000,2BADJRzU,64000,more than downpayment,more than downpayment,0,4500
2bdbd9b2,8900,11/30/2019,8900,,8900,equal to downpayment,,8900,0
2bdbd9b2,3900,2/3/2020,8900,2bdbd9b2,12800,more than downpayment,equal to downpayment,0,3900
2be52c71,4999,12/17/2019,4999,,4999,equal to downpayment,,4999,0
2be52c71,3100,2/5/2020,4999,2be52c71,8099,more than downpayment,equal to downpayment,0,3100
2BUL79ED,9900,1/9/2020,9900,,9900,equal to downpayment,,9900,0
2BV5LQFG,10000,6/2/2019,8900,,10000,more than downpayment,,8900,1100
2BV5LQFG,5000,7/22/2019,8900,2BV5LQFG,15000,more than downpayment,more than downpayment,0,5000
2BV5LQFG,5000,8/22/2019,8900,2BV5LQFG,20000,more than downpayment,more than downpayment,0,5000
2BV5LQFG,5000,9/22/2019,8900,2BV5LQFG,25000,more than downpayment,more than downpayment,0,5000
2BV5LQFG,5000,10/24/2019,8900,2BV5LQFG,30000,more than downpayment,more than downpayment,0,5000
2BV5LQFG,5000,11/24/2019,8900,2BV5LQFG,35000,more than downpayment,more than downpayment,0,5000
2BV5LQFG,5000,12/20/2019,8900,2BV5LQFG,40000,more than downpayment,more than downpayment,0,5000
2BV5LQFG,5000,1/23/2020,8900,2BV5LQFG,45000,more than downpayment,more than downpayment,0,5000
2BYLFIXS,13800,11/13/2019,9900,,13800,more than downpayment,,9900,3900
2ccddb80,10000,1/9/2020,9900,,10000,more than downpayment,,9900,100
2cf98495,9900,1/30/2020,9900,,9900,equal to downpayment,,9900,0
2cp64mGb,23500,8/7/2019,23400,,23500,more than downpayment,,23400,100
2cp64mGb,7300,8/31/2019,23400,2cp64mGb,30800,more than downpayment,more than downpayment,0,7300
2cp64mGb,7300,10/1/2019,23400,2cp64mGb,38100,more than downpayment,more than downpayment,0,7300
2cp64mGb,7300,11/6/2019,23400,2cp64mGb,45400,more than downpayment,more than downpayment,0,7300
2cp64mGb,7300,12/18/2019,23400,2cp64mGb,52700,more than downpayment,more than downpayment,0,7300
2cp64mGb,7300,12/27/2019,23400,2cp64mGb,60000,more than downpayment,more than downpayment,0,7300
2cp64mGb,7300,2/5/2020,23400,2cp64mGb,67300,more than downpayment,more than downpayment,0,7300
2da0bbd9,9900,10/11/2019,9900,,9900,equal to downpayment,,9900,0
2da0bbd9,3900,12/16/2019,9900,2da0bbd9,13800,more than downpayment,equal to downpayment,0,3900
2da0bbd9,3900,1/6/2020,9900,2da0bbd9,17700,more than downpayment,more than downpayment,0,3900
2da0bbd9,3900,1/31/2020,9900,2da0bbd9,21600,more than downpayment,more than downpayment,0,3900
2dc75057,5000,12/23/2019,4999,,5000,more than downpayment,,4999,1
2ddFNGeG,8900,11/28/2018,8900,,8900,equal to downpayment,,8900,0
2ddFNGeG,3900,12/24/2018,8900,2ddFNGeG,12800,more than downpayment,equal to downpayment,0,3900
2ddFNGeG,3900,1/25/2019,8900,2ddFNGeG,16700,more than downpayment,more than downpayment,0,3900
2ddFNGeG,11700,4/30/2019,8900,2ddFNGeG,28400,more than downpayment,more than downpayment,0,11700
2ddFNGeG,500,8/18/2019,8900,2ddFNGeG,28900,more than downpayment,more than downpayment,0,500
2ddFNGeG,7300,8/29/2019,8900,2ddFNGeG,36200,more than downpayment,more than downpayment,0,7300
2ddFNGeG,11700,11/8/2019,8900,2ddFNGeG,47900,more than downpayment,more than downpayment,0,11700
2ddFNGeG,1800,1/31/2020,8900,2ddFNGeG,49700,more than downpayment,more than downpayment,0,1800
2dmNUNwo,13730,2/28/2019,8900,,13730,more than downpayment,,8900,4830
2dmNUNwo,3900,3/23/2019,8900,2dmNUNwo,17630,more than downpayment,more than downpayment,0,3900
2dmNUNwo,3900,4/23/2019,8900,2dmNUNwo,21530,more than downpayment,more than downpayment,0,3900
2dmNUNwo,3900,5/23/2019,8900,2dmNUNwo,25430,more than downpayment,more than downpayment,0,3900
2dmNUNwo,3900,6/21/2019,8900,2dmNUNwo,29330,more than downpayment,more than downpayment,0,3900
2dmNUNwo,3900,7/26/2019,8900,2dmNUNwo,33230,more than downpayment,more than downpayment,0,3900
2dmNUNwo,3900,8/30/2019,8900,2dmNUNwo,37130,more than downpayment,more than downpayment,0,3900
2dmNUNwo,3900,9/26/2019,8900,2dmNUNwo,41030,more than downpayment,more than downpayment,0,3900
2dmNUNwo,3900,10/26/2019,8900,2dmNUNwo,44930,more than downpayment,more than downpayment,0,3900
2dmNUNwo,3900,1/30/2020,8900,2dmNUNwo,48830,more than downpayment,more than downpayment,0,3900
2e12c878,9900,1/10/2020,9900,,9900,equal to downpayment,,9900,0
2E27W8BK,9900,1/13/2020,9900,,9900,equal to downpayment,,9900,0
2e734429,9000,11/9/2019,9900,,9000,less than downpayment,,9000,0
2e734429,900,11/11/2019,9900,2e734429,9900,equal to downpayment,less than downpayment,900,0
2e734429,3000,1/10/2020,9900,2e734429,12900,more than downpayment,equal to downpayment,0,3000
2e734429,900,1/14/2020,9900,2e734429,13800,more than downpayment,more than downpayment,0,900
2f4d8d1e,9900,12/16/2019,8900,,9900,more than downpayment,,8900,1000
2f4d8d1e,3900,2/5/2020,8900,2f4d8d1e,13800,more than downpayment,more than downpayment,0,3900
2f80ef67,9900,11/14/2019,9900,,9900,equal to downpayment,,9900,0
2f80ef67,3900,1/21/2020,9900,2f80ef67,13800,more than downpayment,equal to downpayment,0,3900
2fb77626,23500,10/29/2019,23400,,23500,more than downpayment,,23400,100
2fb77626,7300,12/20/2019,23400,2fb77626,30800,more than downpayment,more than downpayment,0,7300
2fb77626,7300,1/28/2020,23400,2fb77626,38100,more than downpayment,more than downpayment,0,7300
2h9duAht,8900,12/11/2018,8900,,8900,equal to downpayment,,8900,0
2h9duAht,10,1/5/2019,8900,2h9duAht,8910,more than downpayment,equal to downpayment,0,10
2h9duAht,500,1/8/2019,8900,2h9duAht,9410,more than downpayment,more than downpayment,0,500
2h9duAht,6000,1/14/2019,8900,2h9duAht,15410,more than downpayment,more than downpayment,0,6000
2h9duAht,1000,1/31/2019,8900,2h9duAht,16410,more than downpayment,more than downpayment,0,1000
2h9duAht,2000,2/3/2019,8900,2h9duAht,18410,more than downpayment,more than downpayment,0,2000
2h9duAht,1000,2/12/2019,8900,2h9duAht,19410,more than downpayment,more than downpayment,0,1000
2h9duAht,2000,2/20/2019,8900,2h9duAht,21410,more than downpayment,more than downpayment,0,2000
2h9duAht,10,3/1/2019,8900,2h9duAht,21420,more than downpayment,more than downpayment,0,10
2h9duAht,2300,3/13/2019,8900,2h9duAht,23720,more than downpayment,more than downpayment,0,2300
2h9duAht,1000,3/14/2019,8900,2h9duAht,24720,more than downpayment,more than downpayment,0,1000
2h9duAht,2920,4/15/2019,8900,2h9duAht,27640,more than downpayment,more than downpayment,0,2920
2h9duAht,30,4/24/2019,8900,2h9duAht,27670,more than downpayment,more than downpayment,0,30
2h9duAht,1399,4/28/2019,8900,2h9duAht,29069,more than downpayment,more than downpayment,0,1399
2h9duAht,450,5/5/2019,8900,2h9duAht,29519,more than downpayment,more than downpayment,0,450
2h9duAht,1000,5/15/2019,8900,2h9duAht,30519,more than downpayment,more than downpayment,0,1000
2h9duAht,800,5/21/2019,8900,2h9duAht,31319,more than downpayment,more than downpayment,0,800
2h9duAht,380,5/22/2019,8900,2h9duAht,31699,more than downpayment,more than downpayment,0,380
2h9duAht,524,5/24/2019,8900,2h9duAht,32223,more than downpayment,more than downpayment,0,524
2h9duAht,527,5/25/2019,8900,2h9duAht,32750,more than downpayment,more than downpayment,0,527
2h9duAht,1000,5/28/2019,8900,2h9duAht,33750,more than downpayment,more than downpayment,0,1000
2h9duAht,500,6/4/2019,8900,2h9duAht,34250,more than downpayment,more than downpayment,0,500
2h9duAht,460,6/6/2019,8900,2h9duAht,34710,more than downpayment,more than downpayment,0,460
2h9duAht,2000,6/22/2019,8900,2h9duAht,36710,more than downpayment,more than downpayment,0,2000
2h9duAht,400,6/26/2019,8900,2h9duAht,37110,more than downpayment,more than downpayment,0,400
2h9duAht,300,6/28/2019,8900,2h9duAht,37410,more than downpayment,more than downpayment,0,300
2h9duAht,1000,7/3/2019,8900,2h9duAht,38410,more than downpayment,more than downpayment,0,1000
2h9duAht,1000,7/12/2019,8900,2h9duAht,39410,more than downpayment,more than downpayment,0,1000
2h9duAht,1000,7/20/2019,8900,2h9duAht,40410,more than downpayment,more than downpayment,0,1000
2h9duAht,1000,7/30/2019,8900,2h9duAht,41410,more than downpayment,more than downpayment,0,1000
2h9duAht,200,11/8/2019,8900,2h9duAht,41610,more than downpayment,more than downpayment,0,200
2h9duAht,500,11/16/2019,8900,2h9duAht,42110,more than downpayment,more than downpayment,0,500
2h9duAht,230,12/1/2019,8900,2h9duAht,42340,more than downpayment,more than downpayment,0,230
2h9duAht,1000,12/3/2019,8900,2h9duAht,43340,more than downpayment,more than downpayment,0,1000
2h9duAht,4900,12/11/2019,8900,2h9duAht,48240,more than downpayment,more than downpayment,0,4900
2h9duAht,2000,12/12/2019,8900,2h9duAht,50240,more than downpayment,more than downpayment,0,2000
2h9duAht,2000,1/9/2020,8900,2h9duAht,52240,more than downpayment,more than downpayment,0,2000
2h9duAht,2000,2/3/2020,8900,2h9duAht,54240,more than downpayment,more than downpayment,0,2000
2h9duAht,1000,2/4/2020,8900,2h9duAht,55240,more than downpayment,more than downpayment,0,1000
2h9duAht,1000,2/7/2020,8900,2h9duAht,56240,more than downpayment,more than downpayment,0,1000
2HJBEBJG,9900,7/9/2019,9900,,9900,equal to downpayment,,9900,0
2HJBEBJG,3900,8/5/2019,9900,2HJBEBJG,13800,more than downpayment,equal to downpayment,0,3900
2HJBEBJG,3900,9/5/2019,9900,2HJBEBJG,17700,more than downpayment,more than downpayment,0,3900
2HJBEBJG,3900,10/7/2019,9900,2HJBEBJG,21600,more than downpayment,more than downpayment,0,3900
2HJBEBJG,3900,11/17/2019,9900,2HJBEBJG,25500,more than downpayment,more than downpayment,0,3900
2HJBEBJG,3900,2/5/2020,9900,2HJBEBJG,29400,more than downpayment,more than downpayment,0,3900
2HJBEBJG,3900,2/7/2020,9900,2HJBEBJG,33300,more than downpayment,more than downpayment,0,3900
2IBHlux0,9900,6/14/2019,9900,,9900,equal to downpayment,,9900,0
2IBHlux0,3900,8/15/2019,9900,2IBHlux0,13800,more than downpayment,equal to downpayment,0,3900
2IBHlux0,3900,9/15/2019,9900,2IBHlux0,17700,more than downpayment,more than downpayment,0,3900
2IBHlux0,3900,10/15/2019,9900,2IBHlux0,21600,more than downpayment,more than downpayment,0,3900
2IGZK63Q,9900,1/28/2020,9900,,9900,equal to downpayment,,9900,0
2IIQLWQW,9900,12/23/2019,9900,,9900,equal to downpayment,,9900,0
2JRFPJ6Z,8900,10/15/2019,8900,,8900,equal to downpayment,,8900,0
2JRFPJ6Z,3900,12/27/2019,8900,2JRFPJ6Z,12800,more than downpayment,equal to downpayment,0,3900
2JRFPJ6Z,3900,1/27/2020,8900,2JRFPJ6Z,16700,more than downpayment,more than downpayment,0,3900
2JU6ZV3F,5000,11/21/2019,9900,,5000,less than downpayment,,5000,0
2JU6ZV3F,5000,11/30/2019,9900,2JU6ZV3F,10000,more than downpayment,less than downpayment,4900,100
2KUKUFDU,9900,1/15/2020,9900,,9900,equal to downpayment,,9900,0
2NfYluAK,10000,6/19/2017,10000,,10000,equal to downpayment,,10000,0
2NfYluAK,3000,11/14/2017,10000,2NfYluAK,13000,more than downpayment,equal to downpayment,0,3000
2NfYluAK,3000,12/14/2017,10000,2NfYluAK,16000,more than downpayment,more than downpayment,0,3000
2NfYluAK,3000,1/15/2018,10000,2NfYluAK,19000,more than downpayment,more than downpayment,0,3000
2NfYluAK,4500,2/15/2018,10000,2NfYluAK,23500,more than downpayment,more than downpayment,0,4500
2NfYluAK,3000,3/15/2018,10000,2NfYluAK,26500,more than downpayment,more than downpayment,0,3000
2NfYluAK,3000,4/19/2018,10000,2NfYluAK,29500,more than downpayment,more than downpayment,0,3000
2NfYluAK,3000,5/19/2018,10000,2NfYluAK,32500,more than downpayment,more than downpayment,0,3000
2NfYluAK,3000,6/20/2018,10000,2NfYluAK,35500,more than downpayment,more than downpayment,0,3000
2NfYluAK,3000,7/30/2018,10000,2NfYluAK,38500,more than downpayment,more than downpayment,0,3000
2NfYluAK,3000,1/15/2019,10000,2NfYluAK,41500,more than downpayment,more than downpayment,0,3000
2NfYluAK,3500,3/11/2019,10000,2NfYluAK,45000,more than downpayment,more than downpayment,0,3500
2NuzjMTL,8900,4/16/2019,8900,,8900,equal to downpayment,,8900,0
2NuzjMTL,3900,5/25/2019,8900,2NuzjMTL,12800,more than downpayment,equal to downpayment,0,3900
2NuzjMTL,3900,6/26/2019,8900,2NuzjMTL,16700,more than downpayment,more than downpayment,0,3900
2NuzjMTL,1000,7/31/2019,8900,2NuzjMTL,17700,more than downpayment,more than downpayment,0,1000
2NuzjMTL,2900,8/3/2019,8900,2NuzjMTL,20600,more than downpayment,more than downpayment,0,2900
2NuzjMTL,1000,9/12/2019,8900,2NuzjMTL,21600,more than downpayment,more than downpayment,0,1000
2NuzjMTL,1000,9/17/2019,8900,2NuzjMTL,22600,more than downpayment,more than downpayment,0,1000
2NuzjMTL,2000,10/31/2019,8900,2NuzjMTL,24600,more than downpayment,more than downpayment,0,2000
2PPD9XFJ,10000,10/10/2019,9900,,10000,more than downpayment,,9900,100
2PPD9XFJ,8000,11/14/2019,9900,2PPD9XFJ,18000,more than downpayment,more than downpayment,0,8000
2PPD9XFJ,3900,1/11/2020,9900,2PPD9XFJ,21900,more than downpayment,more than downpayment,0,3900
2PRNTZN7,9900,9/8/2019,9900,,9900,equal to downpayment,,9900,0
2PRNTZN7,3900,10/24/2019,9900,2PRNTZN7,13800,more than downpayment,equal to downpayment,0,3900
2PRNTZN7,3900,12/3/2019,9900,2PRNTZN7,17700,more than downpayment,more than downpayment,0,3900
2PRNTZN7,3900,12/30/2019,9900,2PRNTZN7,21600,more than downpayment,more than downpayment,0,3900
2PRuLhn4,10000,12/27/2018,10000,,10000,equal to downpayment,,10000,0
2PRuLhn4,4500,2/25/2019,10000,2PRuLhn4,14500,more than downpayment,equal to downpayment,0,4500
2PRuLhn4,4600,3/25/2019,10000,2PRuLhn4,19100,more than downpayment,more than downpayment,0,4600
2PRuLhn4,4500,4/25/2019,10000,2PRuLhn4,23600,more than downpayment,more than downpayment,0,4500
2PRuLhn4,4500,5/27/2019,10000,2PRuLhn4,28100,more than downpayment,more than downpayment,0,4500
2PRuLhn4,4500,6/25/2019,10000,2PRuLhn4,32600,more than downpayment,more than downpayment,0,4500
2PRuLhn4,3000,7/29/2019,10000,2PRuLhn4,35600,more than downpayment,more than downpayment,0,3000
2PRuLhn4,1000,2/7/2020,10000,2PRuLhn4,36600,more than downpayment,more than downpayment,0,1000
2RZ9X2G7,9900,7/5/2019,9900,,9900,equal to downpayment,,9900,0
2RZ9X2G7,3900,8/28/2019,9900,2RZ9X2G7,13800,more than downpayment,equal to downpayment,0,3900
2RZ9X2G7,3900,9/26/2019,9900,2RZ9X2G7,17700,more than downpayment,more than downpayment,0,3900
2RZ9X2G7,3900,10/26/2019,9900,2RZ9X2G7,21600,more than downpayment,more than downpayment,0,3900
2RZ9X2G7,3900,11/23/2019,9900,2RZ9X2G7,25500,more than downpayment,more than downpayment,0,3900
2RZ9X2G7,3900,1/6/2020,9900,2RZ9X2G7,29400,more than downpayment,more than downpayment,0,3900
2T1812FE,8900,11/20/2019,8900,,8900,equal to downpayment,,8900,0
2T1812FE,20000,11/23/2019,8900,2T1812FE,28900,more than downpayment,equal to downpayment,0,20000
2T51T5J6,8900,1/9/2019,8900,,8900,equal to downpayment,,8900,0
2T51T5J6,3900,3/31/2019,8900,2T51T5J6,12800,more than downpayment,equal to downpayment,0,3900
2T51T5J6,3900,4/29/2019,8900,2T51T5J6,16700,more than downpayment,more than downpayment,0,3900
2T51T5J6,3900,6/4/2019,8900,2T51T5J6,20600,more than downpayment,more than downpayment,0,3900
2T51T5J6,3900,7/9/2019,8900,2T51T5J6,24500,more than downpayment,more than downpayment,0,3900
2T51T5J6,3900,8/6/2019,8900,2T51T5J6,28400,more than downpayment,more than downpayment,0,3900
2TC6HQCC,8900,7/3/2019,8900,,8900,equal to downpayment,,8900,0
2TC6HQCC,3900,8/10/2019,8900,2TC6HQCC,12800,more than downpayment,equal to downpayment,0,3900
2TC6HQCC,3900,9/14/2019,8900,2TC6HQCC,16700,more than downpayment,more than downpayment,0,3900
2TC6HQCC,4000,10/16/2019,8900,2TC6HQCC,20700,more than downpayment,more than downpayment,0,4000
2TC6HQCC,4000,11/16/2019,8900,2TC6HQCC,24700,more than downpayment,more than downpayment,0,4000
2TC6HQCC,3900,12/18/2019,8900,2TC6HQCC,28600,more than downpayment,more than downpayment,0,3900
2TC6HQCC,3900,1/16/2020,8900,2TC6HQCC,32500,more than downpayment,more than downpayment,0,3900
2UPWS4XN,9900,12/29/2019,9900,,9900,equal to downpayment,,9900,0
2VELV9IU,9900,12/18/2019,9900,,9900,equal to downpayment,,9900,0
2VELV9IU,4000,1/25/2020,9900,2VELV9IU,13900,more than downpayment,equal to downpayment,0,4000
2WKR2MO9,9900,6/24/2019,9900,,9900,equal to downpayment,,9900,0
2WKR2MO9,3900,7/21/2019,9900,2WKR2MO9,13800,more than downpayment,equal to downpayment,0,3900
2WKR2MO9,3900,8/23/2019,9900,2WKR2MO9,17700,more than downpayment,more than downpayment,0,3900
2WKR2MO9,3900,9/23/2019,9900,2WKR2MO9,21600,more than downpayment,more than downpayment,0,3900
2WKR2MO9,90400,10/15/2019,9900,2WKR2MO9,112000,more than downpayment,more than downpayment,0,90400
2XANQ9UN,9900,6/26/2019,9900,,9900,equal to downpayment,,9900,0
2XANQ9UN,3900,8/21/2019,9900,2XANQ9UN,13800,more than downpayment,equal to downpayment,0,3900
2XANQ9UN,3900,9/24/2019,9900,2XANQ9UN,17700,more than downpayment,more than downpayment,0,3900
2XANQ9UN,3900,10/24/2019,9900,2XANQ9UN,21600,more than downpayment,more than downpayment,0,3900
2XANQ9UN,3900,11/22/2019,9900,2XANQ9UN,25500,more than downpayment,more than downpayment,0,3900
2XANQ9UN,3900,12/26/2019,9900,2XANQ9UN,29400,more than downpayment,more than downpayment,0,3900
2XANQ9UN,3900,1/28/2020,9900,2XANQ9UN,33300,more than downpayment,more than downpayment,0,3900
2xeIX0Sf,2000,7/17/2018,1999,,2000,more than downpayment,,1999,1
2xeIX0Sf,1450,8/8/2018,1999,2xeIX0Sf,3450,more than downpayment,more than downpayment,0,1450
2xeIX0Sf,1000,10/14/2018,1999,2xeIX0Sf,4450,more than downpayment,more than downpayment,0,1000
2xeIX0Sf,1550,6/25/2019,1999,2xeIX0Sf,6000,more than downpayment,more than downpayment,0,1550
2xeIX0Sf,400,8/19/2019,1999,2xeIX0Sf,6400,more than downpayment,more than downpayment,0,400
2xeIX0Sf,2000,10/5/2019,1999,2xeIX0Sf,8400,more than downpayment,more than downpayment,0,2000
2xeIX0Sf,2000,11/6/2019,1999,2xeIX0Sf,10400,more than downpayment,more than downpayment,0,2000
2xeIX0Sf,1600,1/3/2020,1999,2xeIX0Sf,12000,more than downpayment,more than downpayment,0,1600
2xeIX0Sf,2000,2/5/2020,1999,2xeIX0Sf,14000,more than downpayment,more than downpayment,0,2000
2XF24NGX,9900,1/10/2020,9900,,9900,equal to downpayment,,9900,0
2XKSFLI1,9900,11/17/2019,9900,,9900,equal to downpayment,,9900,0
2XKSFLI1,3900,1/28/2020,9900,2XKSFLI1,13800,more than downpayment,equal to downpayment,0,3900
2Y9hj226,9900,8/28/2019,9900,,9900,equal to downpayment,,9900,0
2Y9hj226,3900,10/31/2019,9900,2Y9hj226,13800,more than downpayment,equal to downpayment,0,3900
2Y9hj226,3900,12/2/2019,9900,2Y9hj226,17700,more than downpayment,more than downpayment,0,3900
2Y9hj226,3900,1/2/2020,9900,2Y9hj226,21600,more than downpayment,more than downpayment,0,3900
2Y9hj226,3900,2/3/2020,9900,2Y9hj226,25500,more than downpayment,more than downpayment,0,3900
2YH5XNTS,9900,2/8/2020,9900,,9900,equal to downpayment,,9900,0
2ZBUEOES,9900,12/22/2019,9900,,9900,equal to downpayment,,9900,0
30b18bdb,10000,1/22/2020,9900,,10000,more than downpayment,,9900,100
30db8c7d,3000,9/12/2019,9900,,3000,less than downpayment,,3000,0
30db8c7d,4900,9/30/2019,9900,30db8c7d,7900,less than downpayment,less than downpayment,4900,0
30db8c7d,1000,10/29/2019,9900,30db8c7d,8900,less than downpayment,less than downpayment,1000,0
30db8c7d,1000,10/30/2019,9900,30db8c7d,9900,equal to downpayment,less than downpayment,1000,0
30db8c7d,3900,12/21/2019,9900,30db8c7d,13800,more than downpayment,equal to downpayment,0,3900
30db8c7d,3900,1/21/2020,9900,30db8c7d,17700,more than downpayment,more than downpayment,0,3900
313de50b,10000,11/5/2019,9900,,10000,more than downpayment,,9900,100
313de50b,4000,12/26/2019,9900,313de50b,14000,more than downpayment,more than downpayment,0,4000
313de50b,3900,1/14/2020,9900,313de50b,17900,more than downpayment,more than downpayment,0,3900
313de50b,3900,2/5/2020,9900,313de50b,21800,more than downpayment,more than downpayment,0,3900
318a4ef7,7900,9/27/2019,7900,,7900,equal to downpayment,,7900,0
318a4ef7,3100,11/4/2019,7900,318a4ef7,11000,more than downpayment,equal to downpayment,0,3100
318a4ef7,3100,12/2/2019,7900,318a4ef7,14100,more than downpayment,more than downpayment,0,3100
318a4ef7,3100,1/4/2020,7900,318a4ef7,17200,more than downpayment,more than downpayment,0,3100
318a4ef7,3100,2/4/2020,7900,318a4ef7,20300,more than downpayment,more than downpayment,0,3100
31BT8KUU,9900,7/2/2019,9900,,9900,equal to downpayment,,9900,0
31BT8KUU,3900,8/5/2019,9900,31BT8KUU,13800,more than downpayment,equal to downpayment,0,3900
31BT8KUU,3900,9/4/2019,9900,31BT8KUU,17700,more than downpayment,more than downpayment,0,3900
31BT8KUU,3900,10/2/2019,9900,31BT8KUU,21600,more than downpayment,more than downpayment,0,3900
31BT8KUU,3900,11/4/2019,9900,31BT8KUU,25500,more than downpayment,more than downpayment,0,3900
31BT8KUU,3900,12/3/2019,9900,31BT8KUU,29400,more than downpayment,more than downpayment,0,3900
31BT8KUU,3900,1/13/2020,9900,31BT8KUU,33300,more than downpayment,more than downpayment,0,3900
31BT8KUU,3900,2/3/2020,9900,31BT8KUU,37200,more than downpayment,more than downpayment,0,3900
31ff4fe4,4999,12/30/2019,4999,,4999,equal to downpayment,,4999,0
31s7QaMH,8900,1/7/2019,8900,,8900,equal to downpayment,,8900,0
31s7QaMH,3900,2/12/2019,8900,31s7QaMH,12800,more than downpayment,equal to downpayment,0,3900
31s7QaMH,3900,3/21/2019,8900,31s7QaMH,16700,more than downpayment,more than downpayment,0,3900
31s7QaMH,3900,4/24/2019,8900,31s7QaMH,20600,more than downpayment,more than downpayment,0,3900
31s7QaMH,3900,5/17/2019,8900,31s7QaMH,24500,more than downpayment,more than downpayment,0,3900
31s7QaMH,3900,6/24/2019,8900,31s7QaMH,28400,more than downpayment,more than downpayment,0,3900
31s7QaMH,3900,7/24/2019,8900,31s7QaMH,32300,more than downpayment,more than downpayment,0,3900
31s7QaMH,3900,8/23/2019,8900,31s7QaMH,36200,more than downpayment,more than downpayment,0,3900
31s7QaMH,3900,9/21/2019,8900,31s7QaMH,40100,more than downpayment,more than downpayment,0,3900
31s7QaMH,3900,10/24/2019,8900,31s7QaMH,44000,more than downpayment,more than downpayment,0,3900
31s7QaMH,3900,11/25/2019,8900,31s7QaMH,47900,more than downpayment,more than downpayment,0,3900
31s7QaMH,3900,12/30/2019,8900,31s7QaMH,51800,more than downpayment,more than downpayment,0,3900
31s7QaMH,3900,1/23/2020,8900,31s7QaMH,55700,more than downpayment,more than downpayment,0,3900
32ca761a,9900,2/4/2020,9900,,9900,equal to downpayment,,9900,0
32fb8518,5000,12/17/2019,4999,,5000,more than downpayment,,4999,1
32XOV52F,20000,6/27/2019,9900,,20000,more than downpayment,,9900,10100
32XOV52F,12000,8/2/2019,9900,32XOV52F,32000,more than downpayment,more than downpayment,0,12000
32XOV52F,4000,8/5/2019,9900,32XOV52F,36000,more than downpayment,more than downpayment,0,4000
32XOV52F,19000,9/3/2019,9900,32XOV52F,55000,more than downpayment,more than downpayment,0,19000
32XOV52F,15000,10/2/2019,9900,32XOV52F,70000,more than downpayment,more than downpayment,0,15000
32XOV52F,4000,11/6/2019,9900,32XOV52F,74000,more than downpayment,more than downpayment,0,4000
32XOV52F,4000,12/3/2019,9900,32XOV52F,78000,more than downpayment,more than downpayment,0,4000
32XOV52F,4000,1/9/2020,9900,32XOV52F,82000,more than downpayment,more than downpayment,0,4000
3305DJn4,9900,9/4/2019,9900,,9900,equal to downpayment,,9900,0
3305DJn4,300,9/20/2019,9900,3305DJn4,10200,more than downpayment,equal to downpayment,0,300
3305DJn4,300,9/21/2019,9900,3305DJn4,10500,more than downpayment,more than downpayment,0,300
3305DJn4,300,9/22/2019,9900,3305DJn4,10800,more than downpayment,more than downpayment,0,300
3305DJn4,300,9/23/2019,9900,3305DJn4,11100,more than downpayment,more than downpayment,0,300
3305DJn4,300,9/24/2019,9900,3305DJn4,11400,more than downpayment,more than downpayment,0,300
3305DJn4,100,9/25/2019,9900,3305DJn4,11500,more than downpayment,more than downpayment,0,100
3305DJn4,200,9/26/2019,9900,3305DJn4,11700,more than downpayment,more than downpayment,0,200
3305DJn4,100,9/28/2019,9900,3305DJn4,11800,more than downpayment,more than downpayment,0,100
3305DJn4,100,9/30/2019,9900,3305DJn4,11900,more than downpayment,more than downpayment,0,100
3305DJn4,100,10/1/2019,9900,3305DJn4,12000,more than downpayment,more than downpayment,0,100
3305DJn4,300,10/2/2019,9900,3305DJn4,12300,more than downpayment,more than downpayment,0,300
3305DJn4,100,10/4/2019,9900,3305DJn4,12400,more than downpayment,more than downpayment,0,100
3305DJn4,100,10/8/2019,9900,3305DJn4,12500,more than downpayment,more than downpayment,0,100
3305DJn4,200,10/9/2019,9900,3305DJn4,12700,more than downpayment,more than downpayment,0,200
3305DJn4,300,10/13/2019,9900,3305DJn4,13000,more than downpayment,more than downpayment,0,300
3305DJn4,100,10/14/2019,9900,3305DJn4,13100,more than downpayment,more than downpayment,0,100
3305DJn4,300,10/15/2019,9900,3305DJn4,13400,more than downpayment,more than downpayment,0,300
3305DJn4,100,10/16/2019,9900,3305DJn4,13500,more than downpayment,more than downpayment,0,100
3305DJn4,100,10/18/2019,9900,3305DJn4,13600,more than downpayment,more than downpayment,0,100
3305DJn4,200,10/19/2019,9900,3305DJn4,13800,more than downpayment,more than downpayment,0,200
3305DJn4,100,10/23/2019,9900,3305DJn4,13900,more than downpayment,more than downpayment,0,100
3305DJn4,200,11/9/2019,9900,3305DJn4,14100,more than downpayment,more than downpayment,0,200
3305DJn4,400,11/13/2019,9900,3305DJn4,14500,more than downpayment,more than downpayment,0,400
3305DJn4,700,11/16/2019,9900,3305DJn4,15200,more than downpayment,more than downpayment,0,700
3305DJn4,300,11/17/2019,9900,3305DJn4,15500,more than downpayment,more than downpayment,0,300
3305DJn4,700,11/18/2019,9900,3305DJn4,16200,more than downpayment,more than downpayment,0,700
3305DJn4,500,11/23/2019,9900,3305DJn4,16700,more than downpayment,more than downpayment,0,500
3305DJn4,1100,11/25/2019,9900,3305DJn4,17800,more than downpayment,more than downpayment,0,1100
3305DJn4,2300,12/20/2019,9900,3305DJn4,20100,more than downpayment,more than downpayment,0,2300
3305DJn4,1600,12/26/2019,9900,3305DJn4,21700,more than downpayment,more than downpayment,0,1600
3305DJn4,900,1/16/2020,9900,3305DJn4,22600,more than downpayment,more than downpayment,0,900
3305DJn4,1000,1/20/2020,9900,3305DJn4,23600,more than downpayment,more than downpayment,0,1000
3305DJn4,1000,1/22/2020,9900,3305DJn4,24600,more than downpayment,more than downpayment,0,1000
3305DJn4,1000,1/24/2020,9900,3305DJn4,25600,more than downpayment,more than downpayment,0,1000
336e55cd,9900,12/11/2019,9900,,9900,equal to downpayment,,9900,0
336e55cd,3900,2/4/2020,9900,336e55cd,13800,more than downpayment,equal to downpayment,0,3900
337cb5f1,4999,1/31/2020,4999,,4999,equal to downpayment,,4999,0
338c69f9,9900,12/17/2019,9900,,9900,equal to downpayment,,9900,0
339SMU5I,9900,10/31/2019,9900,,9900,equal to downpayment,,9900,0
339SMU5I,3900,11/29/2019,9900,339SMU5I,13800,more than downpayment,equal to downpayment,0,3900
339SMU5I,3900,12/30/2019,9900,339SMU5I,17700,more than downpayment,more than downpayment,0,3900
339SMU5I,3900,2/4/2020,9900,339SMU5I,21600,more than downpayment,more than downpayment,0,3900
33cca921,3000,10/28/2019,7900,,3000,less than downpayment,,3000,0
33cca921,2000,10/29/2019,7900,33cca921,5000,less than downpayment,less than downpayment,2000,0
33cca921,1000,10/30/2019,7900,33cca921,6000,less than downpayment,less than downpayment,1000,0
33cca921,2000,10/31/2019,7900,33cca921,8000,more than downpayment,less than downpayment,1900,100
33cca921,150,11/27/2019,7900,33cca921,8150,more than downpayment,more than downpayment,0,150
33cca921,1000,12/3/2019,7900,33cca921,9150,more than downpayment,more than downpayment,0,1000
33cca921,1000,12/5/2019,7900,33cca921,10150,more than downpayment,more than downpayment,0,1000
33cca921,1000,12/6/2019,7900,33cca921,11150,more than downpayment,more than downpayment,0,1000
33cca921,3000,1/5/2020,7900,33cca921,14150,more than downpayment,more than downpayment,0,3000
33cca921,100,1/6/2020,7900,33cca921,14250,more than downpayment,more than downpayment,0,100
33db777e,5000,12/27/2019,9900,,5000,less than downpayment,,5000,0
33db777e,4900,12/28/2019,9900,33db777e,9900,equal to downpayment,less than downpayment,4900,0
3436c8bf,5000,1/18/2020,8900,,5000,less than downpayment,,5000,0
34AP2BGR,9900,8/27/2019,9900,,9900,equal to downpayment,,9900,0
34AP2BGR,3900,10/28/2019,9900,34AP2BGR,13800,more than downpayment,equal to downpayment,0,3900
34AP2BGR,3900,12/1/2019,9900,34AP2BGR,17700,more than downpayment,more than downpayment,0,3900
34AP2BGR,3900,1/1/2020,9900,34AP2BGR,21600,more than downpayment,more than downpayment,0,3900
34AP2BGR,3900,2/1/2020,9900,34AP2BGR,25500,more than downpayment,more than downpayment,0,3900
34MOVNFX,9900,1/13/2020,9900,,9900,equal to downpayment,,9900,0
352439ae,8900,2/3/2020,8900,,8900,equal to downpayment,,8900,0
35C6FKVn,8900,2/21/2019,8900,,8900,equal to downpayment,,8900,0
35C6FKVn,4000,3/22/2019,8900,35C6FKVn,12900,more than downpayment,equal to downpayment,0,4000
35C6FKVn,4000,4/29/2019,8900,35C6FKVn,16900,more than downpayment,more than downpayment,0,4000
35C6FKVn,4000,5/30/2019,8900,35C6FKVn,20900,more than downpayment,more than downpayment,0,4000
35C6FKVn,4000,7/3/2019,8900,35C6FKVn,24900,more than downpayment,more than downpayment,0,4000
35C6FKVn,10000,8/5/2019,8900,35C6FKVn,34900,more than downpayment,more than downpayment,0,10000
35C6FKVn,12000,11/8/2019,8900,35C6FKVn,46900,more than downpayment,more than downpayment,0,12000
35N9NUNL,9900,11/16/2019,9900,,9900,equal to downpayment,,9900,0
35N9NUNL,980,2/5/2020,9900,35N9NUNL,10880,more than downpayment,equal to downpayment,0,980
35WJIZ8P,9900,10/30/2019,9900,,9900,equal to downpayment,,9900,0
3.64E+94,8900,10/19/2019,8900,,8900,equal to downpayment,,8900,0
3.64E+94,3900,12/21/2019,8900,3.64E+94,12800,more than downpayment,equal to downpayment,0,3900
3.64E+94,3900,1/25/2020,8900,3.64E+94,16700,more than downpayment,more than downpayment,0,3900
36938db9,9900,2/7/2020,9900,,9900,equal to downpayment,,9900,0
36c91b90,7900,9/16/2019,7900,,7900,equal to downpayment,,7900,0
36c91b90,3100,11/30/2019,7900,36c91b90,11000,more than downpayment,equal to downpayment,0,3100
36c91b90,3100,2/3/2020,7900,36c91b90,14100,more than downpayment,more than downpayment,0,3100
36HKOATI,9900,11/28/2019,9900,,9900,equal to downpayment,,9900,0
3754174a,9900,12/19/2019,9900,,9900,equal to downpayment,,9900,0
37APuZ2c,10000,9/6/2017,10000,,10000,equal to downpayment,,10000,0
37APuZ2c,4000,11/3/2017,10000,37APuZ2c,14000,more than downpayment,equal to downpayment,0,4000
37APuZ2c,2000,2/5/2018,10000,37APuZ2c,16000,more than downpayment,more than downpayment,0,2000
37APuZ2c,3000,3/8/2018,10000,37APuZ2c,19000,more than downpayment,more than downpayment,0,3000
37APuZ2c,3000,3/24/2018,10000,37APuZ2c,22000,more than downpayment,more than downpayment,0,3000
37APuZ2c,3000,5/7/2018,10000,37APuZ2c,25000,more than downpayment,more than downpayment,0,3000
37APuZ2c,1000,11/15/2018,10000,37APuZ2c,26000,more than downpayment,more than downpayment,0,1000
37c1e6b5,26250,10/12/2019,26250,,26250,equal to downpayment,,26250,0
37c1e6b5,26250,11/30/2019,26250,37c1e6b5,52500,more than downpayment,equal to downpayment,0,26250
37c1e6b5,26250,1/21/2020,26250,37c1e6b5,78750,more than downpayment,more than downpayment,0,26250
37c1e6b5,6250,1/29/2020,26250,37c1e6b5,85000,more than downpayment,more than downpayment,0,6250
37c1e6b5,5000,2/3/2020,26250,37c1e6b5,90000,more than downpayment,more than downpayment,0,5000
382a1e02,8900,12/31/2019,8900,,8900,equal to downpayment,,8900,0
389da586,4999,12/30/2019,4999,,4999,equal to downpayment,,4999,0
38chx7mC,10500,6/10/2017,10000,,10500,more than downpayment,,10000,500
38chx7mC,5000,8/21/2017,10000,38chx7mC,15500,more than downpayment,more than downpayment,0,5000
38chx7mC,5000,9/11/2017,10000,38chx7mC,20500,more than downpayment,more than downpayment,0,5000
38chx7mC,5000,10/7/2017,10000,38chx7mC,25500,more than downpayment,more than downpayment,0,5000
38chx7mC,5000,12/11/2017,10000,38chx7mC,30500,more than downpayment,more than downpayment,0,5000
38chx7mC,5000,1/22/2018,10000,38chx7mC,35500,more than downpayment,more than downpayment,0,5000
38chx7mC,5000,3/5/2018,10000,38chx7mC,40500,more than downpayment,more than downpayment,0,5000
38chx7mC,5000,4/13/2018,10000,38chx7mC,45500,more than downpayment,more than downpayment,0,5000
38chx7mC,5000,5/14/2018,10000,38chx7mC,50500,more than downpayment,more than downpayment,0,5000
38chx7mC,1400,6/20/2018,10000,38chx7mC,51900,more than downpayment,more than downpayment,0,1400
38chx7mC,3900,12/21/2019,10000,38chx7mC,55800,more than downpayment,more than downpayment,0,3900
38chx7mC,3900,1/18/2020,10000,38chx7mC,59700,more than downpayment,more than downpayment,0,3900
39cc4ea3,9900,12/11/2019,8900,,9900,more than downpayment,,8900,1000
39efab38,9900,11/6/2019,9900,,9900,equal to downpayment,,9900,0
39efab38,5000,11/28/2019,9900,39efab38,14900,more than downpayment,equal to downpayment,0,5000
39efab38,3900,12/22/2019,9900,39efab38,18800,more than downpayment,more than downpayment,0,3900
39efab38,3900,2/8/2020,9900,39efab38,22700,more than downpayment,more than downpayment,0,3900
39vPJIPI,9900,10/31/2018,9900,,9900,equal to downpayment,,9900,0
39vPJIPI,9000,1/28/2019,9900,39vPJIPI,18900,more than downpayment,equal to downpayment,0,9000
39vPJIPI,4500,3/21/2019,9900,39vPJIPI,23400,more than downpayment,more than downpayment,0,4500
39vPJIPI,9000,5/3/2019,9900,39vPJIPI,32400,more than downpayment,more than downpayment,0,9000
39vPJIPI,4500,6/18/2019,9900,39vPJIPI,36900,more than downpayment,more than downpayment,0,4500
39vPJIPI,4500,7/11/2019,9900,39vPJIPI,41400,more than downpayment,more than downpayment,0,4500
39vPJIPI,4500,7/30/2019,9900,39vPJIPI,45900,more than downpayment,more than downpayment,0,4500
39vPJIPI,4500,9/16/2019,9900,39vPJIPI,50400,more than downpayment,more than downpayment,0,4500
39vPJIPI,4500,10/22/2019,9900,39vPJIPI,54900,more than downpayment,more than downpayment,0,4500
3a68157b,9900,1/21/2020,9900,,9900,equal to downpayment,,9900,0
3a8f6340,8900,10/12/2019,8900,,8900,equal to downpayment,,8900,0
3a8f6340,3900,11/29/2019,8900,3a8f6340,12800,more than downpayment,equal to downpayment,0,3900
3a8f6340,3900,12/24/2019,8900,3a8f6340,16700,more than downpayment,more than downpayment,0,3900
3a8f6340,3900,2/8/2020,8900,3a8f6340,20600,more than downpayment,more than downpayment,0,3900
3AAZ5HWG,19800,6/30/2019,9900,,19800,more than downpayment,,9900,9900
3AAZ5HWG,1900,11/19/2019,9900,3AAZ5HWG,21700,more than downpayment,more than downpayment,0,1900
3AAZ5HWG,3800,12/3/2019,9900,3AAZ5HWG,25500,more than downpayment,more than downpayment,0,3800
3AAZ5HWG,3900,1/10/2020,9900,3AAZ5HWG,29400,more than downpayment,more than downpayment,0,3900
3AAZ5HWG,3900,1/30/2020,9900,3AAZ5HWG,33300,more than downpayment,more than downpayment,0,3900
3abb3e25,9900,12/24/2019,9900,,9900,equal to downpayment,,9900,0
3abb3e25,3900,2/6/2020,9900,3abb3e25,13800,more than downpayment,equal to downpayment,0,3900
3ADDU6HV,9900,12/30/2019,9900,,9900,equal to downpayment,,9900,0
3b7ad7c4,9900,11/6/2019,9900,,9900,equal to downpayment,,9900,0
3b7ad7c4,4000,12/6/2019,9900,3b7ad7c4,13900,more than downpayment,equal to downpayment,0,4000
3b7ad7c4,4000,1/14/2020,9900,3b7ad7c4,17900,more than downpayment,more than downpayment,0,4000
3BN691UL,9900,12/4/2019,9900,,9900,equal to downpayment,,9900,0
3c0ada23,7900,9/30/2019,7900,,7900,equal to downpayment,,7900,0
3c0ada23,3100,10/15/2019,7900,3c0ada23,11000,more than downpayment,equal to downpayment,0,3100
3c0ada23,6200,11/15/2019,7900,3c0ada23,17200,more than downpayment,more than downpayment,0,6200
3c0ada23,3100,12/4/2019,7900,3c0ada23,20300,more than downpayment,more than downpayment,0,3100
3c0ada23,3100,12/21/2019,7900,3c0ada23,23400,more than downpayment,more than downpayment,0,3100
3c0ada23,3100,1/4/2020,7900,3c0ada23,26500,more than downpayment,more than downpayment,0,3100
3c0ada23,3100,2/4/2020,7900,3c0ada23,29600,more than downpayment,more than downpayment,0,3100
3c28ce3c,9900,10/4/2019,9900,,9900,equal to downpayment,,9900,0
3c28ce3c,4000,11/26/2019,9900,3c28ce3c,13900,more than downpayment,equal to downpayment,0,4000
3c28ce3c,3900,1/23/2020,9900,3c28ce3c,17800,more than downpayment,more than downpayment,0,3900
3c8ReD2m,10000,11/12/2018,10000,,10000,equal to downpayment,,10000,0
3c8ReD2m,6000,1/14/2019,10000,3c8ReD2m,16000,more than downpayment,equal to downpayment,0,6000
3c8ReD2m,3000,1/21/2019,10000,3c8ReD2m,19000,more than downpayment,more than downpayment,0,3000
3c8ReD2m,9000,3/13/2019,10000,3c8ReD2m,28000,more than downpayment,more than downpayment,0,9000
3c8ReD2m,1900,5/15/2019,10000,3c8ReD2m,29900,more than downpayment,more than downpayment,0,1900
3c8ReD2m,600,5/16/2019,10000,3c8ReD2m,30500,more than downpayment,more than downpayment,0,600
3c8ReD2m,750,5/18/2019,10000,3c8ReD2m,31250,more than downpayment,more than downpayment,0,750
3c8ReD2m,2000,6/3/2019,10000,3c8ReD2m,33250,more than downpayment,more than downpayment,0,2000
3c8ReD2m,990,6/16/2019,10000,3c8ReD2m,34240,more than downpayment,more than downpayment,0,990
3c8ReD2m,970,6/25/2019,10000,3c8ReD2m,35210,more than downpayment,more than downpayment,0,970
3c8ReD2m,2990,7/6/2019,10000,3c8ReD2m,38200,more than downpayment,more than downpayment,0,2990
3c8ReD2m,1330,7/13/2019,10000,3c8ReD2m,39530,more than downpayment,more than downpayment,0,1330
3c8ReD2m,470,8/7/2019,10000,3c8ReD2m,40000,more than downpayment,more than downpayment,0,470
3c8ReD2m,15000,11/7/2019,10000,3c8ReD2m,55000,more than downpayment,more than downpayment,0,15000
3c8ReD2m,2000,12/2/2019,10000,3c8ReD2m,57000,more than downpayment,more than downpayment,0,2000
3c90cdac,8900,9/11/2019,8900,,8900,equal to downpayment,,8900,0
3c90cdac,7800,12/6/2019,8900,3c90cdac,16700,more than downpayment,equal to downpayment,0,7800
3CIYSHB3,8900,10/25/2019,8900,,8900,equal to downpayment,,8900,0
3CIYSHB3,3900,11/25/2019,8900,3CIYSHB3,12800,more than downpayment,equal to downpayment,0,3900
3CIYSHB3,3900,12/26/2019,8900,3CIYSHB3,16700,more than downpayment,more than downpayment,0,3900
3CIYSHB3,3900,1/25/2020,8900,3CIYSHB3,20600,more than downpayment,more than downpayment,0,3900
3d5008b1,4000,1/10/2020,9900,,4000,less than downpayment,,4000,0
3d5008b1,6000,1/11/2020,9900,3d5008b1,10000,more than downpayment,less than downpayment,5900,100
3D8ytMjQ,10000,8/27/2018,10000,,10000,equal to downpayment,,10000,0
3D8ytMjQ,4500,9/26/2018,10000,3D8ytMjQ,14500,more than downpayment,equal to downpayment,0,4500
3D8ytMjQ,4500,10/23/2018,10000,3D8ytMjQ,19000,more than downpayment,more than downpayment,0,4500
3D8ytMjQ,4500,11/23/2018,10000,3D8ytMjQ,23500,more than downpayment,more than downpayment,0,4500
3D8ytMjQ,34500,1/3/2019,10000,3D8ytMjQ,58000,more than downpayment,more than downpayment,0,34500
3DF37U64,9900,11/27/2019,9900,,9900,equal to downpayment,,9900,0
3DKSEKJP,8900,10/16/2019,8900,,8900,equal to downpayment,,8900,0
3DKSEKJP,3900,1/24/2020,8900,3DKSEKJP,12800,more than downpayment,equal to downpayment,0,3900
3DPNEoOB,10000,11/4/2018,9900,,10000,more than downpayment,,9900,100
3DPNEoOB,9000,2/4/2019,9900,3DPNEoOB,19000,more than downpayment,more than downpayment,0,9000
3DPNEoOB,9000,4/1/2019,9900,3DPNEoOB,28000,more than downpayment,more than downpayment,0,9000
3DPNEoOB,4500,4/30/2019,9900,3DPNEoOB,32500,more than downpayment,more than downpayment,0,4500
3DPNEoOB,4500,5/27/2019,9900,3DPNEoOB,37000,more than downpayment,more than downpayment,0,4500
3DPNEoOB,9000,9/4/2019,9900,3DPNEoOB,46000,more than downpayment,more than downpayment,0,9000
3DPNEoOB,9000,10/29/2019,9900,3DPNEoOB,55000,more than downpayment,more than downpayment,0,9000
3DPNEoOB,8900,11/27/2019,9900,3DPNEoOB,63900,more than downpayment,more than downpayment,0,8900
3e2b1ea4,9900,1/21/2020,9900,,9900,equal to downpayment,,9900,0
3EH6SWSZ,9900,1/30/2020,9900,,9900,equal to downpayment,,9900,0
3ESLACXM,9900,11/27/2019,9900,,9900,equal to downpayment,,9900,0
3ESLACXM,3900,2/3/2020,9900,3ESLACXM,13800,more than downpayment,equal to downpayment,0,3900
3fd886c9,9900,11/15/2019,9900,,9900,equal to downpayment,,9900,0
3fd886c9,3950,1/4/2020,9900,3fd886c9,13850,more than downpayment,equal to downpayment,0,3950
3fd886c9,3900,2/1/2020,9900,3fd886c9,17750,more than downpayment,more than downpayment,0,3900
3fzS8HG7,50000,2/22/2019,8900,,50000,more than downpayment,,8900,41100
3fzS8HG7,4000,3/20/2019,8900,3fzS8HG7,54000,more than downpayment,more than downpayment,0,4000
3fzS8HG7,4000,6/25/2019,8900,3fzS8HG7,58000,more than downpayment,more than downpayment,0,4000
3fzS8HG7,4000,8/5/2019,8900,3fzS8HG7,62000,more than downpayment,more than downpayment,0,4000
3fzS8HG7,4000,9/13/2019,8900,3fzS8HG7,66000,more than downpayment,more than downpayment,0,4000
3fzS8HG7,4000,11/4/2019,8900,3fzS8HG7,70000,more than downpayment,more than downpayment,0,4000
3fzS8HG7,4000,1/11/2020,8900,3fzS8HG7,74000,more than downpayment,more than downpayment,0,4000
3GHOVCXN,9900,10/31/2019,9900,,9900,equal to downpayment,,9900,0
3GHOVCXN,4000,11/8/2019,9900,3GHOVCXN,13900,more than downpayment,equal to downpayment,0,4000
3GHOVCXN,3000,1/8/2020,9900,3GHOVCXN,16900,more than downpayment,more than downpayment,0,3000
3GHOVCXN,1100,1/20/2020,9900,3GHOVCXN,18000,more than downpayment,more than downpayment,0,1100
3GOKBO4O,8900,10/28/2019,8900,,8900,equal to downpayment,,8900,0
3GOKBO4O,5000,11/13/2019,8900,3GOKBO4O,13900,more than downpayment,equal to downpayment,0,5000
3GOKBO4O,5000,12/7/2019,8900,3GOKBO4O,18900,more than downpayment,more than downpayment,0,5000
3GOKBO4O,9000,1/8/2020,8900,3GOKBO4O,27900,more than downpayment,more than downpayment,0,9000
3GOKBO4O,7800,2/8/2020,8900,3GOKBO4O,35700,more than downpayment,more than downpayment,0,7800
3IDO3JCJ,9900,1/7/2020,9900,,9900,equal to downpayment,,9900,0
3ISrZjNR,9900,7/12/2019,9900,,9900,equal to downpayment,,9900,0
3ISrZjNR,3900,9/30/2019,9900,3ISrZjNR,13800,more than downpayment,equal to downpayment,0,3900
3ISrZjNR,3900,12/10/2019,9900,3ISrZjNR,17700,more than downpayment,more than downpayment,0,3900
3ISrZjNR,3900,12/20/2019,9900,3ISrZjNR,21600,more than downpayment,more than downpayment,0,3900
3ISrZjNR,3900,1/14/2020,9900,3ISrZjNR,25500,more than downpayment,more than downpayment,0,3900
3ISrZjNR,3900,2/4/2020,9900,3ISrZjNR,29400,more than downpayment,more than downpayment,0,3900
3J6KX7TQ,9900,11/18/2019,9900,,9900,equal to downpayment,,9900,0
3J6KX7TQ,4000,12/28/2019,9900,3J6KX7TQ,13900,more than downpayment,equal to downpayment,0,4000
3J6KX7TQ,4000,1/20/2020,9900,3J6KX7TQ,17900,more than downpayment,more than downpayment,0,4000
3JISOCYE,9900,12/7/2019,9900,,9900,equal to downpayment,,9900,0
3JISOCYE,3900,1/30/2020,9900,3JISOCYE,13800,more than downpayment,equal to downpayment,0,3900
3JTZL9VJ,9000,12/12/2019,8900,,9000,more than downpayment,,8900,100
3JVP96P5,10000,8/30/2019,9900,,10000,more than downpayment,,9900,100
3JVP96P5,4000,10/18/2019,9900,3JVP96P5,14000,more than downpayment,more than downpayment,0,4000
3JVP96P5,4000,11/10/2019,9900,3JVP96P5,18000,more than downpayment,more than downpayment,0,4000
3JVP96P5,4000,12/9/2019,9900,3JVP96P5,22000,more than downpayment,more than downpayment,0,4000
3JVP96P5,4000,1/19/2020,9900,3JVP96P5,26000,more than downpayment,more than downpayment,0,4000
3JVP96P5,4000,2/4/2020,9900,3JVP96P5,30000,more than downpayment,more than downpayment,0,4000
3JWT55TF,9900,12/7/2019,9900,,9900,equal to downpayment,,9900,0
3KA662EZ,8000,10/24/2019,9900,,8000,less than downpayment,,8000,0
3KA662EZ,1900,10/29/2019,9900,3KA662EZ,9900,equal to downpayment,less than downpayment,1900,0
3KA662EZ,3900,12/31/2019,9900,3KA662EZ,13800,more than downpayment,equal to downpayment,0,3900
3KA662EZ,3900,1/31/2020,9900,3KA662EZ,17700,more than downpayment,more than downpayment,0,3900
3L36QWR8,9900,12/16/2019,9900,,9900,equal to downpayment,,9900,0
3LV228UG,9900,1/20/2020,9900,,9900,equal to downpayment,,9900,0
3mpISlG0,8900,8/26/2019,8900,,8900,equal to downpayment,,8900,0
3mpISlG0,3900,10/22/2019,8900,3mpISlG0,12800,more than downpayment,equal to downpayment,0,3900
3mpISlG0,3900,11/27/2019,8900,3mpISlG0,16700,more than downpayment,more than downpayment,0,3900
3mpISlG0,3900,12/18/2019,8900,3mpISlG0,20600,more than downpayment,more than downpayment,0,3900
3mpISlG0,3900,1/24/2020,8900,3mpISlG0,24500,more than downpayment,more than downpayment,0,3900
3NyozREZ,9900,7/17/2019,8900,,9900,more than downpayment,,8900,1000
3NyozREZ,18500,8/11/2019,8900,3NyozREZ,28400,more than downpayment,more than downpayment,0,18500
3ODMSMBH,9900,10/7/2019,40000,,9900,less than downpayment,,9900,0
3ODMSMBH,40000,10/21/2019,40000,3ODMSMBH,49900,more than downpayment,less than downpayment,30100,9900
3ODMSMBH,30000,11/6/2019,40000,3ODMSMBH,79900,more than downpayment,more than downpayment,0,30000
3ODMSMBH,20100,12/31/2019,40000,3ODMSMBH,100000,more than downpayment,more than downpayment,0,20100
3ODMSMBH,30000,1/24/2020,40000,3ODMSMBH,130000,more than downpayment,more than downpayment,0,30000
3OM124XW,9900,2/4/2020,9900,,9900,equal to downpayment,,9900,0
3PUQ46VX,9900,11/8/2019,9900,,9900,equal to downpayment,,9900,0
3PUQ46VX,4000,1/4/2020,9900,3PUQ46VX,13900,more than downpayment,equal to downpayment,0,4000
3PUQ46VX,500,2/6/2020,9900,3PUQ46VX,14400,more than downpayment,more than downpayment,0,500
3qDNROEl,8900,12/13/2018,8900,,8900,equal to downpayment,,8900,0
3qDNROEl,5000,12/15/2018,8900,3qDNROEl,13900,more than downpayment,equal to downpayment,0,5000
3qDNROEl,5000,2/13/2019,8900,3qDNROEl,18900,more than downpayment,more than downpayment,0,5000
3qDNROEl,5000,3/13/2019,8900,3qDNROEl,23900,more than downpayment,more than downpayment,0,5000
3qDNROEl,4000,4/12/2019,8900,3qDNROEl,27900,more than downpayment,more than downpayment,0,4000
3qDNROEl,4500,5/14/2019,8900,3qDNROEl,32400,more than downpayment,more than downpayment,0,4500
3qDNROEl,5000,6/13/2019,8900,3qDNROEl,37400,more than downpayment,more than downpayment,0,5000
3qDNROEl,5000,7/12/2019,8900,3qDNROEl,42400,more than downpayment,more than downpayment,0,5000
3qDNROEl,5000,8/9/2019,8900,3qDNROEl,47400,more than downpayment,more than downpayment,0,5000
3qDNROEl,1800,10/25/2019,8900,3qDNROEl,49200,more than downpayment,more than downpayment,0,1800
3qDNROEl,4000,11/15/2019,8900,3qDNROEl,53200,more than downpayment,more than downpayment,0,4000
3QwlXDyQ,2000,8/22/2019,9900,,2000,less than downpayment,,2000,0
3Rmypfln,9900,6/29/2019,9900,,9900,equal to downpayment,,9900,0
3Rmypfln,4000,8/14/2019,9900,3Rmypfln,13900,more than downpayment,equal to downpayment,0,4000
3Rmypfln,4000,9/15/2019,9900,3Rmypfln,17900,more than downpayment,more than downpayment,0,4000
3Rmypfln,4000,10/13/2019,9900,3Rmypfln,21900,more than downpayment,more than downpayment,0,4000
3Rmypfln,4000,11/14/2019,9900,3Rmypfln,25900,more than downpayment,more than downpayment,0,4000
3Rmypfln,3500,12/30/2019,9900,3Rmypfln,29400,more than downpayment,more than downpayment,0,3500
3Rmypfln,2000,1/15/2020,9900,3Rmypfln,31400,more than downpayment,more than downpayment,0,2000
3Rmypfln,5000,1/27/2020,9900,3Rmypfln,36400,more than downpayment,more than downpayment,0,5000
3SO9JyFF,10000,1/24/2019,10000,,10000,equal to downpayment,,10000,0
3SO9JyFF,4500,2/12/2019,10000,3SO9JyFF,14500,more than downpayment,equal to downpayment,0,4500
3SO9JyFF,4500,3/6/2019,10000,3SO9JyFF,19000,more than downpayment,more than downpayment,0,4500
3SO9JyFF,4500,4/4/2019,10000,3SO9JyFF,23500,more than downpayment,more than downpayment,0,4500
3SO9JyFF,5000,5/7/2019,10000,3SO9JyFF,28500,more than downpayment,more than downpayment,0,5000
3SO9JyFF,6000,6/3/2019,10000,3SO9JyFF,34500,more than downpayment,more than downpayment,0,6000
3SO9JyFF,6000,7/2/2019,10000,3SO9JyFF,40500,more than downpayment,more than downpayment,0,6000
3SO9JyFF,4500,8/15/2019,10000,3SO9JyFF,45000,more than downpayment,more than downpayment,0,4500
3SO9JyFF,4500,9/15/2019,10000,3SO9JyFF,49500,more than downpayment,more than downpayment,0,4500
3SO9JyFF,4500,10/16/2019,10000,3SO9JyFF,54000,more than downpayment,more than downpayment,0,4500
3SO9JyFF,4500,11/7/2019,10000,3SO9JyFF,58500,more than downpayment,more than downpayment,0,4500
3SO9JyFF,5500,12/9/2019,10000,3SO9JyFF,64000,more than downpayment,more than downpayment,0,5500
3Txf3ePq,8900,4/17/2019,8900,,8900,equal to downpayment,,8900,0
3Txf3ePq,3900,5/20/2019,8900,3Txf3ePq,12800,more than downpayment,equal to downpayment,0,3900
3Txf3ePq,3900,6/12/2019,8900,3Txf3ePq,16700,more than downpayment,more than downpayment,0,3900
3Txf3ePq,3900,7/13/2019,8900,3Txf3ePq,20600,more than downpayment,more than downpayment,0,3900
3Txf3ePq,3900,8/20/2019,8900,3Txf3ePq,24500,more than downpayment,more than downpayment,0,3900
3Txf3ePq,3900,9/22/2019,8900,3Txf3ePq,28400,more than downpayment,more than downpayment,0,3900
3Txf3ePq,3900,10/22/2019,8900,3Txf3ePq,32300,more than downpayment,more than downpayment,0,3900
3Txf3ePq,3900,11/7/2019,8900,3Txf3ePq,36200,more than downpayment,more than downpayment,0,3900
3Txf3ePq,3900,12/2/2019,8900,3Txf3ePq,40100,more than downpayment,more than downpayment,0,3900
3Txf3ePq,3900,1/2/2020,8900,3Txf3ePq,44000,more than downpayment,more than downpayment,0,3900
3Txf3ePq,3900,1/28/2020,8900,3Txf3ePq,47900,more than downpayment,more than downpayment,0,3900
3tz8bQ6A,9000,3/25/2019,8900,,9000,more than downpayment,,8900,100
3tz8bQ6A,3900,5/2/2019,8900,3tz8bQ6A,12900,more than downpayment,more than downpayment,0,3900
3tz8bQ6A,3900,5/30/2019,8900,3tz8bQ6A,16800,more than downpayment,more than downpayment,0,3900
3tz8bQ6A,3900,7/8/2019,8900,3tz8bQ6A,20700,more than downpayment,more than downpayment,0,3900
3tz8bQ6A,3900,8/5/2019,8900,3tz8bQ6A,24600,more than downpayment,more than downpayment,0,3900
3tz8bQ6A,3900,9/4/2019,8900,3tz8bQ6A,28500,more than downpayment,more than downpayment,0,3900
3tz8bQ6A,3900,10/15/2019,8900,3tz8bQ6A,32400,more than downpayment,more than downpayment,0,3900
3tz8bQ6A,3900,11/8/2019,8900,3tz8bQ6A,36300,more than downpayment,more than downpayment,0,3900
3tz8bQ6A,3900,12/6/2019,8900,3tz8bQ6A,40200,more than downpayment,more than downpayment,0,3900
3tz8bQ6A,3900,1/14/2020,8900,3tz8bQ6A,44100,more than downpayment,more than downpayment,0,3900
3udTPnOw,8900,4/15/2019,8900,,8900,equal to downpayment,,8900,0
3udTPnOw,10000,5/8/2019,8900,3udTPnOw,18900,more than downpayment,equal to downpayment,0,10000
3udTPnOw,7000,6/3/2019,8900,3udTPnOw,25900,more than downpayment,more than downpayment,0,7000
3udTPnOw,3900,7/3/2019,8900,3udTPnOw,29800,more than downpayment,more than downpayment,0,3900
3udTPnOw,3900,8/29/2019,8900,3udTPnOw,33700,more than downpayment,more than downpayment,0,3900
3udTPnOw,3900,12/5/2019,8900,3udTPnOw,37600,more than downpayment,more than downpayment,0,3900
3udTPnOw,2500,1/17/2020,8900,3udTPnOw,40100,more than downpayment,more than downpayment,0,2500
3UZFBRTA,9900,12/22/2019,9900,,9900,equal to downpayment,,9900,0
3uzPxOuw,8900,4/29/2019,8900,,8900,equal to downpayment,,8900,0
3uzPxOuw,1400,5/20/2019,8900,3uzPxOuw,10300,more than downpayment,equal to downpayment,0,1400
3uzPxOuw,1800,5/27/2019,8900,3uzPxOuw,12100,more than downpayment,more than downpayment,0,1800
3uzPxOuw,1300,5/28/2019,8900,3uzPxOuw,13400,more than downpayment,more than downpayment,0,1300
3uzPxOuw,2300,7/3/2019,8900,3uzPxOuw,15700,more than downpayment,more than downpayment,0,2300
3uzPxOuw,1600,7/4/2019,8900,3uzPxOuw,17300,more than downpayment,more than downpayment,0,1600
3uzPxOuw,3900,8/5/2019,8900,3uzPxOuw,21200,more than downpayment,more than downpayment,0,3900
3uzPxOuw,4000,9/5/2019,8900,3uzPxOuw,25200,more than downpayment,more than downpayment,0,4000
3uzPxOuw,2000,10/16/2019,8900,3uzPxOuw,27200,more than downpayment,more than downpayment,0,2000
3uzPxOuw,2000,10/21/2019,8900,3uzPxOuw,29200,more than downpayment,more than downpayment,0,2000
3uzPxOuw,1900,11/4/2019,8900,3uzPxOuw,31100,more than downpayment,more than downpayment,0,1900
3uzPxOuw,1400,11/29/2019,8900,3uzPxOuw,32500,more than downpayment,more than downpayment,0,1400
3uzPxOuw,3700,12/30/2019,8900,3uzPxOuw,36200,more than downpayment,more than downpayment,0,3700
3VYZ1cAC,8900,4/17/2019,8900,,8900,equal to downpayment,,8900,0
3VYZ1cAC,3900,5/24/2019,8900,3VYZ1cAC,12800,more than downpayment,equal to downpayment,0,3900
3VYZ1cAC,3900,7/29/2019,8900,3VYZ1cAC,16700,more than downpayment,more than downpayment,0,3900
3Vz2HEQ2,10000,4/3/2019,10000,,10000,equal to downpayment,,10000,0
3Vz2HEQ2,4500,5/22/2019,10000,3Vz2HEQ2,14500,more than downpayment,equal to downpayment,0,4500
3Vz2HEQ2,4500,6/12/2019,10000,3Vz2HEQ2,19000,more than downpayment,more than downpayment,0,4500
3Vz2HEQ2,4500,7/8/2019,10000,3Vz2HEQ2,23500,more than downpayment,more than downpayment,0,4500
3Vz2HEQ2,4500,8/7/2019,10000,3Vz2HEQ2,28000,more than downpayment,more than downpayment,0,4500
3Vz2HEQ2,4500,9/7/2019,10000,3Vz2HEQ2,32500,more than downpayment,more than downpayment,0,4500
3Vz2HEQ2,4000,10/8/2019,10000,3Vz2HEQ2,36500,more than downpayment,more than downpayment,0,4000
3Vz2HEQ2,5000,11/6/2019,10000,3Vz2HEQ2,41500,more than downpayment,more than downpayment,0,5000
3Vz2HEQ2,4500,12/10/2019,10000,3Vz2HEQ2,46000,more than downpayment,more than downpayment,0,4500
3Vz2HEQ2,4500,1/8/2020,10000,3Vz2HEQ2,50500,more than downpayment,more than downpayment,0,4500
3wsNzqxY,9900,6/28/2019,9900,,9900,equal to downpayment,,9900,0
3wsNzqxY,3900,8/2/2019,9900,3wsNzqxY,13800,more than downpayment,equal to downpayment,0,3900
3wsNzqxY,3900,9/9/2019,9900,3wsNzqxY,17700,more than downpayment,more than downpayment,0,3900
3wsNzqxY,3900,11/5/2019,9900,3wsNzqxY,21600,more than downpayment,more than downpayment,0,3900
3wsNzqxY,2400,12/17/2019,9900,3wsNzqxY,24000,more than downpayment,more than downpayment,0,2400
3wsNzqxY,2800,12/25/2019,9900,3wsNzqxY,26800,more than downpayment,more than downpayment,0,2800
3wsNzqxY,3000,12/31/2019,9900,3wsNzqxY,29800,more than downpayment,more than downpayment,0,3000
3XFSP9H1,9900,6/10/2019,8900,,9900,more than downpayment,,8900,1000
3XFSP9H1,3900,8/6/2019,8900,3XFSP9H1,13800,more than downpayment,more than downpayment,0,3900
3XFSP9H1,3900,9/10/2019,8900,3XFSP9H1,17700,more than downpayment,more than downpayment,0,3900
3XFSP9H1,3900,10/7/2019,8900,3XFSP9H1,21600,more than downpayment,more than downpayment,0,3900
3XFSP9H1,3900,11/6/2019,8900,3XFSP9H1,25500,more than downpayment,more than downpayment,0,3900
3XFSP9H1,3900,12/4/2019,8900,3XFSP9H1,29400,more than downpayment,more than downpayment,0,3900
3XFSP9H1,3900,1/7/2020,8900,3XFSP9H1,33300,more than downpayment,more than downpayment,0,3900
3XFSP9H1,3900,2/3/2020,8900,3XFSP9H1,37200,more than downpayment,more than downpayment,0,3900
3XV1XTM6,2000,11/30/2019,8900,,2000,less than downpayment,,2000,0
3XV1XTM6,1000,12/5/2019,8900,3XV1XTM6,3000,less than downpayment,less than downpayment,1000,0
3XV1XTM6,2000,12/15/2019,8900,3XV1XTM6,5000,less than downpayment,less than downpayment,2000,0
3XV1XTM6,1000,12/22/2019,8900,3XV1XTM6,6000,less than downpayment,less than downpayment,1000,0
3XV1XTM6,4000,1/6/2020,8900,3XV1XTM6,10000,more than downpayment,less than downpayment,2900,1100
3XV1XTM6,4000,1/13/2020,8900,3XV1XTM6,14000,more than downpayment,more than downpayment,0,4000
3xXcOVF1,8900,2/21/2019,8900,,8900,equal to downpayment,,8900,0
3xXcOVF1,3900,4/3/2019,8900,3xXcOVF1,12800,more than downpayment,equal to downpayment,0,3900
3xXcOVF1,3900,5/7/2019,8900,3xXcOVF1,16700,more than downpayment,more than downpayment,0,3900
3xXcOVF1,3900,6/4/2019,8900,3xXcOVF1,20600,more than downpayment,more than downpayment,0,3900
3xXcOVF1,3900,7/4/2019,8900,3xXcOVF1,24500,more than downpayment,more than downpayment,0,3900
3xXcOVF1,3900,8/5/2019,8900,3xXcOVF1,28400,more than downpayment,more than downpayment,0,3900
3xXcOVF1,3900,9/9/2019,8900,3xXcOVF1,32300,more than downpayment,more than downpayment,0,3900
3xXcOVF1,3900,10/6/2019,8900,3xXcOVF1,36200,more than downpayment,more than downpayment,0,3900
3xXcOVF1,3900,11/4/2019,8900,3xXcOVF1,40100,more than downpayment,more than downpayment,0,3900
3xXcOVF1,3900,12/3/2019,8900,3xXcOVF1,44000,more than downpayment,more than downpayment,0,3900
3xXcOVF1,3900,1/6/2020,8900,3xXcOVF1,47900,more than downpayment,more than downpayment,0,3900
3xXcOVF1,3900,2/8/2020,8900,3xXcOVF1,51800,more than downpayment,more than downpayment,0,3900
3YA2QSJ8,9900,6/16/2019,8900,,9900,more than downpayment,,8900,1000
3YA2QSJ8,3900,8/4/2019,8900,3YA2QSJ8,13800,more than downpayment,more than downpayment,0,3900
3YA2QSJ8,3900,9/4/2019,8900,3YA2QSJ8,17700,more than downpayment,more than downpayment,0,3900
3YA2QSJ8,3900,10/3/2019,8900,3YA2QSJ8,21600,more than downpayment,more than downpayment,0,3900
3YA2QSJ8,3900,11/4/2019,8900,3YA2QSJ8,25500,more than downpayment,more than downpayment,0,3900
3YA2QSJ8,3900,12/6/2019,8900,3YA2QSJ8,29400,more than downpayment,more than downpayment,0,3900
3YA2QSJ8,3900,1/7/2020,8900,3YA2QSJ8,33300,more than downpayment,more than downpayment,0,3900
3YA2QSJ8,3900,2/5/2020,8900,3YA2QSJ8,37200,more than downpayment,more than downpayment,0,3900
3Z3WZFPK,9900,12/29/2019,9900,,9900,equal to downpayment,,9900,0
3Z9PMSLP,8900,1/23/2020,8900,,8900,equal to downpayment,,8900,0
3ZG4GW1Y,9900,1/15/2020,9900,,9900,equal to downpayment,,9900,0
3zjsbFv0,26250,8/21/2019,26250,,26250,equal to downpayment,,26250,0
3zjsbFv0,52500,9/20/2019,26250,3zjsbFv0,78750,more than downpayment,equal to downpayment,0,52500
3ZKI7BGT,9900,11/27/2019,9900,,9900,equal to downpayment,,9900,0
3ZKI7BGT,3900,2/7/2020,9900,3ZKI7BGT,13800,more than downpayment,equal to downpayment,0,3900
3ZLl8WiR,10000,8/9/2017,10000,,10000,equal to downpayment,,10000,0
3ZLl8WiR,3500,10/9/2017,10000,3ZLl8WiR,13500,more than downpayment,equal to downpayment,0,3500
3ZLl8WiR,7000,11/9/2017,10000,3ZLl8WiR,20500,more than downpayment,more than downpayment,0,7000
3ZLl8WiR,3500,12/18/2017,10000,3ZLl8WiR,24000,more than downpayment,more than downpayment,0,3500
3ZLl8WiR,7000,1/17/2018,10000,3ZLl8WiR,31000,more than downpayment,more than downpayment,0,7000
3ZLl8WiR,7000,2/18/2018,10000,3ZLl8WiR,38000,more than downpayment,more than downpayment,0,7000
3ZLl8WiR,4000,3/15/2018,10000,3ZLl8WiR,42000,more than downpayment,more than downpayment,0,4000
3ZLl8WiR,3000,5/7/2018,10000,3ZLl8WiR,45000,more than downpayment,more than downpayment,0,3000
40675bdd,8900,9/12/2019,26250,,8900,less than downpayment,,8900,0
40675bdd,3900,10/24/2019,26250,40675bdd,12800,less than downpayment,less than downpayment,3900,0
40675bdd,3900,11/22/2019,26250,40675bdd,16700,less than downpayment,less than downpayment,3900,0
40675bdd,3900,12/27/2019,26250,40675bdd,20600,less than downpayment,less than downpayment,3900,0
40675bdd,84400,12/28/2019,26250,40675bdd,105000,more than downpayment,less than downpayment,5650,78750
406NHsj8,10000,9/19/2017,10000,,10000,equal to downpayment,,10000,0
406NHsj8,5000,9/22/2017,10000,406NHsj8,15000,more than downpayment,equal to downpayment,0,5000
406NHsj8,5000,9/27/2017,10000,406NHsj8,20000,more than downpayment,more than downpayment,0,5000
406NHsj8,3200,10/16/2017,10000,406NHsj8,23200,more than downpayment,more than downpayment,0,3200
406NHsj8,2000,11/12/2017,10000,406NHsj8,25200,more than downpayment,more than downpayment,0,2000
406NHsj8,2200,1/27/2018,10000,406NHsj8,27400,more than downpayment,more than downpayment,0,2200
406NHsj8,2800,2/10/2018,10000,406NHsj8,30200,more than downpayment,more than downpayment,0,2800
406NHsj8,2800,3/7/2018,10000,406NHsj8,33000,more than downpayment,more than downpayment,0,2800
406NHsj8,2500,3/23/2018,10000,406NHsj8,35500,more than downpayment,more than downpayment,0,2500
406NHsj8,2500,4/5/2018,10000,406NHsj8,38000,more than downpayment,more than downpayment,0,2500
406NHsj8,2000,4/8/2018,10000,406NHsj8,40000,more than downpayment,more than downpayment,0,2000
406NHsj8,2500,4/9/2018,10000,406NHsj8,42500,more than downpayment,more than downpayment,0,2500
406NHsj8,3500,4/20/2018,10000,406NHsj8,46000,more than downpayment,more than downpayment,0,3500
406NHsj8,4000,4/24/2018,10000,406NHsj8,50000,more than downpayment,more than downpayment,0,4000
40aff47f,9900,11/13/2019,9900,,9900,equal to downpayment,,9900,0
40aff47f,4000,1/27/2020,9900,40aff47f,13900,more than downpayment,equal to downpayment,0,4000
40MzUe8d,8900,8/27/2019,9900,,8900,less than downpayment,,8900,0
40MzUe8d,3900,9/10/2019,9900,40MzUe8d,12800,more than downpayment,less than downpayment,1000,2900
40MzUe8d,3900,11/11/2019,9900,40MzUe8d,16700,more than downpayment,more than downpayment,0,3900
40MzUe8d,3900,12/10/2019,9900,40MzUe8d,20600,more than downpayment,more than downpayment,0,3900
40MzUe8d,3900,1/9/2020,9900,40MzUe8d,24500,more than downpayment,more than downpayment,0,3900
413jJRvM,8900,5/21/2019,9900,,8900,less than downpayment,,8900,0
413jJRvM,1000,6/13/2019,9900,413jJRvM,9900,equal to downpayment,less than downpayment,1000,0
413jJRvM,5000,6/25/2019,9900,413jJRvM,14900,more than downpayment,equal to downpayment,0,5000
413jJRvM,6000,7/5/2019,9900,413jJRvM,20900,more than downpayment,more than downpayment,0,6000
413jJRvM,4000,8/7/2019,9900,413jJRvM,24900,more than downpayment,more than downpayment,0,4000
413jJRvM,4000,9/4/2019,9900,413jJRvM,28900,more than downpayment,more than downpayment,0,4000
413jJRvM,5000,11/7/2019,9900,413jJRvM,33900,more than downpayment,more than downpayment,0,5000
413jJRvM,4000,1/6/2020,9900,413jJRvM,37900,more than downpayment,more than downpayment,0,4000
413jJRvM,4000,1/31/2020,9900,413jJRvM,41900,more than downpayment,more than downpayment,0,4000
41980456,5,2/6/2020,9900,,5,less than downpayment,,5,0
41LMIB9J,9900,12/13/2019,9900,,9900,equal to downpayment,,9900,0
41LMIB9J,3900,2/5/2020,9900,41LMIB9J,13800,more than downpayment,equal to downpayment,0,3900
41PIW3BA,9900,12/14/2019,9900,,9900,equal to downpayment,,9900,0
425883c3,9900,9/5/2019,9900,,9900,equal to downpayment,,9900,0
425883c3,3900,11/6/2019,9900,425883c3,13800,more than downpayment,equal to downpayment,0,3900
425883c3,3900,12/8/2019,9900,425883c3,17700,more than downpayment,more than downpayment,0,3900
425883c3,3900,1/4/2020,9900,425883c3,21600,more than downpayment,more than downpayment,0,3900
425883c3,3900,2/7/2020,9900,425883c3,25500,more than downpayment,more than downpayment,0,3900
42602337,9900,1/23/2020,9900,,9900,equal to downpayment,,9900,0
42BP1QP1,8900,5/30/2019,9900,,8900,less than downpayment,,8900,0
42BP1QP1,1000,6/25/2019,9900,42BP1QP1,9900,equal to downpayment,less than downpayment,1000,0
42BP1QP1,5000,7/17/2019,9900,42BP1QP1,14900,more than downpayment,equal to downpayment,0,5000
42BP1QP1,3500,8/20/2019,9900,42BP1QP1,18400,more than downpayment,more than downpayment,0,3500
42BP1QP1,4000,9/17/2019,9900,42BP1QP1,22400,more than downpayment,more than downpayment,0,4000
42BP1QP1,4100,10/29/2019,9900,42BP1QP1,26500,more than downpayment,more than downpayment,0,4100
42BP1QP1,4000,11/29/2019,9900,42BP1QP1,30500,more than downpayment,more than downpayment,0,4000
42BP1QP1,4000,1/2/2020,9900,42BP1QP1,34500,more than downpayment,more than downpayment,0,4000
42BP1QP1,4000,1/23/2020,9900,42BP1QP1,38500,more than downpayment,more than downpayment,0,4000
42DKLE3E,9900,6/19/2019,8900,,9900,more than downpayment,,8900,1000
42DKLE3E,3900,7/29/2019,8900,42DKLE3E,13800,more than downpayment,more than downpayment,0,3900
42DKLE3E,3900,8/30/2019,8900,42DKLE3E,17700,more than downpayment,more than downpayment,0,3900
42DKLE3E,3900,10/4/2019,8900,42DKLE3E,21600,more than downpayment,more than downpayment,0,3900
42DKLE3E,3900,11/15/2019,8900,42DKLE3E,25500,more than downpayment,more than downpayment,0,3900
42DKLE3E,6800,1/28/2020,8900,42DKLE3E,32300,more than downpayment,more than downpayment,0,6800
42UXLI5N,26250,7/24/2019,8900,,26250,more than downpayment,,8900,17350
42UXLI5N,53000,12/13/2019,8900,42UXLI5N,79250,more than downpayment,more than downpayment,0,53000
42W42K3H,9900,9/26/2019,9900,,9900,equal to downpayment,,9900,0
42W42K3H,3900,12/2/2019,9900,42W42K3H,13800,more than downpayment,equal to downpayment,0,3900
42W42K3H,4000,1/3/2020,9900,42W42K3H,17800,more than downpayment,more than downpayment,0,4000
42W42K3H,4000,2/6/2020,9900,42W42K3H,21800,more than downpayment,more than downpayment,0,4000
43a0483b,9900,11/4/2019,9900,,9900,equal to downpayment,,9900,0
43a0483b,3900,12/21/2019,9900,43a0483b,13800,more than downpayment,equal to downpayment,0,3900
43EJ6Z5H,10000,10/1/2019,9900,,10000,more than downpayment,,9900,100
43EJ6Z5H,4000,11/6/2019,9900,43EJ6Z5H,14000,more than downpayment,more than downpayment,0,4000
43EJ6Z5H,4000,12/10/2019,9900,43EJ6Z5H,18000,more than downpayment,more than downpayment,0,4000
43EJ6Z5H,4000,1/25/2020,9900,43EJ6Z5H,22000,more than downpayment,more than downpayment,0,4000
440ded92,9900,1/20/2020,9900,,9900,equal to downpayment,,9900,0
445fd524,7900,9/23/2019,7900,,7900,equal to downpayment,,7900,0
445fd524,3100,11/3/2019,7900,445fd524,11000,more than downpayment,equal to downpayment,0,3100
445fd524,3100,12/2/2019,7900,445fd524,14100,more than downpayment,more than downpayment,0,3100
445fd524,3100,1/2/2020,7900,445fd524,17200,more than downpayment,more than downpayment,0,3100
445fd524,3100,2/2/2020,7900,445fd524,20300,more than downpayment,more than downpayment,0,3100
44C6TPSR,9900,8/5/2019,9900,,9900,equal to downpayment,,9900,0
44C6TPSR,3900,9/26/2019,9900,44C6TPSR,13800,more than downpayment,equal to downpayment,0,3900
44C6TPSR,3900,10/26/2019,9900,44C6TPSR,17700,more than downpayment,more than downpayment,0,3900
44C6TPSR,3900,11/29/2019,9900,44C6TPSR,21600,more than downpayment,more than downpayment,0,3900
44C6TPSR,3900,1/3/2020,9900,44C6TPSR,25500,more than downpayment,more than downpayment,0,3900
44GEEMI3,1594,10/14/2019,1594,,1594,equal to downpayment,,1594,0
44GEEMI3,3100,12/18/2019,1594,44GEEMI3,4694,more than downpayment,equal to downpayment,0,3100
453c4f3a,52500,11/15/2019,8900,,52500,more than downpayment,,8900,43600
4550qJCU,9900,11/28/2018,9900,,9900,equal to downpayment,,9900,0
4550qJCU,5000,1/30/2019,9900,4550qJCU,14900,more than downpayment,equal to downpayment,0,5000
4550qJCU,4000,3/13/2019,9900,4550qJCU,18900,more than downpayment,more than downpayment,0,4000
4550qJCU,4500,4/3/2019,9900,4550qJCU,23400,more than downpayment,more than downpayment,0,4500
4550qJCU,8000,6/22/2019,9900,4550qJCU,31400,more than downpayment,more than downpayment,0,8000
4550qJCU,9900,7/29/2019,9900,4550qJCU,41300,more than downpayment,more than downpayment,0,9900
4550qJCU,4600,9/2/2019,9900,4550qJCU,45900,more than downpayment,more than downpayment,0,4600
4550qJCU,4500,9/24/2019,9900,4550qJCU,50400,more than downpayment,more than downpayment,0,4500
4550qJCU,4500,10/29/2019,9900,4550qJCU,54900,more than downpayment,more than downpayment,0,4500
4550qJCU,4500,12/11/2019,9900,4550qJCU,59400,more than downpayment,more than downpayment,0,4500
4550qJCU,4500,1/13/2020,9900,4550qJCU,63900,more than downpayment,more than downpayment,0,4500
45MRVSFV,13800,8/14/2019,9900,,13800,more than downpayment,,9900,3900
45MRVSFV,3900,10/2/2019,9900,45MRVSFV,17700,more than downpayment,more than downpayment,0,3900
45MRVSFV,4000,10/27/2019,9900,45MRVSFV,21700,more than downpayment,more than downpayment,0,4000
45MRVSFV,4000,12/2/2019,9900,45MRVSFV,25700,more than downpayment,more than downpayment,0,4000
45MRVSFV,4000,12/24/2019,9900,45MRVSFV,29700,more than downpayment,more than downpayment,0,4000
45MRVSFV,4000,1/25/2020,9900,45MRVSFV,33700,more than downpayment,more than downpayment,0,4000
45NDDF4D,9900,9/20/2019,9900,,9900,equal to downpayment,,9900,0
45NDDF4D,5000,11/19/2019,9900,45NDDF4D,14900,more than downpayment,equal to downpayment,0,5000
45NDDF4D,5000,12/22/2019,9900,45NDDF4D,19900,more than downpayment,more than downpayment,0,5000
45NDDF4D,3900,1/20/2020,9900,45NDDF4D,23800,more than downpayment,more than downpayment,0,3900
4613f516,8900,9/16/2019,8900,,8900,equal to downpayment,,8900,0
46911203,9900,11/15/2019,9900,,9900,equal to downpayment,,9900,0
46911203,3900,1/25/2020,9900,46911203,13800,more than downpayment,equal to downpayment,0,3900
46cdb666,10000,10/23/2019,9900,,10000,more than downpayment,,9900,100
46cdb666,5000,1/3/2020,9900,46cdb666,15000,more than downpayment,more than downpayment,0,5000
46cdb666,5000,2/6/2020,9900,46cdb666,20000,more than downpayment,more than downpayment,0,5000
46IPIYTR,1599,10/14/2019,1594,,1599,more than downpayment,,1594,5
46MH8ENX,9900,12/30/2019,9900,,9900,equal to downpayment,,9900,0
4.71E+72,9900,12/5/2019,9900,,9900,equal to downpayment,,9900,0
4.71E+72,3900,1/24/2020,9900,4.71E+72,13800,more than downpayment,equal to downpayment,0,3900
47867d51,8900,11/13/2019,8900,,8900,equal to downpayment,,8900,0
47867d51,3900,12/4/2019,8900,47867d51,12800,more than downpayment,equal to downpayment,0,3900
47867d51,3900,1/3/2020,8900,47867d51,16700,more than downpayment,more than downpayment,0,3900
47867d51,3900,2/1/2020,8900,47867d51,20600,more than downpayment,more than downpayment,0,3900
47dae745,7900,9/11/2019,7900,,7900,equal to downpayment,,7900,0
47dae745,4000,10/23/2019,7900,47dae745,11900,more than downpayment,equal to downpayment,0,4000
47dae745,4000,11/21/2019,7900,47dae745,15900,more than downpayment,more than downpayment,0,4000
47dae745,4000,12/20/2019,7900,47dae745,19900,more than downpayment,more than downpayment,0,4000
47dae745,4000,1/21/2020,7900,47dae745,23900,more than downpayment,more than downpayment,0,4000
47MO8PIC,9900,1/3/2020,9900,,9900,equal to downpayment,,9900,0
486acda3,1300,1/14/2020,4999,,1300,less than downpayment,,1300,0
486acda3,700,1/23/2020,4999,486acda3,2000,less than downpayment,less than downpayment,700,0
486acda3,3000,1/28/2020,4999,486acda3,5000,more than downpayment,less than downpayment,2999,1
49422JC8,9900,12/19/2019,9900,,9900,equal to downpayment,,9900,0
498ea93c,5,9/26/2019,9900,,5,less than downpayment,,5,0
49WI7RCY,1594,10/14/2019,8900,,1594,less than downpayment,,1594,0
49WI7RCY,7306,11/13/2019,8900,49WI7RCY,8900,equal to downpayment,less than downpayment,7306,0
49WI7RCY,3900,12/26/2019,8900,49WI7RCY,12800,more than downpayment,equal to downpayment,0,3900
49WI7RCY,3900,1/25/2020,8900,49WI7RCY,16700,more than downpayment,more than downpayment,0,3900
4a152725,8900,10/9/2019,8900,,8900,equal to downpayment,,8900,0
4a152725,5000,11/3/2019,8900,4a152725,13900,more than downpayment,equal to downpayment,0,5000
4a152725,5000,12/6/2019,8900,4a152725,18900,more than downpayment,more than downpayment,0,5000
4a152725,5000,1/6/2020,8900,4a152725,23900,more than downpayment,more than downpayment,0,5000
4A3HWA4C,9900,11/22/2019,9900,,9900,equal to downpayment,,9900,0
4ace85e4,9900,11/11/2019,9900,,9900,equal to downpayment,,9900,0
4ace85e4,3900,12/27/2019,9900,4ace85e4,13800,more than downpayment,equal to downpayment,0,3900
4ace85e4,3900,2/5/2020,9900,4ace85e4,17700,more than downpayment,more than downpayment,0,3900
4b25TihY,8900,2/4/2019,8900,,8900,equal to downpayment,,8900,0
4b25TihY,3900,3/4/2019,8900,4b25TihY,12800,more than downpayment,equal to downpayment,0,3900
4b25TihY,3900,4/5/2019,8900,4b25TihY,16700,more than downpayment,more than downpayment,0,3900
4b25TihY,3900,5/4/2019,8900,4b25TihY,20600,more than downpayment,more than downpayment,0,3900
4b25TihY,3900,6/6/2019,8900,4b25TihY,24500,more than downpayment,more than downpayment,0,3900
4b25TihY,3900,7/6/2019,8900,4b25TihY,28400,more than downpayment,more than downpayment,0,3900
4b25TihY,3900,8/5/2019,8900,4b25TihY,32300,more than downpayment,more than downpayment,0,3900
4b25TihY,3900,9/6/2019,8900,4b25TihY,36200,more than downpayment,more than downpayment,0,3900
4b25TihY,3900,10/7/2019,8900,4b25TihY,40100,more than downpayment,more than downpayment,0,3900
4b25TihY,3900,11/12/2019,8900,4b25TihY,44000,more than downpayment,more than downpayment,0,3900
4b25TihY,3900,12/6/2019,8900,4b25TihY,47900,more than downpayment,more than downpayment,0,3900
4b25TihY,3900,1/7/2020,8900,4b25TihY,51800,more than downpayment,more than downpayment,0,3900
4b25TihY,3900,2/6/2020,8900,4b25TihY,55700,more than downpayment,more than downpayment,0,3900
4b4f16ea,13555,1/16/2020,7900,,13555,more than downpayment,,7900,5655
4Bg8fMcd,8900,2/27/2019,8900,,8900,equal to downpayment,,8900,0
4Bg8fMcd,3900,4/9/2019,8900,4Bg8fMcd,12800,more than downpayment,equal to downpayment,0,3900
4Bg8fMcd,3900,5/6/2019,8900,4Bg8fMcd,16700,more than downpayment,more than downpayment,0,3900
4Bg8fMcd,3900,6/4/2019,8900,4Bg8fMcd,20600,more than downpayment,more than downpayment,0,3900
4Bg8fMcd,3900,7/12/2019,8900,4Bg8fMcd,24500,more than downpayment,more than downpayment,0,3900
4Bg8fMcd,3900,8/7/2019,8900,4Bg8fMcd,28400,more than downpayment,more than downpayment,0,3900
4Bg8fMcd,3900,9/5/2019,8900,4Bg8fMcd,32300,more than downpayment,more than downpayment,0,3900
4Bg8fMcd,3900,10/19/2019,8900,4Bg8fMcd,36200,more than downpayment,more than downpayment,0,3900
4Bg8fMcd,3900,11/7/2019,8900,4Bg8fMcd,40100,more than downpayment,more than downpayment,0,3900
4Bg8fMcd,3000,12/20/2019,8900,4Bg8fMcd,43100,more than downpayment,more than downpayment,0,3000
4Bg8fMcd,900,12/31/2019,8900,4Bg8fMcd,44000,more than downpayment,more than downpayment,0,900
4Bg8fMcd,1000,1/13/2020,8900,4Bg8fMcd,45000,more than downpayment,more than downpayment,0,1000
4Bg8fMcd,2900,1/16/2020,8900,4Bg8fMcd,47900,more than downpayment,more than downpayment,0,2900
4Bg8fMcd,1800,2/6/2020,8900,4Bg8fMcd,49700,more than downpayment,more than downpayment,0,1800
4BKALWZ2,9900,12/30/2019,9900,,9900,equal to downpayment,,9900,0
4c323f33,9900,12/30/2019,9900,,9900,equal to downpayment,,9900,0
4c323f33,3900,2/5/2020,9900,4c323f33,13800,more than downpayment,equal to downpayment,0,3900
4c515e3e,3999,11/14/2019,3999,,3999,equal to downpayment,,3999,0
4c515e3e,3100,1/2/2020,3999,4c515e3e,7099,more than downpayment,equal to downpayment,0,3100
4c515e3e,3100,2/3/2020,3999,4c515e3e,10199,more than downpayment,more than downpayment,0,3100
4c8ce26e,16700,9/20/2019,8900,,16700,more than downpayment,,8900,7800
4c8ce26e,1000,12/5/2019,8900,4c8ce26e,17700,more than downpayment,more than downpayment,0,1000
4c8ce26e,2000,1/6/2020,8900,4c8ce26e,19700,more than downpayment,more than downpayment,0,2000
4c8ce26e,3900,2/4/2020,8900,4c8ce26e,23600,more than downpayment,more than downpayment,0,3900
4CJJL5ZQ,9900,11/12/2019,9900,,9900,equal to downpayment,,9900,0
4CJJL5ZQ,3900,1/3/2020,9900,4CJJL5ZQ,13800,more than downpayment,equal to downpayment,0,3900
4CVIDUGG,9900,11/4/2019,9900,,9900,equal to downpayment,,9900,0
4CVIDUGG,6000,12/27/2019,9900,4CVIDUGG,15900,more than downpayment,equal to downpayment,0,6000
4d2e8a73,8900,9/24/2019,8900,,8900,equal to downpayment,,8900,0
4d2e8a73,3900,10/26/2019,8900,4d2e8a73,12800,more than downpayment,equal to downpayment,0,3900
4d2e8a73,3900,12/4/2019,8900,4d2e8a73,16700,more than downpayment,more than downpayment,0,3900
4d2e8a73,3900,12/26/2019,8900,4d2e8a73,20600,more than downpayment,more than downpayment,0,3900
4d2e8a73,3900,1/29/2020,8900,4d2e8a73,24500,more than downpayment,more than downpayment,0,3900
4d51c94c,26250,1/23/2020,26250,,26250,equal to downpayment,,26250,0
4e5ce9b7,1000,10/8/2019,9900,,1000,less than downpayment,,1000,0
4e5ce9b7,1000,10/23/2019,9900,4e5ce9b7,2000,less than downpayment,less than downpayment,1000,0
4e5ce9b7,7900,1/3/2020,9900,4e5ce9b7,9900,equal to downpayment,less than downpayment,7900,0
4f0c0ef8,9900,1/22/2020,9900,,9900,equal to downpayment,,9900,0
4FOSCGH9,9900,11/19/2019,9900,,9900,equal to downpayment,,9900,0
4FOSCGH9,3900,1/28/2020,9900,4FOSCGH9,13800,more than downpayment,equal to downpayment,0,3900
4gk14bZZ,20000,12/10/2018,8900,,20000,more than downpayment,,8900,11100
4gk14bZZ,5000,1/23/2019,8900,4gk14bZZ,25000,more than downpayment,more than downpayment,0,5000
4gk14bZZ,5000,2/22/2019,8900,4gk14bZZ,30000,more than downpayment,more than downpayment,0,5000
4gk14bZZ,5000,3/23/2019,8900,4gk14bZZ,35000,more than downpayment,more than downpayment,0,5000
4gk14bZZ,5000,4/21/2019,8900,4gk14bZZ,40000,more than downpayment,more than downpayment,0,5000
4gk14bZZ,5000,5/23/2019,8900,4gk14bZZ,45000,more than downpayment,more than downpayment,0,5000
4gk14bZZ,5000,6/22/2019,8900,4gk14bZZ,50000,more than downpayment,more than downpayment,0,5000
4gk14bZZ,5000,7/23/2019,8900,4gk14bZZ,55000,more than downpayment,more than downpayment,0,5000
4gk14bZZ,5000,8/24/2019,8900,4gk14bZZ,60000,more than downpayment,more than downpayment,0,5000
4gk14bZZ,5000,9/24/2019,8900,4gk14bZZ,65000,more than downpayment,more than downpayment,0,5000
4gk14bZZ,5000,10/22/2019,8900,4gk14bZZ,70000,more than downpayment,more than downpayment,0,5000
4gk14bZZ,5000,11/24/2019,8900,4gk14bZZ,75000,more than downpayment,more than downpayment,0,5000
4gk14bZZ,5000,12/22/2019,8900,4gk14bZZ,80000,more than downpayment,more than downpayment,0,5000
4gk14bZZ,3900,1/24/2020,8900,4gk14bZZ,83900,more than downpayment,more than downpayment,0,3900
4GsEQdm9,10000,8/7/2018,10000,,10000,equal to downpayment,,10000,0
4GsEQdm9,4500,9/7/2018,10000,4GsEQdm9,14500,more than downpayment,equal to downpayment,0,4500
4GsEQdm9,4500,10/12/2018,10000,4GsEQdm9,19000,more than downpayment,more than downpayment,0,4500
4GsEQdm9,4500,11/19/2018,10000,4GsEQdm9,23500,more than downpayment,more than downpayment,0,4500
4GsEQdm9,4500,12/22/2018,10000,4GsEQdm9,28000,more than downpayment,more than downpayment,0,4500
4GsEQdm9,4500,1/22/2019,10000,4GsEQdm9,32500,more than downpayment,more than downpayment,0,4500
4GsEQdm9,4500,2/25/2019,10000,4GsEQdm9,37000,more than downpayment,more than downpayment,0,4500
4GsEQdm9,4500,3/25/2019,10000,4GsEQdm9,41500,more than downpayment,more than downpayment,0,4500
4GsEQdm9,4500,4/26/2019,10000,4GsEQdm9,46000,more than downpayment,more than downpayment,0,4500
4GsEQdm9,4500,5/25/2019,10000,4GsEQdm9,50500,more than downpayment,more than downpayment,0,4500
4GsEQdm9,4500,7/2/2019,10000,4GsEQdm9,55000,more than downpayment,more than downpayment,0,4500
4GsEQdm9,4500,7/30/2019,10000,4GsEQdm9,59500,more than downpayment,more than downpayment,0,4500
4GsEQdm9,4500,9/7/2019,10000,4GsEQdm9,64000,more than downpayment,more than downpayment,0,4500
4H8CX8XD,10000,5/20/2019,8900,,10000,more than downpayment,,8900,1100
4H8CX8XD,16000,7/25/2019,8900,4H8CX8XD,26000,more than downpayment,more than downpayment,0,16000
4H8CX8XD,12000,10/25/2019,8900,4H8CX8XD,38000,more than downpayment,more than downpayment,0,12000
4H8CX8XD,12000,1/25/2020,8900,4H8CX8XD,50000,more than downpayment,more than downpayment,0,12000
4HJG6Z4K,9900,8/15/2019,9900,,9900,equal to downpayment,,9900,0
4HJG6Z4K,3900,10/4/2019,9900,4HJG6Z4K,13800,more than downpayment,equal to downpayment,0,3900
4HJG6Z4K,3900,11/4/2019,9900,4HJG6Z4K,17700,more than downpayment,more than downpayment,0,3900
4HJG6Z4K,3900,12/26/2019,9900,4HJG6Z4K,21600,more than downpayment,more than downpayment,0,3900
4HJG6Z4K,3900,1/28/2020,9900,4HJG6Z4K,25500,more than downpayment,more than downpayment,0,3900
4HJQDLDP,9900,1/2/2020,9900,,9900,equal to downpayment,,9900,0
4HJQDLDP,900,1/23/2020,9900,4HJQDLDP,10800,more than downpayment,equal to downpayment,0,900
4IU48UMY,19000,1/22/2020,23400,,19000,less than downpayment,,19000,0
4IU48UMY,4500,1/28/2020,23400,4IU48UMY,23500,more than downpayment,less than downpayment,4400,100
4IZ4FC7C,10000,7/12/2019,8900,,10000,more than downpayment,,8900,1100
4IZ4FC7C,11700,9/6/2019,8900,4IZ4FC7C,21700,more than downpayment,more than downpayment,0,11700
4IZ4FC7C,19500,1/25/2020,8900,4IZ4FC7C,41200,more than downpayment,more than downpayment,0,19500
4j3h4LnS,8900,11/23/2018,8900,,8900,equal to downpayment,,8900,0
4j3h4LnS,3900,12/28/2018,8900,4j3h4LnS,12800,more than downpayment,equal to downpayment,0,3900
4j3h4LnS,3900,2/1/2019,8900,4j3h4LnS,16700,more than downpayment,more than downpayment,0,3900
4j3h4LnS,1400,2/28/2019,8900,4j3h4LnS,18100,more than downpayment,more than downpayment,0,1400
4j3h4LnS,1900,3/9/2019,8900,4j3h4LnS,20000,more than downpayment,more than downpayment,0,1900
4j3h4LnS,500,3/24/2019,8900,4j3h4LnS,20500,more than downpayment,more than downpayment,0,500
4j3h4LnS,500,4/4/2019,8900,4j3h4LnS,21000,more than downpayment,more than downpayment,0,500
4j3h4LnS,500,4/18/2019,8900,4j3h4LnS,21500,more than downpayment,more than downpayment,0,500
4j3h4LnS,500,5/22/2019,8900,4j3h4LnS,22000,more than downpayment,more than downpayment,0,500
4j3h4LnS,500,5/30/2019,8900,4j3h4LnS,22500,more than downpayment,more than downpayment,0,500
4j3h4LnS,500,6/25/2019,8900,4j3h4LnS,23000,more than downpayment,more than downpayment,0,500
4j3h4LnS,500,7/3/2019,8900,4j3h4LnS,23500,more than downpayment,more than downpayment,0,500
4j3h4LnS,100,7/31/2019,8900,4j3h4LnS,23600,more than downpayment,more than downpayment,0,100
4j3h4LnS,300,8/6/2019,8900,4j3h4LnS,23900,more than downpayment,more than downpayment,0,300
4j3h4LnS,200,8/14/2019,8900,4j3h4LnS,24100,more than downpayment,more than downpayment,0,200
4j3h4LnS,200,8/21/2019,8900,4j3h4LnS,24300,more than downpayment,more than downpayment,0,200
4j3h4LnS,200,8/29/2019,8900,4j3h4LnS,24500,more than downpayment,more than downpayment,0,200
4j3h4LnS,500,9/4/2019,8900,4j3h4LnS,25000,more than downpayment,more than downpayment,0,500
4j3h4LnS,10000,10/1/2019,8900,4j3h4LnS,35000,more than downpayment,more than downpayment,0,10000
4j3h4LnS,2000,10/6/2019,8900,4j3h4LnS,37000,more than downpayment,more than downpayment,0,2000
4j3h4LnS,1000,11/2/2019,8900,4j3h4LnS,38000,more than downpayment,more than downpayment,0,1000
4j3h4LnS,1000,11/16/2019,8900,4j3h4LnS,39000,more than downpayment,more than downpayment,0,1000
4j3h4LnS,1000,11/17/2019,8900,4j3h4LnS,40000,more than downpayment,more than downpayment,0,1000
4j3h4LnS,1000,11/26/2019,8900,4j3h4LnS,41000,more than downpayment,more than downpayment,0,1000
4J5H3OFV,1500,11/20/2019,9900,,1500,less than downpayment,,1500,0
4JIhzKgk,7000,6/9/2017,7000,,7000,equal to downpayment,,7000,0
4JIhzKgk,3000,7/18/2017,7000,4JIhzKgk,10000,more than downpayment,equal to downpayment,0,3000
4JIhzKgk,3000,8/15/2017,7000,4JIhzKgk,13000,more than downpayment,more than downpayment,0,3000
4JIhzKgk,3000,9/13/2017,7000,4JIhzKgk,16000,more than downpayment,more than downpayment,0,3000
4JIhzKgk,3000,10/17/2017,7000,4JIhzKgk,19000,more than downpayment,more than downpayment,0,3000
4JIhzKgk,3000,11/13/2017,7000,4JIhzKgk,22000,more than downpayment,more than downpayment,0,3000
4JIhzKgk,3000,12/15/2017,7000,4JIhzKgk,25000,more than downpayment,more than downpayment,0,3000
4JIhzKgk,3000,1/13/2018,7000,4JIhzKgk,28000,more than downpayment,more than downpayment,0,3000
4JIhzKgk,3000,3/1/2018,7000,4JIhzKgk,31000,more than downpayment,more than downpayment,0,3000
4JIhzKgk,4000,3/16/2018,7000,4JIhzKgk,35000,more than downpayment,more than downpayment,0,4000
4jouALvP,6800,5/22/2017,6800,,6800,equal to downpayment,,6800,0
4jouALvP,1000,2/28/2018,6800,4jouALvP,7800,more than downpayment,equal to downpayment,0,1000
4jouALvP,1500,4/17/2018,6800,4jouALvP,9300,more than downpayment,more than downpayment,0,1500
4jouALvP,1100,6/24/2019,6800,4jouALvP,10400,more than downpayment,more than downpayment,0,1100
4jouALvP,800,8/12/2019,6800,4jouALvP,11200,more than downpayment,more than downpayment,0,800
4K6UXJGZ,9900,1/4/2020,9900,,9900,equal to downpayment,,9900,0
4keZC65G,8900,7/18/2019,8900,,8900,equal to downpayment,,8900,0
4keZC65G,7800,9/28/2019,8900,4keZC65G,16700,more than downpayment,equal to downpayment,0,7800
4keZC65G,3900,11/25/2019,8900,4keZC65G,20600,more than downpayment,more than downpayment,0,3900
4keZC65G,3900,12/26/2019,8900,4keZC65G,24500,more than downpayment,more than downpayment,0,3900
4keZC65G,3900,1/25/2020,8900,4keZC65G,28400,more than downpayment,more than downpayment,0,3900
4kVGepWJ,8900,4/15/2019,8900,,8900,equal to downpayment,,8900,0
4kVGepWJ,3900,5/17/2019,8900,4kVGepWJ,12800,more than downpayment,equal to downpayment,0,3900
4kVGepWJ,3900,6/22/2019,8900,4kVGepWJ,16700,more than downpayment,more than downpayment,0,3900
4kVGepWJ,3900,7/18/2019,8900,4kVGepWJ,20600,more than downpayment,more than downpayment,0,3900
4kVGepWJ,3900,8/21/2019,8900,4kVGepWJ,24500,more than downpayment,more than downpayment,0,3900
4kVGepWJ,3900,9/23/2019,8900,4kVGepWJ,28400,more than downpayment,more than downpayment,0,3900
4kVGepWJ,3900,10/21/2019,8900,4kVGepWJ,32300,more than downpayment,more than downpayment,0,3900
4kVGepWJ,3900,11/20/2019,8900,4kVGepWJ,36200,more than downpayment,more than downpayment,0,3900
4kVGepWJ,3900,12/23/2019,8900,4kVGepWJ,40100,more than downpayment,more than downpayment,0,3900
4kVGepWJ,3900,1/24/2020,8900,4kVGepWJ,44000,more than downpayment,more than downpayment,0,3900
4m2CD78D,10000,11/30/2018,10000,,10000,equal to downpayment,,10000,0
4m2CD78D,4500,2/21/2019,10000,4m2CD78D,14500,more than downpayment,equal to downpayment,0,4500
4m2CD78D,4500,3/29/2019,10000,4m2CD78D,19000,more than downpayment,more than downpayment,0,4500
4MV56EA8,9900,1/3/2020,9900,,9900,equal to downpayment,,9900,0
4NMD7IC8,8900,5/25/2019,8900,,8900,equal to downpayment,,8900,0
4NMD7IC8,3900,7/5/2019,8900,4NMD7IC8,12800,more than downpayment,equal to downpayment,0,3900
4NMD7IC8,3900,8/2/2019,8900,4NMD7IC8,16700,more than downpayment,more than downpayment,0,3900
4NMD7IC8,3900,9/6/2019,8900,4NMD7IC8,20600,more than downpayment,more than downpayment,0,3900
4NMD7IC8,3900,10/4/2019,8900,4NMD7IC8,24500,more than downpayment,more than downpayment,0,3900
4NMD7IC8,3900,11/5/2019,8900,4NMD7IC8,28400,more than downpayment,more than downpayment,0,3900
4NMD7IC8,3900,12/4/2019,8900,4NMD7IC8,32300,more than downpayment,more than downpayment,0,3900
4NMD7IC8,3900,1/8/2020,8900,4NMD7IC8,36200,more than downpayment,more than downpayment,0,3900
4NVpgsZZ,17200,4/15/2019,8900,,17200,more than downpayment,,8900,8300
4NVpgsZZ,10000,5/6/2019,8900,4NVpgsZZ,27200,more than downpayment,more than downpayment,0,10000
4NVpgsZZ,10000,10/16/2019,8900,4NVpgsZZ,37200,more than downpayment,more than downpayment,0,10000
4NyNo7nQ,10000,7/12/2019,9900,,10000,more than downpayment,,9900,100
4NyNo7nQ,4000,11/8/2019,9900,4NyNo7nQ,14000,more than downpayment,more than downpayment,0,4000
4NyNo7nQ,3400,12/11/2019,9900,4NyNo7nQ,17400,more than downpayment,more than downpayment,0,3400
4NyNo7nQ,3020,1/23/2020,9900,4NyNo7nQ,20420,more than downpayment,more than downpayment,0,3020
4OXI3LXC,9900,1/13/2020,9900,,9900,equal to downpayment,,9900,0
4PPE7J53,9900,6/28/2019,9900,,9900,equal to downpayment,,9900,0
4PPE7J53,3900,8/18/2019,9900,4PPE7J53,13800,more than downpayment,equal to downpayment,0,3900
4PPE7J53,3900,9/20/2019,9900,4PPE7J53,17700,more than downpayment,more than downpayment,0,3900
4PPE7J53,3900,10/18/2019,9900,4PPE7J53,21600,more than downpayment,more than downpayment,0,3900
4PPE7J53,3900,12/5/2019,9900,4PPE7J53,25500,more than downpayment,more than downpayment,0,3900
4PPE7J53,3900,1/5/2020,9900,4PPE7J53,29400,more than downpayment,more than downpayment,0,3900
4PPE7J53,3900,2/7/2020,9900,4PPE7J53,33300,more than downpayment,more than downpayment,0,3900
4pPriyB1,10000,11/7/2018,10000,,10000,equal to downpayment,,10000,0
4pPriyB1,4500,12/5/2018,10000,4pPriyB1,14500,more than downpayment,equal to downpayment,0,4500
4pPriyB1,2000,12/24/2018,10000,4pPriyB1,16500,more than downpayment,more than downpayment,0,2000
4pPriyB1,1900,1/12/2019,10000,4pPriyB1,18400,more than downpayment,more than downpayment,0,1900
4pPriyB1,5100,1/18/2019,10000,4pPriyB1,23500,more than downpayment,more than downpayment,0,5100
4pPriyB1,4000,3/29/2019,10000,4pPriyB1,27500,more than downpayment,more than downpayment,0,4000
4pPriyB1,5000,4/30/2019,10000,4pPriyB1,32500,more than downpayment,more than downpayment,0,5000
4pPriyB1,4500,6/3/2019,10000,4pPriyB1,37000,more than downpayment,more than downpayment,0,4500
4pPriyB1,4500,6/28/2019,10000,4pPriyB1,41500,more than downpayment,more than downpayment,0,4500
4pPriyB1,4200,7/30/2019,10000,4pPriyB1,45700,more than downpayment,more than downpayment,0,4200
4pPriyB1,500,9/3/2019,10000,4pPriyB1,46200,more than downpayment,more than downpayment,0,500
4pPriyB1,3300,9/26/2019,10000,4pPriyB1,49500,more than downpayment,more than downpayment,0,3300
4pPriyB1,3500,11/29/2019,10000,4pPriyB1,53000,more than downpayment,more than downpayment,0,3500
4PZUQ55D,9900,11/12/2019,9900,,9900,equal to downpayment,,9900,0
4PZUQ55D,3900,2/6/2020,9900,4PZUQ55D,13800,more than downpayment,equal to downpayment,0,3900
4QI1T45I,9900,11/12/2019,9900,,9900,equal to downpayment,,9900,0
4QI1T45I,3900,12/26/2019,9900,4QI1T45I,13800,more than downpayment,equal to downpayment,0,3900
4QI1T45I,4000,1/27/2020,9900,4QI1T45I,17800,more than downpayment,more than downpayment,0,4000
4SCF5FYT,9900,1/19/2020,9900,,9900,equal to downpayment,,9900,0
4Sibixdl,8900,4/30/2019,8900,,8900,equal to downpayment,,8900,0
4Sibixdl,3900,6/1/2019,8900,4Sibixdl,12800,more than downpayment,equal to downpayment,0,3900
4Sibixdl,3900,7/4/2019,8900,4Sibixdl,16700,more than downpayment,more than downpayment,0,3900
4Sibixdl,3900,8/5/2019,8900,4Sibixdl,20600,more than downpayment,more than downpayment,0,3900
4Sibixdl,3900,9/5/2019,8900,4Sibixdl,24500,more than downpayment,more than downpayment,0,3900
4Sibixdl,3900,10/2/2019,8900,4Sibixdl,28400,more than downpayment,more than downpayment,0,3900
4Sibixdl,3900,11/6/2019,8900,4Sibixdl,32300,more than downpayment,more than downpayment,0,3900
4Sibixdl,3900,12/3/2019,8900,4Sibixdl,36200,more than downpayment,more than downpayment,0,3900
4Sibixdl,3000,1/15/2020,8900,4Sibixdl,39200,more than downpayment,more than downpayment,0,3000
4Sibixdl,900,1/17/2020,8900,4Sibixdl,40100,more than downpayment,more than downpayment,0,900
4TN1BIAQ,5000,12/24/2019,4999,,5000,more than downpayment,,4999,1
4TP99G7P,9900,8/26/2019,9900,,9900,equal to downpayment,,9900,0
4TP99G7P,3900,11/13/2019,9900,4TP99G7P,13800,more than downpayment,equal to downpayment,0,3900
4TP99G7P,4000,12/14/2019,9900,4TP99G7P,17800,more than downpayment,more than downpayment,0,4000
4TP99G7P,3900,1/14/2020,9900,4TP99G7P,21700,more than downpayment,more than downpayment,0,3900
4TRXH648,9900,1/4/2020,9900,,9900,equal to downpayment,,9900,0
4U129623,8900,5/21/2019,8900,,8900,equal to downpayment,,8900,0
4U129623,3900,8/16/2019,8900,4U129623,12800,more than downpayment,equal to downpayment,0,3900
4U129623,12000,8/30/2019,8900,4U129623,24800,more than downpayment,more than downpayment,0,12000
4UIVLEYK,9900,11/26/2019,9900,,9900,equal to downpayment,,9900,0
4UIVLEYK,3900,12/26/2019,9900,4UIVLEYK,13800,more than downpayment,equal to downpayment,0,3900
4UIVLEYK,3900,1/31/2020,9900,4UIVLEYK,17700,more than downpayment,more than downpayment,0,3900
4UMXERRC,8900,11/5/2019,8900,,8900,equal to downpayment,,8900,0
4UMXERRC,3900,1/5/2020,8900,4UMXERRC,12800,more than downpayment,equal to downpayment,0,3900
4UMXERRC,4000,2/5/2020,8900,4UMXERRC,16800,more than downpayment,more than downpayment,0,4000
4UZFUREM,8900,11/12/2019,8900,,8900,equal to downpayment,,8900,0
4UZFUREM,3900,12/30/2019,8900,4UZFUREM,12800,more than downpayment,equal to downpayment,0,3900
4UZFUREM,3900,1/29/2020,8900,4UZFUREM,16700,more than downpayment,more than downpayment,0,3900
4W15H424,9900,1/16/2020,9900,,9900,equal to downpayment,,9900,0
4XMOD41Y,9900,1/16/2020,9900,,9900,equal to downpayment,,9900,0
4YJhNDpS,8900,1/29/2019,8900,,8900,equal to downpayment,,8900,0
4YJhNDpS,3900,5/23/2019,8900,4YJhNDpS,12800,more than downpayment,equal to downpayment,0,3900
4YJhNDpS,3900,7/3/2019,8900,4YJhNDpS,16700,more than downpayment,more than downpayment,0,3900
4YJhNDpS,3900,11/7/2019,8900,4YJhNDpS,20600,more than downpayment,more than downpayment,0,3900
4YJhNDpS,3900,12/17/2019,8900,4YJhNDpS,24500,more than downpayment,more than downpayment,0,3900
4YPFgGIg,9000,11/6/2018,8900,,9000,more than downpayment,,8900,100
4YPFgGIg,4000,12/25/2018,8900,4YPFgGIg,13000,more than downpayment,more than downpayment,0,4000
4YPFgGIg,4000,1/25/2019,8900,4YPFgGIg,17000,more than downpayment,more than downpayment,0,4000
4YPFgGIg,4000,2/25/2019,8900,4YPFgGIg,21000,more than downpayment,more than downpayment,0,4000
4YPFgGIg,4000,3/25/2019,8900,4YPFgGIg,25000,more than downpayment,more than downpayment,0,4000
4YPFgGIg,4000,4/26/2019,8900,4YPFgGIg,29000,more than downpayment,more than downpayment,0,4000
4YPFgGIg,2000,6/26/2019,8900,4YPFgGIg,31000,more than downpayment,more than downpayment,0,2000
4YPFgGIg,2000,8/1/2019,8900,4YPFgGIg,33000,more than downpayment,more than downpayment,0,2000
4YPFgGIg,2000,8/7/2019,8900,4YPFgGIg,35000,more than downpayment,more than downpayment,0,2000
4YPFgGIg,2000,8/30/2019,8900,4YPFgGIg,37000,more than downpayment,more than downpayment,0,2000
4YPFgGIg,1500,9/19/2019,8900,4YPFgGIg,38500,more than downpayment,more than downpayment,0,1500
4YPFgGIg,1000,10/2/2019,8900,4YPFgGIg,39500,more than downpayment,more than downpayment,0,1000
4YPFgGIg,1000,10/11/2019,8900,4YPFgGIg,40500,more than downpayment,more than downpayment,0,1000
4YPFgGIg,2000,10/24/2019,8900,4YPFgGIg,42500,more than downpayment,more than downpayment,0,2000
4YPFgGIg,2000,11/11/2019,8900,4YPFgGIg,44500,more than downpayment,more than downpayment,0,2000
4YPFgGIg,4000,11/21/2019,8900,4YPFgGIg,48500,more than downpayment,more than downpayment,0,4000
4YPFgGIg,2000,12/13/2019,8900,4YPFgGIg,50500,more than downpayment,more than downpayment,0,2000
4YPFgGIg,4000,1/6/2020,8900,4YPFgGIg,54500,more than downpayment,more than downpayment,0,4000
4YPFgGIg,2000,1/22/2020,8900,4YPFgGIg,56500,more than downpayment,more than downpayment,0,2000
4YPFgGIg,1000,1/23/2020,8900,4YPFgGIg,57500,more than downpayment,more than downpayment,0,1000
4YPFgGIg,2000,1/31/2020,8900,4YPFgGIg,59500,more than downpayment,more than downpayment,0,2000
4ZBL15FK,9900,12/11/2019,9900,,9900,equal to downpayment,,9900,0
5053bcb0,9900,12/10/2019,9900,,9900,equal to downpayment,,9900,0
50b14840,8900,10/15/2019,8900,,8900,equal to downpayment,,8900,0
50b14840,4000,11/25/2019,8900,50b14840,12900,more than downpayment,equal to downpayment,0,4000
50b14840,4000,12/30/2019,8900,50b14840,16900,more than downpayment,more than downpayment,0,4000
50b14840,4000,1/27/2020,8900,50b14840,20900,more than downpayment,more than downpayment,0,4000
50cd93fc,9900,1/22/2020,8900,,9900,more than downpayment,,8900,1000
51b5b55f,4999,1/31/2020,4999,,4999,equal to downpayment,,4999,0
51ba960f,200,7/29/2019,8900,,200,less than downpayment,,200,0
51DWIAV5,9900,10/2/2019,9900,,9900,equal to downpayment,,9900,0
51DWIAV5,3900,11/15/2019,9900,51DWIAV5,13800,more than downpayment,equal to downpayment,0,3900
51DWIAV5,3900,12/17/2019,9900,51DWIAV5,17700,more than downpayment,more than downpayment,0,3900
51DWIAV5,3900,1/30/2020,9900,51DWIAV5,21600,more than downpayment,more than downpayment,0,3900
51LK2rYY,8900,6/24/2019,8900,,8900,equal to downpayment,,8900,0
51LK2rYY,1000,6/25/2019,8900,51LK2rYY,9900,more than downpayment,equal to downpayment,0,1000
51LK2rYY,3900,7/30/2019,8900,51LK2rYY,13800,more than downpayment,more than downpayment,0,3900
51LK2rYY,3900,9/29/2019,8900,51LK2rYY,17700,more than downpayment,more than downpayment,0,3900
51LK2rYY,3900,10/21/2019,8900,51LK2rYY,21600,more than downpayment,more than downpayment,0,3900
51LK2rYY,3900,11/26/2019,8900,51LK2rYY,25500,more than downpayment,more than downpayment,0,3900
51LK2rYY,3900,12/31/2019,8900,51LK2rYY,29400,more than downpayment,more than downpayment,0,3900
51VwHLlN,8900,1/30/2019,8900,,8900,equal to downpayment,,8900,0
51VwHLlN,3900,3/11/2019,8900,51VwHLlN,12800,more than downpayment,equal to downpayment,0,3900
51VwHLlN,3900,4/8/2019,8900,51VwHLlN,16700,more than downpayment,more than downpayment,0,3900
51VwHLlN,3900,5/30/2019,8900,51VwHLlN,20600,more than downpayment,more than downpayment,0,3900
51VwHLlN,7800,7/9/2019,8900,51VwHLlN,28400,more than downpayment,more than downpayment,0,7800
51VwHLlN,3900,8/20/2019,8900,51VwHLlN,32300,more than downpayment,more than downpayment,0,3900
51VwHLlN,7800,11/9/2019,8900,51VwHLlN,40100,more than downpayment,more than downpayment,0,7800
51VwHLlN,3900,12/17/2019,8900,51VwHLlN,44000,more than downpayment,more than downpayment,0,3900
51VwHLlN,3900,1/17/2020,8900,51VwHLlN,47900,more than downpayment,more than downpayment,0,3900
5259WWAZ,9900,9/18/2019,9900,,9900,equal to downpayment,,9900,0
5259WWAZ,3900,12/25/2019,9900,5259WWAZ,13800,more than downpayment,equal to downpayment,0,3900
5259WWAZ,3900,1/25/2020,9900,5259WWAZ,17700,more than downpayment,more than downpayment,0,3900
529WY4NZ,9900,6/9/2019,8900,,9900,more than downpayment,,8900,1000
529WY4NZ,3900,9/4/2019,8900,529WY4NZ,13800,more than downpayment,more than downpayment,0,3900
529WY4NZ,3400,10/5/2019,8900,529WY4NZ,17200,more than downpayment,more than downpayment,0,3400
529WY4NZ,1000,11/5/2019,8900,529WY4NZ,18200,more than downpayment,more than downpayment,0,1000
529WY4NZ,2500,11/6/2019,8900,529WY4NZ,20700,more than downpayment,more than downpayment,0,2500
529WY4NZ,3900,12/6/2019,8900,529WY4NZ,24600,more than downpayment,more than downpayment,0,3900
529WY4NZ,3900,12/30/2019,8900,529WY4NZ,28500,more than downpayment,more than downpayment,0,3900
529WY4NZ,3900,1/31/2020,8900,529WY4NZ,32400,more than downpayment,more than downpayment,0,3900
52a6a51a,13800,11/12/2019,9900,,13800,more than downpayment,,9900,3900
52b5e119,8900,1/24/2020,8900,,8900,equal to downpayment,,8900,0
52d663c5,9900,10/14/2019,9900,,9900,equal to downpayment,,9900,0
52d663c5,600,11/7/2019,9900,52d663c5,10500,more than downpayment,equal to downpayment,0,600
52d663c5,1000,12/1/2019,9900,52d663c5,11500,more than downpayment,more than downpayment,0,1000
52d663c5,2300,12/4/2019,9900,52d663c5,13800,more than downpayment,more than downpayment,0,2300
52d663c5,500,12/17/2019,9900,52d663c5,14300,more than downpayment,more than downpayment,0,500
52d663c5,1500,1/3/2020,9900,52d663c5,15800,more than downpayment,more than downpayment,0,1500
52d663c5,1900,1/8/2020,9900,52d663c5,17700,more than downpayment,more than downpayment,0,1900
52d663c5,1500,2/2/2020,9900,52d663c5,19200,more than downpayment,more than downpayment,0,1500
52d663c5,300,2/3/2020,9900,52d663c5,19500,more than downpayment,more than downpayment,0,300
52d663c5,600,2/4/2020,9900,52d663c5,20100,more than downpayment,more than downpayment,0,600
52d663c5,1500,2/6/2020,9900,52d663c5,21600,more than downpayment,more than downpayment,0,1500
5321768b,7900,9/23/2019,7900,,7900,equal to downpayment,,7900,0
5321768b,3100,11/5/2019,7900,5321768b,11000,more than downpayment,equal to downpayment,0,3100
5321768b,3100,11/26/2019,7900,5321768b,14100,more than downpayment,more than downpayment,0,3100
5321768b,3100,12/26/2019,7900,5321768b,17200,more than downpayment,more than downpayment,0,3100
5321768b,3100,2/6/2020,7900,5321768b,20300,more than downpayment,more than downpayment,0,3100
532d5398,8900,10/17/2019,8900,,8900,equal to downpayment,,8900,0
532d5398,3900,12/17/2019,8900,532d5398,12800,more than downpayment,equal to downpayment,0,3900
532d5398,3900,1/24/2020,8900,532d5398,16700,more than downpayment,more than downpayment,0,3900
53XHZSQT,9900,6/13/2019,8900,,9900,more than downpayment,,8900,1000
54LSGCQE,14000,6/16/2019,8900,,14000,more than downpayment,,8900,5100
55114568,8900,10/28/2019,8900,,8900,equal to downpayment,,8900,0
55114568,1000,11/6/2019,8900,55114568,9900,more than downpayment,equal to downpayment,0,1000
55114568,3900,12/5/2019,8900,55114568,13800,more than downpayment,more than downpayment,0,3900
55114568,3990,1/9/2020,8900,55114568,17790,more than downpayment,more than downpayment,0,3990
55114568,3900,2/6/2020,8900,55114568,21690,more than downpayment,more than downpayment,0,3900
55c37e0a,8900,10/9/2019,8900,,8900,equal to downpayment,,8900,0
55c37e0a,3900,11/2/2019,8900,55c37e0a,12800,more than downpayment,equal to downpayment,0,3900
55c37e0a,3900,12/4/2019,8900,55c37e0a,16700,more than downpayment,more than downpayment,0,3900
55c37e0a,3900,1/5/2020,8900,55c37e0a,20600,more than downpayment,more than downpayment,0,3900
55c37e0a,3900,2/7/2020,8900,55c37e0a,24500,more than downpayment,more than downpayment,0,3900
55fea4b3,7900,9/23/2019,7900,,7900,equal to downpayment,,7900,0
55fea4b3,3100,10/24/2019,7900,55fea4b3,11000,more than downpayment,equal to downpayment,0,3100
55fea4b3,3100,11/27/2019,7900,55fea4b3,14100,more than downpayment,more than downpayment,0,3100
55fea4b3,3100,12/27/2019,7900,55fea4b3,17200,more than downpayment,more than downpayment,0,3100
55fea4b3,3100,2/5/2020,7900,55fea4b3,20300,more than downpayment,more than downpayment,0,3100
55HLZE3G,9900,1/14/2020,9900,,9900,equal to downpayment,,9900,0
5606de5a,9900,1/2/2020,9900,,9900,equal to downpayment,,9900,0
565ZOUCK,9900,10/9/2019,9900,,9900,equal to downpayment,,9900,0
565ZOUCK,3900,11/25/2019,9900,565ZOUCK,13800,more than downpayment,equal to downpayment,0,3900
565ZOUCK,3900,12/26/2019,9900,565ZOUCK,17700,more than downpayment,more than downpayment,0,3900
565ZOUCK,3900,1/24/2020,9900,565ZOUCK,21600,more than downpayment,more than downpayment,0,3900
56PRTWQJ,9900,11/7/2019,9900,,9900,equal to downpayment,,9900,0
56PRTWQJ,3900,12/27/2019,9900,56PRTWQJ,13800,more than downpayment,equal to downpayment,0,3900
56PRTWQJ,3900,2/5/2020,9900,56PRTWQJ,17700,more than downpayment,more than downpayment,0,3900
5746K5UV,26250,7/31/2019,8900,,26250,more than downpayment,,8900,17350
58aabfde,100,2/7/2020,8900,,100,less than downpayment,,100,0
58aabfde,500,2/9/2020,8900,58aabfde,600,less than downpayment,less than downpayment,500,0
5950e5f5,9900,1/28/2020,9900,,9900,equal to downpayment,,9900,0
59EK5X9M,10000,6/30/2019,8900,,10000,more than downpayment,,8900,1100
59EK5X9M,3900,8/6/2019,8900,59EK5X9M,13900,more than downpayment,more than downpayment,0,3900
59EK5X9M,3900,9/4/2019,8900,59EK5X9M,17800,more than downpayment,more than downpayment,0,3900
59EK5X9M,3900,9/26/2019,8900,59EK5X9M,21700,more than downpayment,more than downpayment,0,3900
59EK5X9M,3900,11/11/2019,8900,59EK5X9M,25600,more than downpayment,more than downpayment,0,3900
59EK5X9M,3900,12/29/2019,8900,59EK5X9M,29500,more than downpayment,more than downpayment,0,3900
59EK5X9M,3900,1/28/2020,8900,59EK5X9M,33400,more than downpayment,more than downpayment,0,3900
59f97e43,8900,1/16/2020,8900,,8900,equal to downpayment,,8900,0
59UHWKKV,8900,12/16/2019,8900,,8900,equal to downpayment,,8900,0
5aaedd18,1000,9/9/2019,9900,,1000,less than downpayment,,1000,0
5aaedd18,1000,9/11/2019,9900,5aaedd18,2000,less than downpayment,less than downpayment,1000,0
5aaedd18,1000,11/13/2019,9900,5aaedd18,3000,less than downpayment,less than downpayment,1000,0
5aaedd18,1000,11/14/2019,9900,5aaedd18,4000,less than downpayment,less than downpayment,1000,0
5aaedd18,500,11/20/2019,9900,5aaedd18,4500,less than downpayment,less than downpayment,500,0
5aaedd18,230,12/4/2019,9900,5aaedd18,4730,less than downpayment,less than downpayment,230,0
5AKPP17F,9900,1/24/2020,9900,,9900,equal to downpayment,,9900,0
5APNG17S,9900,8/2/2019,9900,,9900,equal to downpayment,,9900,0
5APNG17S,3900,9/10/2019,9900,5APNG17S,13800,more than downpayment,equal to downpayment,0,3900
5APNG17S,3900,10/7/2019,9900,5APNG17S,17700,more than downpayment,more than downpayment,0,3900
5APNG17S,3900,11/7/2019,9900,5APNG17S,21600,more than downpayment,more than downpayment,0,3900
5APNG17S,3900,12/13/2019,9900,5APNG17S,25500,more than downpayment,more than downpayment,0,3900
5APNG17S,3900,1/12/2020,9900,5APNG17S,29400,more than downpayment,more than downpayment,0,3900
5BBZD12D,8900,11/20/2019,8900,,8900,equal to downpayment,,8900,0
5BNZBAIT,9900,11/12/2019,9900,,9900,equal to downpayment,,9900,0
5BNZBAIT,3900,1/28/2020,9900,5BNZBAIT,13800,more than downpayment,equal to downpayment,0,3900
5c31feae,8900,11/12/2019,8900,,8900,equal to downpayment,,8900,0
5c31feae,3900,12/27/2019,8900,5c31feae,12800,more than downpayment,equal to downpayment,0,3900
5c31feae,3900,1/27/2020,8900,5c31feae,16700,more than downpayment,more than downpayment,0,3900
5C6XT2SH,9900,1/24/2020,9900,,9900,equal to downpayment,,9900,0
5C7DJNY5,34000,1/7/2020,34000,,34000,equal to downpayment,,34000,0
5c8e523f,8900,11/18/2019,8900,,8900,equal to downpayment,,8900,0
5c8e523f,5000,12/19/2019,8900,5c8e523f,13900,more than downpayment,equal to downpayment,0,5000
5c8e523f,3700,12/30/2019,8900,5c8e523f,17600,more than downpayment,more than downpayment,0,3700
5c8e523f,4000,1/27/2020,8900,5c8e523f,21600,more than downpayment,more than downpayment,0,4000
5CQTWY32,9900,12/27/2019,9900,,9900,equal to downpayment,,9900,0
5d44a591,8999,11/29/2019,8900,,8999,more than downpayment,,8900,99
5d44a591,3810,1/5/2020,8900,5d44a591,12809,more than downpayment,more than downpayment,0,3810
5d44a591,3900,2/4/2020,8900,5d44a591,16709,more than downpayment,more than downpayment,0,3900
5dATsDAs,9900,11/29/2019,9900,,9900,equal to downpayment,,9900,0
5dATsDAs,50,1/21/2020,9900,5dATsDAs,9950,more than downpayment,equal to downpayment,0,50
5dATsDAs,2000,2/3/2020,9900,5dATsDAs,11950,more than downpayment,more than downpayment,0,2000
5dATsDAs,5000,2/6/2020,9900,5dATsDAs,16950,more than downpayment,more than downpayment,0,5000
5DIOSGO1,9900,1/7/2020,9900,,9900,equal to downpayment,,9900,0
5DIOSGO1,3900,2/6/2020,9900,5DIOSGO1,13800,more than downpayment,equal to downpayment,0,3900
5DKDF2PY,9900,9/16/2019,9900,,9900,equal to downpayment,,9900,0
5DKDF2PY,3900,11/7/2019,9900,5DKDF2PY,13800,more than downpayment,equal to downpayment,0,3900
5DKDF2PY,3900,12/6/2019,9900,5DKDF2PY,17700,more than downpayment,more than downpayment,0,3900
5DKDF2PY,3900,1/7/2020,9900,5DKDF2PY,21600,more than downpayment,more than downpayment,0,3900
5DSY3INS,9900,12/21/2019,9900,,9900,equal to downpayment,,9900,0
5EBUVPPX,8900,7/28/2019,8900,,8900,equal to downpayment,,8900,0
5EBUVPPX,3900,9/26/2019,8900,5EBUVPPX,12800,more than downpayment,equal to downpayment,0,3900
5EBUVPPX,3900,10/29/2019,8900,5EBUVPPX,16700,more than downpayment,more than downpayment,0,3900
5EBUVPPX,3900,11/29/2019,8900,5EBUVPPX,20600,more than downpayment,more than downpayment,0,3900
5EBUVPPX,3900,12/26/2019,8900,5EBUVPPX,24500,more than downpayment,more than downpayment,0,3900
5EBUVPPX,3900,1/21/2020,8900,5EBUVPPX,28400,more than downpayment,more than downpayment,0,3900
5EEa54zi,9000,2/6/2019,8900,,9000,more than downpayment,,8900,100
5EEa54zi,5000,3/14/2019,8900,5EEa54zi,14000,more than downpayment,more than downpayment,0,5000
5EEa54zi,5000,4/11/2019,8900,5EEa54zi,19000,more than downpayment,more than downpayment,0,5000
5EEa54zi,4000,5/11/2019,8900,5EEa54zi,23000,more than downpayment,more than downpayment,0,4000
5EEa54zi,8000,5/25/2019,8900,5EEa54zi,31000,more than downpayment,more than downpayment,0,8000
5EEa54zi,4000,6/10/2019,8900,5EEa54zi,35000,more than downpayment,more than downpayment,0,4000
5EEa54zi,5000,6/22/2019,8900,5EEa54zi,40000,more than downpayment,more than downpayment,0,5000
5EEa54zi,5000,7/6/2019,8900,5EEa54zi,45000,more than downpayment,more than downpayment,0,5000
5EEa54zi,4000,7/17/2019,8900,5EEa54zi,49000,more than downpayment,more than downpayment,0,4000
5EEa54zi,4000,8/12/2019,8900,5EEa54zi,53000,more than downpayment,more than downpayment,0,4000
5EEa54zi,3900,9/11/2019,8900,5EEa54zi,56900,more than downpayment,more than downpayment,0,3900
5EEa54zi,3900,10/11/2019,8900,5EEa54zi,60800,more than downpayment,more than downpayment,0,3900
5EEa54zi,3900,11/17/2019,8900,5EEa54zi,64700,more than downpayment,more than downpayment,0,3900
5EEa54zi,3900,12/15/2019,8900,5EEa54zi,68600,more than downpayment,more than downpayment,0,3900
5EEa54zi,3900,12/26/2019,8900,5EEa54zi,72500,more than downpayment,more than downpayment,0,3900
5EEa54zi,3900,1/13/2020,8900,5EEa54zi,76400,more than downpayment,more than downpayment,0,3900
5EEa54zi,3900,1/25/2020,8900,5EEa54zi,80300,more than downpayment,more than downpayment,0,3900
5efbe082,500,1/21/2020,9900,,500,less than downpayment,,500,0
5efbe082,200,1/22/2020,9900,5efbe082,700,less than downpayment,less than downpayment,200,0
5efbe082,200,1/23/2020,9900,5efbe082,900,less than downpayment,less than downpayment,200,0
5efbe082,400,1/28/2020,9900,5efbe082,1300,less than downpayment,less than downpayment,400,0
5efbe082,300,1/29/2020,9900,5efbe082,1600,less than downpayment,less than downpayment,300,0
5efbe082,500,2/6/2020,9900,5efbe082,2100,less than downpayment,less than downpayment,500,0
5EPKGO1A,9900,2/4/2020,9900,,9900,equal to downpayment,,9900,0
5EUQXOU4,9900,11/5/2019,9900,,9900,equal to downpayment,,9900,0
5EUQXOU4,4000,12/5/2019,9900,5EUQXOU4,13900,more than downpayment,equal to downpayment,0,4000
5EUQXOU4,4000,1/5/2020,9900,5EUQXOU4,17900,more than downpayment,more than downpayment,0,4000
5EUQXOU4,4000,2/8/2020,9900,5EUQXOU4,21900,more than downpayment,more than downpayment,0,4000
5f8a29a2,9900,1/8/2020,9900,,9900,equal to downpayment,,9900,0
5FDK5FM7,9900,8/19/2019,9900,,9900,equal to downpayment,,9900,0
5FDK5FM7,3900,10/7/2019,9900,5FDK5FM7,13800,more than downpayment,equal to downpayment,0,3900
5FDK5FM7,3900,11/5/2019,9900,5FDK5FM7,17700,more than downpayment,more than downpayment,0,3900
5FDK5FM7,4000,12/1/2019,9900,5FDK5FM7,21700,more than downpayment,more than downpayment,0,4000
5FDK5FM7,4000,1/4/2020,9900,5FDK5FM7,25700,more than downpayment,more than downpayment,0,4000
5FDK5FM7,3900,2/4/2020,9900,5FDK5FM7,29600,more than downpayment,more than downpayment,0,3900
5FDSCCRY,9900,10/16/2019,9900,,9900,equal to downpayment,,9900,0
5FDSCCRY,3900,11/25/2019,9900,5FDSCCRY,13800,more than downpayment,equal to downpayment,0,3900
5FDSCCRY,3900,12/27/2019,9900,5FDSCCRY,17700,more than downpayment,more than downpayment,0,3900
5FDSCCRY,3900,2/5/2020,9900,5FDSCCRY,21600,more than downpayment,more than downpayment,0,3900
5fffbc63,8900,1/30/2020,8900,,8900,equal to downpayment,,8900,0
5fTqUoiX,8900,8/6/2019,8900,,8900,equal to downpayment,,8900,0
5fTqUoiX,3900,9/16/2019,8900,5fTqUoiX,12800,more than downpayment,equal to downpayment,0,3900
5fTqUoiX,3900,10/16/2019,8900,5fTqUoiX,16700,more than downpayment,more than downpayment,0,3900
5fTqUoiX,3900,11/15/2019,8900,5fTqUoiX,20600,more than downpayment,more than downpayment,0,3900
5fTqUoiX,3900,12/16/2019,8900,5fTqUoiX,24500,more than downpayment,more than downpayment,0,3900
5FVFQS1X,9900,12/19/2019,9900,,9900,equal to downpayment,,9900,0
5GFOEYIB,26500,9/17/2019,26250,,26500,more than downpayment,,26250,250
5GFOEYIB,26167,10/31/2019,26250,5GFOEYIB,52667,more than downpayment,more than downpayment,0,26167
5GFOEYIB,26167,12/18/2019,26250,5GFOEYIB,78834,more than downpayment,more than downpayment,0,26167
5GFOEYIB,26167,1/21/2020,26250,5GFOEYIB,105001,more than downpayment,more than downpayment,0,26167
5i2xxiiu,8900,3/13/2019,8900,,8900,equal to downpayment,,8900,0
5i2xxiiu,3900,5/8/2019,8900,5i2xxiiu,12800,more than downpayment,equal to downpayment,0,3900
5i2xxiiu,3800,6/20/2019,8900,5i2xxiiu,16600,more than downpayment,more than downpayment,0,3800
5i2xxiiu,4000,7/2/2019,8900,5i2xxiiu,20600,more than downpayment,more than downpayment,0,4000
5i2xxiiu,4000,8/8/2019,8900,5i2xxiiu,24600,more than downpayment,more than downpayment,0,4000
5i2xxiiu,3900,9/12/2019,8900,5i2xxiiu,28500,more than downpayment,more than downpayment,0,3900
5i2xxiiu,3800,10/14/2019,8900,5i2xxiiu,32300,more than downpayment,more than downpayment,0,3800
5i2xxiiu,3900,11/12/2019,8900,5i2xxiiu,36200,more than downpayment,more than downpayment,0,3900
5i2xxiiu,3900,11/26/2019,8900,5i2xxiiu,40100,more than downpayment,more than downpayment,0,3900
5i2xxiiu,3900,1/15/2020,8900,5i2xxiiu,44000,more than downpayment,more than downpayment,0,3900
5IGRR55X,8900,12/23/2019,8900,,8900,equal to downpayment,,8900,0
5IHHV6NY,9900,11/13/2019,9900,,9900,equal to downpayment,,9900,0
5IHHV6NY,3900,12/31/2019,9900,5IHHV6NY,13800,more than downpayment,equal to downpayment,0,3900
5iqgouEt,2000,6/28/2019,1999,,2000,more than downpayment,,1999,1
5iqgouEt,2000,8/5/2019,1999,5iqgouEt,4000,more than downpayment,more than downpayment,0,2000
5iqgouEt,2000,9/5/2019,1999,5iqgouEt,6000,more than downpayment,more than downpayment,0,2000
5iqgouEt,2000,10/5/2019,1999,5iqgouEt,8000,more than downpayment,more than downpayment,0,2000
5iqgouEt,2000,11/6/2019,1999,5iqgouEt,10000,more than downpayment,more than downpayment,0,2000
5iqgouEt,2000,12/4/2019,1999,5iqgouEt,12000,more than downpayment,more than downpayment,0,2000
5iqgouEt,2000,1/6/2020,1999,5iqgouEt,14000,more than downpayment,more than downpayment,0,2000
5iqgouEt,2000,2/4/2020,1999,5iqgouEt,16000,more than downpayment,more than downpayment,0,2000
5IY8M7UG,8900,9/19/2019,26250,,8900,less than downpayment,,8900,0
5IY8M7UG,96100,10/15/2019,26250,5IY8M7UG,105000,more than downpayment,less than downpayment,17350,78750
5KEczYc9,9900,9/21/2019,9900,,9900,equal to downpayment,,9900,0
5KEczYc9,3900,11/22/2019,9900,5KEczYc9,13800,more than downpayment,equal to downpayment,0,3900
5KEczYc9,7800,1/9/2020,9900,5KEczYc9,21600,more than downpayment,more than downpayment,0,7800
5KhJIE2i,8900,1/31/2019,8900,,8900,equal to downpayment,,8900,0
5KhJIE2i,3900,4/6/2019,8900,5KhJIE2i,12800,more than downpayment,equal to downpayment,0,3900
5KhJIE2i,7800,5/8/2019,8900,5KhJIE2i,20600,more than downpayment,more than downpayment,0,7800
5KX9YFG4,8900,5/19/2019,8900,,8900,equal to downpayment,,8900,0
5KX9YFG4,3900,7/24/2019,8900,5KX9YFG4,12800,more than downpayment,equal to downpayment,0,3900
5KX9YFG4,3900,8/28/2019,8900,5KX9YFG4,16700,more than downpayment,more than downpayment,0,3900
5KX9YFG4,3900,9/30/2019,8900,5KX9YFG4,20600,more than downpayment,more than downpayment,0,3900
5KX9YFG4,3900,10/28/2019,8900,5KX9YFG4,24500,more than downpayment,more than downpayment,0,3900
5KX9YFG4,3900,11/26/2019,8900,5KX9YFG4,28400,more than downpayment,more than downpayment,0,3900
5KX9YFG4,3900,12/30/2019,8900,5KX9YFG4,32300,more than downpayment,more than downpayment,0,3900
5KX9YFG4,3900,1/31/2020,8900,5KX9YFG4,36200,more than downpayment,more than downpayment,0,3900
5LjMEAt0,8900,4/11/2019,8900,,8900,equal to downpayment,,8900,0
5LjMEAt0,4000,5/10/2019,8900,5LjMEAt0,12900,more than downpayment,equal to downpayment,0,4000
5LjMEAt0,4000,6/13/2019,8900,5LjMEAt0,16900,more than downpayment,more than downpayment,0,4000
5LjMEAt0,4000,7/17/2019,8900,5LjMEAt0,20900,more than downpayment,more than downpayment,0,4000
5LjMEAt0,4000,8/23/2019,8900,5LjMEAt0,24900,more than downpayment,more than downpayment,0,4000
5LjMEAt0,4000,9/24/2019,8900,5LjMEAt0,28900,more than downpayment,more than downpayment,0,4000
5LjMEAt0,4000,10/26/2019,8900,5LjMEAt0,32900,more than downpayment,more than downpayment,0,4000
5LjMEAt0,4000,11/25/2019,8900,5LjMEAt0,36900,more than downpayment,more than downpayment,0,4000
5LjMEAt0,4000,12/26/2019,8900,5LjMEAt0,40900,more than downpayment,more than downpayment,0,4000
5LjMEAt0,4000,1/21/2020,8900,5LjMEAt0,44900,more than downpayment,more than downpayment,0,4000
5lowYhej,8900,8/19/2019,8900,,8900,equal to downpayment,,8900,0
5lowYhej,3900,12/3/2019,8900,5lowYhej,12800,more than downpayment,equal to downpayment,0,3900
5lowYhej,3900,1/8/2020,8900,5lowYhej,16700,more than downpayment,more than downpayment,0,3900
5MIFEBYY,4000,9/17/2019,8900,,4000,less than downpayment,,4000,0
5MIFEBYY,3900,9/23/2019,8900,5MIFEBYY,7900,less than downpayment,less than downpayment,3900,0
5MIFEBYY,2000,9/24/2019,8900,5MIFEBYY,9900,more than downpayment,less than downpayment,1000,1000
5MIFEBYY,3900,12/4/2019,8900,5MIFEBYY,13800,more than downpayment,more than downpayment,0,3900
5MIFEBYY,3900,1/5/2020,8900,5MIFEBYY,17700,more than downpayment,more than downpayment,0,3900
5MIFEBYY,3900,2/4/2020,8900,5MIFEBYY,21600,more than downpayment,more than downpayment,0,3900
5PQV2IDC,9900,11/1/2019,9900,,9900,equal to downpayment,,9900,0
5PQV2IDC,3900,12/4/2019,9900,5PQV2IDC,13800,more than downpayment,equal to downpayment,0,3900
5PQV2IDC,3900,1/22/2020,9900,5PQV2IDC,17700,more than downpayment,more than downpayment,0,3900
5RGWFAHZ,8900,8/11/2019,8900,,8900,equal to downpayment,,8900,0
5RGWFAHZ,3900,9/25/2019,8900,5RGWFAHZ,12800,more than downpayment,equal to downpayment,0,3900
5RGWFAHZ,3900,10/26/2019,8900,5RGWFAHZ,16700,more than downpayment,more than downpayment,0,3900
5RGWFAHZ,3900,11/26/2019,8900,5RGWFAHZ,20600,more than downpayment,more than downpayment,0,3900
5RGWFAHZ,3900,12/26/2019,8900,5RGWFAHZ,24500,more than downpayment,more than downpayment,0,3900
5RGWFAHZ,3900,1/28/2020,8900,5RGWFAHZ,28400,more than downpayment,more than downpayment,0,3900
5S2Q7UB4,10000,12/20/2019,9900,,10000,more than downpayment,,9900,100
5SO4JR4W,9900,8/10/2019,9900,,9900,equal to downpayment,,9900,0
5SO4JR4W,3900,10/4/2019,9900,5SO4JR4W,13800,more than downpayment,equal to downpayment,0,3900
5SO4JR4W,3900,11/5/2019,9900,5SO4JR4W,17700,more than downpayment,more than downpayment,0,3900
5SO4JR4W,3900,12/5/2019,9900,5SO4JR4W,21600,more than downpayment,more than downpayment,0,3900
5SO4JR4W,3900,1/5/2020,9900,5SO4JR4W,25500,more than downpayment,more than downpayment,0,3900
5SO4JR4W,3900,2/6/2020,9900,5SO4JR4W,29400,more than downpayment,more than downpayment,0,3900
5sX11cfh,8900,2/7/2019,8900,,8900,equal to downpayment,,8900,0
5T8QWPAD,8900,10/28/2019,8900,,8900,equal to downpayment,,8900,0
5T8QWPAD,3900,12/28/2019,8900,5T8QWPAD,12800,more than downpayment,equal to downpayment,0,3900
5T8QWPAD,3900,1/25/2020,8900,5T8QWPAD,16700,more than downpayment,more than downpayment,0,3900
5tV3TX42,8900,5/16/2019,8900,,8900,equal to downpayment,,8900,0
5tV3TX42,3900,6/23/2019,8900,5tV3TX42,12800,more than downpayment,equal to downpayment,0,3900
5tV3TX42,3900,7/22/2019,8900,5tV3TX42,16700,more than downpayment,more than downpayment,0,3900
5tV3TX42,3900,8/21/2019,8900,5tV3TX42,20600,more than downpayment,more than downpayment,0,3900
5tV3TX42,3900,9/25/2019,8900,5tV3TX42,24500,more than downpayment,more than downpayment,0,3900
5tV3TX42,3900,10/25/2019,8900,5tV3TX42,28400,more than downpayment,more than downpayment,0,3900
5tV3TX42,3900,11/23/2019,8900,5tV3TX42,32300,more than downpayment,more than downpayment,0,3900
5tV3TX42,3900,12/28/2019,8900,5tV3TX42,36200,more than downpayment,more than downpayment,0,3900
5tV3TX42,3900,1/27/2020,8900,5tV3TX42,40100,more than downpayment,more than downpayment,0,3900
5uh76NG5,10000,8/9/2017,10000,,10000,equal to downpayment,,10000,0
5uh76NG5,7000,1/25/2018,10000,5uh76NG5,17000,more than downpayment,equal to downpayment,0,7000
5uh76NG5,8000,2/12/2018,10000,5uh76NG5,25000,more than downpayment,more than downpayment,0,8000
5uh76NG5,6000,4/10/2018,10000,5uh76NG5,31000,more than downpayment,more than downpayment,0,6000
5UUAAYLG,8900,7/26/2019,8900,,8900,equal to downpayment,,8900,0
5UUAAYLG,3900,9/9/2019,8900,5UUAAYLG,12800,more than downpayment,equal to downpayment,0,3900
5UUAAYLG,3900,10/11/2019,8900,5UUAAYLG,16700,more than downpayment,more than downpayment,0,3900
5UUAAYLG,5300,11/2/2019,8900,5UUAAYLG,22000,more than downpayment,more than downpayment,0,5300
5UUAAYLG,3900,12/7/2019,8900,5UUAAYLG,25900,more than downpayment,more than downpayment,0,3900
5UUAAYLG,3900,1/14/2020,8900,5UUAAYLG,29800,more than downpayment,more than downpayment,0,3900
5UvwuIjn,8900,2/22/2019,8900,,8900,equal to downpayment,,8900,0
5UvwuIjn,3900,3/22/2019,8900,5UvwuIjn,12800,more than downpayment,equal to downpayment,0,3900
5UvwuIjn,3900,4/25/2019,8900,5UvwuIjn,16700,more than downpayment,more than downpayment,0,3900
5UvwuIjn,3900,5/25/2019,8900,5UvwuIjn,20600,more than downpayment,more than downpayment,0,3900
5UvwuIjn,3900,6/25/2019,8900,5UvwuIjn,24500,more than downpayment,more than downpayment,0,3900
5UvwuIjn,3900,7/24/2019,8900,5UvwuIjn,28400,more than downpayment,more than downpayment,0,3900
5UvwuIjn,3900,8/30/2019,8900,5UvwuIjn,32300,more than downpayment,more than downpayment,0,3900
5UvwuIjn,3900,10/3/2019,8900,5UvwuIjn,36200,more than downpayment,more than downpayment,0,3900
5UvwuIjn,3900,11/6/2019,8900,5UvwuIjn,40100,more than downpayment,more than downpayment,0,3900
5UvwuIjn,3900,12/6/2019,8900,5UvwuIjn,44000,more than downpayment,more than downpayment,0,3900
5UvwuIjn,3900,1/6/2020,8900,5UvwuIjn,47900,more than downpayment,more than downpayment,0,3900
5UvwuIjn,3900,2/6/2020,8900,5UvwuIjn,51800,more than downpayment,more than downpayment,0,3900
5V77RWX5,10000,11/21/2019,8900,,10000,more than downpayment,,8900,1100
5V77RWX5,50000,1/16/2020,8900,5V77RWX5,60000,more than downpayment,more than downpayment,0,50000
5V77RWX5,27000,1/23/2020,8900,5V77RWX5,87000,more than downpayment,more than downpayment,0,27000
5V77RWX5,20000,1/29/2020,8900,5V77RWX5,107000,more than downpayment,more than downpayment,0,20000
5VKKzq0z,8900,7/13/2019,8900,,8900,equal to downpayment,,8900,0
5VKKzq0z,10000,8/17/2019,8900,5VKKzq0z,18900,more than downpayment,equal to downpayment,0,10000
5VKKzq0z,3900,9/15/2019,8900,5VKKzq0z,22800,more than downpayment,more than downpayment,0,3900
5VKKzq0z,3900,10/7/2019,8900,5VKKzq0z,26700,more than downpayment,more than downpayment,0,3900
5VKKzq0z,3900,11/18/2019,8900,5VKKzq0z,30600,more than downpayment,more than downpayment,0,3900
5VKKzq0z,3900,12/16/2019,8900,5VKKzq0z,34500,more than downpayment,more than downpayment,0,3900
5VKKzq0z,3900,1/16/2020,8900,5VKKzq0z,38400,more than downpayment,more than downpayment,0,3900
5vkUbWuf,8900,8/30/2019,8900,,8900,equal to downpayment,,8900,0
5vkUbWuf,3900,10/24/2019,8900,5vkUbWuf,12800,more than downpayment,equal to downpayment,0,3900
5vkUbWuf,3900,11/26/2019,8900,5vkUbWuf,16700,more than downpayment,more than downpayment,0,3900
5vkUbWuf,3900,12/30/2019,8900,5vkUbWuf,20600,more than downpayment,more than downpayment,0,3900
5vkUbWuf,3900,1/27/2020,8900,5vkUbWuf,24500,more than downpayment,more than downpayment,0,3900
5X8BPW97,9900,12/2/2019,9900,,9900,equal to downpayment,,9900,0
5XSQFafi,8900,8/8/2019,8900,,8900,equal to downpayment,,8900,0
5XSQFafi,16000,8/22/2019,8900,5XSQFafi,24900,more than downpayment,equal to downpayment,0,16000
5XSQFafi,3900,10/19/2019,8900,5XSQFafi,28800,more than downpayment,more than downpayment,0,3900
5XSQFafi,3900,1/18/2020,8900,5XSQFafi,32700,more than downpayment,more than downpayment,0,3900
5XTGV98J,10000,11/9/2019,9900,,10000,more than downpayment,,9900,100
5Y79U9TC,9900,9/19/2019,9900,,9900,equal to downpayment,,9900,0
5Y79U9TC,4000,11/3/2019,9900,5Y79U9TC,13900,more than downpayment,equal to downpayment,0,4000
5Y79U9TC,3900,12/5/2019,9900,5Y79U9TC,17800,more than downpayment,more than downpayment,0,3900
5Y79U9TC,3900,1/4/2020,9900,5Y79U9TC,21700,more than downpayment,more than downpayment,0,3900
5Y79U9TC,3900,2/3/2020,9900,5Y79U9TC,25600,more than downpayment,more than downpayment,0,3900
5YJNRUE6,8900,1/24/2020,8900,,8900,equal to downpayment,,8900,0
5Yk3SYkr,9900,2/21/2019,9900,,9900,equal to downpayment,,9900,0
5Yk3SYkr,20000,3/13/2019,9900,5Yk3SYkr,29900,more than downpayment,equal to downpayment,0,20000
5Yk3SYkr,10000,5/28/2019,9900,5Yk3SYkr,39900,more than downpayment,more than downpayment,0,10000
5Yk3SYkr,4500,10/10/2019,9900,5Yk3SYkr,44400,more than downpayment,more than downpayment,0,4500
5Yk3SYkr,4500,11/15/2019,9900,5Yk3SYkr,48900,more than downpayment,more than downpayment,0,4500
5Yk3SYkr,4500,12/10/2019,9900,5Yk3SYkr,53400,more than downpayment,more than downpayment,0,4500
5Yk3SYkr,4500,1/20/2020,9900,5Yk3SYkr,57900,more than downpayment,more than downpayment,0,4500
5yQmciUy,8900,7/22/2019,8900,,8900,equal to downpayment,,8900,0
5yQmciUy,4000,9/12/2019,8900,5yQmciUy,12900,more than downpayment,equal to downpayment,0,4000
5yQmciUy,4000,10/14/2019,8900,5yQmciUy,16900,more than downpayment,more than downpayment,0,4000
5yQmciUy,4000,11/12/2019,8900,5yQmciUy,20900,more than downpayment,more than downpayment,0,4000
5yQmciUy,4000,12/12/2019,8900,5yQmciUy,24900,more than downpayment,more than downpayment,0,4000
5yQmciUy,4000,1/8/2020,8900,5yQmciUy,28900,more than downpayment,more than downpayment,0,4000
5yQmciUy,3950,2/7/2020,8900,5yQmciUy,32850,more than downpayment,more than downpayment,0,3950
5ZDKWALP,9900,2/4/2020,9900,,9900,equal to downpayment,,9900,0
5ZHB31VM,2000,6/28/2019,1999,,2000,more than downpayment,,1999,1
5ZHB31VM,2000,7/7/2019,1999,5ZHB31VM,4000,more than downpayment,more than downpayment,0,2000
5ZHB31VM,4000,8/9/2019,1999,5ZHB31VM,8000,more than downpayment,more than downpayment,0,4000
5ZHB31VM,2000,9/21/2019,1999,5ZHB31VM,10000,more than downpayment,more than downpayment,0,2000
5ZHB31VM,2000,9/23/2019,1999,5ZHB31VM,12000,more than downpayment,more than downpayment,0,2000
5ZHB31VM,2000,10/30/2019,1999,5ZHB31VM,14000,more than downpayment,more than downpayment,0,2000
5ZHB31VM,4000,12/18/2019,1999,5ZHB31VM,18000,more than downpayment,more than downpayment,0,4000
5ZUJW7QR,9900,1/18/2020,9900,,9900,equal to downpayment,,9900,0
604AbYDi,9900,1/3/2019,8900,,9900,more than downpayment,,8900,1000
604AbYDi,3900,2/11/2019,8900,604AbYDi,13800,more than downpayment,more than downpayment,0,3900
604AbYDi,3900,3/12/2019,8900,604AbYDi,17700,more than downpayment,more than downpayment,0,3900
604AbYDi,3900,4/16/2019,8900,604AbYDi,21600,more than downpayment,more than downpayment,0,3900
604AbYDi,3900,5/16/2019,8900,604AbYDi,25500,more than downpayment,more than downpayment,0,3900
604AbYDi,3900,6/15/2019,8900,604AbYDi,29400,more than downpayment,more than downpayment,0,3900
604AbYDi,3990,7/16/2019,8900,604AbYDi,33390,more than downpayment,more than downpayment,0,3990
604AbYDi,3900,8/20/2019,8900,604AbYDi,37290,more than downpayment,more than downpayment,0,3900
604AbYDi,3990,9/16/2019,8900,604AbYDi,41280,more than downpayment,more than downpayment,0,3990
604AbYDi,3990,11/15/2019,8900,604AbYDi,45270,more than downpayment,more than downpayment,0,3990
604AbYDi,3990,12/16/2019,8900,604AbYDi,49260,more than downpayment,more than downpayment,0,3990
604AbYDi,3900,1/14/2020,8900,604AbYDi,53160,more than downpayment,more than downpayment,0,3900
60d1cb49,9900,10/22/2019,9900,,9900,equal to downpayment,,9900,0
60d1cb49,3900,1/16/2020,9900,60d1cb49,13800,more than downpayment,equal to downpayment,0,3900
60d1cb49,1000,1/23/2020,9900,60d1cb49,14800,more than downpayment,more than downpayment,0,1000
60d1cb49,2000,1/27/2020,9900,60d1cb49,16800,more than downpayment,more than downpayment,0,2000
60d1cb49,900,1/28/2020,9900,60d1cb49,17700,more than downpayment,more than downpayment,0,900
61IQW5J8,8900,1/22/2020,8900,,8900,equal to downpayment,,8900,0
61RCJRNU,8900,7/17/2019,8900,,8900,equal to downpayment,,8900,0
61RCJRNU,3900,9/4/2019,8900,61RCJRNU,12800,more than downpayment,equal to downpayment,0,3900
61RCJRNU,3900,10/4/2019,8900,61RCJRNU,16700,more than downpayment,more than downpayment,0,3900
61RCJRNU,3900,12/8/2019,8900,61RCJRNU,20600,more than downpayment,more than downpayment,0,3900
61RCJRNU,3900,1/10/2020,8900,61RCJRNU,24500,more than downpayment,more than downpayment,0,3900
61RCJRNU,3900,2/6/2020,8900,61RCJRNU,28400,more than downpayment,more than downpayment,0,3900
6247E6ZL,8900,11/12/2019,8900,,8900,equal to downpayment,,8900,0
6247E6ZL,3900,12/26/2019,8900,6247E6ZL,12800,more than downpayment,equal to downpayment,0,3900
6247E6ZL,3900,1/24/2020,8900,6247E6ZL,16700,more than downpayment,more than downpayment,0,3900
62486a21,11000,11/8/2019,9900,,11000,more than downpayment,,9900,1100
62486a21,1000,11/23/2019,9900,62486a21,12000,more than downpayment,more than downpayment,0,1000
62486a21,1000,11/26/2019,9900,62486a21,13000,more than downpayment,more than downpayment,0,1000
62486a21,5000,2/3/2020,9900,62486a21,18000,more than downpayment,more than downpayment,0,5000
6273db3f,9900,11/20/2019,9900,,9900,equal to downpayment,,9900,0
6273db3f,3900,1/8/2020,9900,6273db3f,13800,more than downpayment,equal to downpayment,0,3900
62B957EF,9900,2/8/2020,9900,,9900,equal to downpayment,,9900,0
62fbb80f,8900,1/7/2020,8900,,8900,equal to downpayment,,8900,0
642a63fa,9900,12/3/2019,9900,,9900,equal to downpayment,,9900,0
642a63fa,3900,1/31/2020,9900,642a63fa,13800,more than downpayment,equal to downpayment,0,3900
64fdaebb,8900,9/30/2019,8900,,8900,equal to downpayment,,8900,0
64fdaebb,4000,11/11/2019,8900,64fdaebb,12900,more than downpayment,equal to downpayment,0,4000
64fdaebb,4000,1/6/2020,8900,64fdaebb,16900,more than downpayment,more than downpayment,0,4000
64FV2FYL,1000,11/11/2019,9900,,1000,less than downpayment,,1000,0
64FV2FYL,10000,11/14/2019,9900,64FV2FYL,11000,more than downpayment,less than downpayment,8900,1100
64FV2FYL,3900,2/5/2020,9900,64FV2FYL,14900,more than downpayment,more than downpayment,0,3900
64WS81P8,1594,10/14/2019,1594,,1594,equal to downpayment,,1594,0
64WS81P8,3100,1/9/2020,1594,64WS81P8,4694,more than downpayment,equal to downpayment,0,3100
64WS81P8,3100,1/29/2020,1594,64WS81P8,7794,more than downpayment,more than downpayment,0,3100
655f711f,9900,10/29/2019,9900,,9900,equal to downpayment,,9900,0
655f711f,3900,12/6/2019,9900,655f711f,13800,more than downpayment,equal to downpayment,0,3900
655f711f,7800,1/29/2020,9900,655f711f,21600,more than downpayment,more than downpayment,0,7800
65IE4RHv,8900,4/12/2019,8900,,8900,equal to downpayment,,8900,0
65IE4RHv,4100,5/25/2019,8900,65IE4RHv,13000,more than downpayment,equal to downpayment,0,4100
65IE4RHv,4100,6/24/2019,8900,65IE4RHv,17100,more than downpayment,more than downpayment,0,4100
65IE4RHv,1000,7/13/2019,8900,65IE4RHv,18100,more than downpayment,more than downpayment,0,1000
65IE4RHv,3900,7/28/2019,8900,65IE4RHv,22000,more than downpayment,more than downpayment,0,3900
65IE4RHv,3900,8/26/2019,8900,65IE4RHv,25900,more than downpayment,more than downpayment,0,3900
65IE4RHv,3900,9/30/2019,8900,65IE4RHv,29800,more than downpayment,more than downpayment,0,3900
65IE4RHv,2650,11/20/2019,8900,65IE4RHv,32450,more than downpayment,more than downpayment,0,2650
65IE4RHv,1250,11/25/2019,8900,65IE4RHv,33700,more than downpayment,more than downpayment,0,1250
65IE4RHv,1400,11/28/2019,8900,65IE4RHv,35100,more than downpayment,more than downpayment,0,1400
65IE4RHv,2400,11/29/2019,8900,65IE4RHv,37500,more than downpayment,more than downpayment,0,2400
65IE4RHv,2600,12/31/2019,8900,65IE4RHv,40100,more than downpayment,more than downpayment,0,2600
65IE4RHv,3999,1/24/2020,8900,65IE4RHv,44099,more than downpayment,more than downpayment,0,3999
65XL8B4D,9900,11/26/2019,9900,,9900,equal to downpayment,,9900,0
65XL8B4D,3900,2/3/2020,9900,65XL8B4D,13800,more than downpayment,equal to downpayment,0,3900
669QeWji,9900,6/10/2019,9900,,9900,equal to downpayment,,9900,0
669QeWji,3900,7/26/2019,9900,669QeWji,13800,more than downpayment,equal to downpayment,0,3900
669QeWji,3900,8/24/2019,9900,669QeWji,17700,more than downpayment,more than downpayment,0,3900
66EgwxAK,8900,3/25/2019,8900,,8900,equal to downpayment,,8900,0
66EgwxAK,1000,4/9/2019,8900,66EgwxAK,9900,more than downpayment,equal to downpayment,0,1000
66EgwxAK,1000,4/27/2019,8900,66EgwxAK,10900,more than downpayment,more than downpayment,0,1000
66EgwxAK,1600,5/1/2019,8900,66EgwxAK,12500,more than downpayment,more than downpayment,0,1600
66EgwxAK,300,5/9/2019,8900,66EgwxAK,12800,more than downpayment,more than downpayment,0,300
66EgwxAK,2000,6/6/2019,8900,66EgwxAK,14800,more than downpayment,more than downpayment,0,2000
66EgwxAK,1200,6/22/2019,8900,66EgwxAK,16000,more than downpayment,more than downpayment,0,1200
6734acd7,9900,7/24/2019,9900,,9900,equal to downpayment,,9900,0
6734acd7,3900,11/5/2019,9900,6734acd7,13800,more than downpayment,equal to downpayment,0,3900
6734acd7,5000,1/4/2020,9900,6734acd7,18800,more than downpayment,more than downpayment,0,5000
68AM7MIP,9900,6/19/2019,9900,,9900,equal to downpayment,,9900,0
68AM7MIP,3900,8/5/2019,9900,68AM7MIP,13800,more than downpayment,equal to downpayment,0,3900
68AM7MIP,3900,9/4/2019,9900,68AM7MIP,17700,more than downpayment,more than downpayment,0,3900
68AM7MIP,3900,10/7/2019,9900,68AM7MIP,21600,more than downpayment,more than downpayment,0,3900
68AM7MIP,3900,11/12/2019,9900,68AM7MIP,25500,more than downpayment,more than downpayment,0,3900
68AM7MIP,3900,12/5/2019,9900,68AM7MIP,29400,more than downpayment,more than downpayment,0,3900
68AM7MIP,3000,1/8/2020,9900,68AM7MIP,32400,more than downpayment,more than downpayment,0,3000
68AM7MIP,900,1/23/2020,9900,68AM7MIP,33300,more than downpayment,more than downpayment,0,900
68eae184,9900,12/10/2019,9900,,9900,equal to downpayment,,9900,0
68eae184,3900,2/4/2020,9900,68eae184,13800,more than downpayment,equal to downpayment,0,3900
68HWXE31,9900,10/11/2019,9900,,9900,equal to downpayment,,9900,0
68HWXE31,3900,11/23/2019,9900,68HWXE31,13800,more than downpayment,equal to downpayment,0,3900
68HWXE31,3900,12/24/2019,9900,68HWXE31,17700,more than downpayment,more than downpayment,0,3900
68HWXE31,3900,1/25/2020,9900,68HWXE31,21600,more than downpayment,more than downpayment,0,3900
69JEunmS,14400,11/8/2018,9900,,14400,more than downpayment,,9900,4500
69JEunmS,500,11/30/2018,9900,69JEunmS,14900,more than downpayment,more than downpayment,0,500
69JEunmS,9000,12/21/2018,9900,69JEunmS,23900,more than downpayment,more than downpayment,0,9000
69JEunmS,4500,2/22/2019,9900,69JEunmS,28400,more than downpayment,more than downpayment,0,4500
69JEunmS,4500,3/22/2019,9900,69JEunmS,32900,more than downpayment,more than downpayment,0,4500
69JEunmS,4500,4/24/2019,9900,69JEunmS,37400,more than downpayment,more than downpayment,0,4500
69JEunmS,4500,5/23/2019,9900,69JEunmS,41900,more than downpayment,more than downpayment,0,4500
69JEunmS,4500,6/24/2019,9900,69JEunmS,46400,more than downpayment,more than downpayment,0,4500
69JEunmS,4500,7/23/2019,9900,69JEunmS,50900,more than downpayment,more than downpayment,0,4500
69JEunmS,4500,8/21/2019,9900,69JEunmS,55400,more than downpayment,more than downpayment,0,4500
69JEunmS,4500,9/19/2019,9900,69JEunmS,59900,more than downpayment,more than downpayment,0,4500
69JEunmS,4500,10/19/2019,9900,69JEunmS,64400,more than downpayment,more than downpayment,0,4500
69JEunmS,4500,11/24/2019,9900,69JEunmS,68900,more than downpayment,more than downpayment,0,4500
69JEunmS,4500,12/24/2019,9900,69JEunmS,73400,more than downpayment,more than downpayment,0,4500
69JEunmS,4500,1/22/2020,9900,69JEunmS,77900,more than downpayment,more than downpayment,0,4500
69ZI5BUV,2000,12/15/2019,9900,,2000,less than downpayment,,2000,0
69ZI5BUV,2000,1/29/2020,9900,69ZI5BUV,4000,less than downpayment,less than downpayment,2000,0
69ZI5BUV,1000,1/30/2020,9900,69ZI5BUV,5000,less than downpayment,less than downpayment,1000,0
6A265RTH,9900,1/22/2020,9900,,9900,equal to downpayment,,9900,0
6a2a7ab3,9900,11/28/2019,8900,,9900,more than downpayment,,8900,1000
6A2B8TEP,8900,11/19/2019,8900,,8900,equal to downpayment,,8900,0
6AF44ZHA,9900,11/16/2019,9900,,9900,equal to downpayment,,9900,0
6AF44ZHA,3900,2/6/2020,9900,6AF44ZHA,13800,more than downpayment,equal to downpayment,0,3900
6b789c9f,9900,10/18/2019,9900,,9900,equal to downpayment,,9900,0
6b789c9f,3900,1/9/2020,9900,6b789c9f,13800,more than downpayment,equal to downpayment,0,3900
6bae151d,8900,10/1/2019,8900,,8900,equal to downpayment,,8900,0
6bae151d,1000,10/4/2019,8900,6bae151d,9900,more than downpayment,equal to downpayment,0,1000
6bae151d,3900,11/4/2019,8900,6bae151d,13800,more than downpayment,more than downpayment,0,3900
6bae151d,3900,12/14/2019,8900,6bae151d,17700,more than downpayment,more than downpayment,0,3900
6bae151d,3900,1/10/2020,8900,6bae151d,21600,more than downpayment,more than downpayment,0,3900
6cfHsF7S,8900,5/27/2019,8900,,8900,equal to downpayment,,8900,0
6cfHsF7S,4000,7/28/2019,8900,6cfHsF7S,12900,more than downpayment,equal to downpayment,0,4000
6cfHsF7S,4000,8/11/2019,8900,6cfHsF7S,16900,more than downpayment,more than downpayment,0,4000
6cfHsF7S,3000,9/1/2019,8900,6cfHsF7S,19900,more than downpayment,more than downpayment,0,3000
6cfHsF7S,3000,10/3/2019,8900,6cfHsF7S,22900,more than downpayment,more than downpayment,0,3000
6cfHsF7S,3000,11/3/2019,8900,6cfHsF7S,25900,more than downpayment,more than downpayment,0,3000
6cfHsF7S,3000,11/25/2019,8900,6cfHsF7S,28900,more than downpayment,more than downpayment,0,3000
6cfHsF7S,3900,12/7/2019,8900,6cfHsF7S,32800,more than downpayment,more than downpayment,0,3900
6cfHsF7S,3000,1/6/2020,8900,6cfHsF7S,35800,more than downpayment,more than downpayment,0,3000
6cfHsF7S,3000,1/27/2020,8900,6cfHsF7S,38800,more than downpayment,more than downpayment,0,3000
6CV81CMZ,9900,6/12/2019,8900,,9900,more than downpayment,,8900,1000
6CV81CMZ,3900,8/5/2019,8900,6CV81CMZ,13800,more than downpayment,more than downpayment,0,3900
6CV81CMZ,3900,9/3/2019,8900,6CV81CMZ,17700,more than downpayment,more than downpayment,0,3900
6CV81CMZ,3900,10/7/2019,8900,6CV81CMZ,21600,more than downpayment,more than downpayment,0,3900
6CV81CMZ,3900,11/5/2019,8900,6CV81CMZ,25500,more than downpayment,more than downpayment,0,3900
6CV81CMZ,3900,12/9/2019,8900,6CV81CMZ,29400,more than downpayment,more than downpayment,0,3900
6CV81CMZ,3900,1/15/2020,8900,6CV81CMZ,33300,more than downpayment,more than downpayment,0,3900
6d62dbd9,26250,9/9/2019,26250,,26250,equal to downpayment,,26250,0
6d62dbd9,10000,11/5/2019,26250,6d62dbd9,36250,more than downpayment,equal to downpayment,0,10000
6d62dbd9,26500,12/3/2019,26250,6d62dbd9,62750,more than downpayment,more than downpayment,0,26500
6DFQJ5UL,9900,11/19/2019,9900,,9900,equal to downpayment,,9900,0
6DFQJ5UL,3900,1/23/2020,9900,6DFQJ5UL,13800,more than downpayment,equal to downpayment,0,3900
6DI86LAW,9900,1/22/2020,9900,,9900,equal to downpayment,,9900,0
6dO2zLA7,9900,9/9/2019,9900,,9900,equal to downpayment,,9900,0
6dO2zLA7,3900,11/5/2019,9900,6dO2zLA7,13800,more than downpayment,equal to downpayment,0,3900
6dO2zLA7,3900,12/3/2019,9900,6dO2zLA7,17700,more than downpayment,more than downpayment,0,3900
6dO2zLA7,3900,1/5/2020,9900,6dO2zLA7,21600,more than downpayment,more than downpayment,0,3900
6dO2zLA7,3900,2/7/2020,9900,6dO2zLA7,25500,more than downpayment,more than downpayment,0,3900
6EFqF5nu,9900,7/11/2019,9900,,9900,equal to downpayment,,9900,0
6EFqF5nu,3900,8/25/2019,9900,6EFqF5nu,13800,more than downpayment,equal to downpayment,0,3900
6EFqF5nu,3900,9/24/2019,9900,6EFqF5nu,17700,more than downpayment,more than downpayment,0,3900
6EFqF5nu,3900,10/24/2019,9900,6EFqF5nu,21600,more than downpayment,more than downpayment,0,3900
6EFqF5nu,3900,12/31/2019,9900,6EFqF5nu,25500,more than downpayment,more than downpayment,0,3900
6EFqF5nu,3900,1/28/2020,9900,6EFqF5nu,29400,more than downpayment,more than downpayment,0,3900
6EJHPOSK,9900,11/12/2019,9900,,9900,equal to downpayment,,9900,0
6EJHPOSK,3900,1/15/2020,9900,6EJHPOSK,13800,more than downpayment,equal to downpayment,0,3900
6f142fd7,18000,9/12/2019,9900,,18000,more than downpayment,,9900,8100
6FHGU7LU,7000,1/19/2020,9900,,7000,less than downpayment,,7000,0
6FHGU7LU,500,1/20/2020,9900,6FHGU7LU,7500,less than downpayment,less than downpayment,500,0
6FHGU7LU,1000,1/22/2020,9900,6FHGU7LU,8500,less than downpayment,less than downpayment,1000,0
6FHGU7LU,500,1/25/2020,9900,6FHGU7LU,9000,less than downpayment,less than downpayment,500,0
6FHGU7LU,900,1/31/2020,9900,6FHGU7LU,9900,equal to downpayment,less than downpayment,900,0
6GBMNIBZ,9900,10/30/2019,9900,,9900,equal to downpayment,,9900,0
6GD4XAKH,10000,11/12/2019,9900,,10000,more than downpayment,,9900,100
6GD4XAKH,5000,12/26/2019,9900,6GD4XAKH,15000,more than downpayment,more than downpayment,0,5000
6GD4XAKH,4000,1/21/2020,9900,6GD4XAKH,19000,more than downpayment,more than downpayment,0,4000
6HB5ZJ5T,9900,6/10/2019,9900,,9900,equal to downpayment,,9900,0
6HB5ZJ5T,3900,8/8/2019,9900,6HB5ZJ5T,13800,more than downpayment,equal to downpayment,0,3900
6HB5ZJ5T,3900,9/13/2019,9900,6HB5ZJ5T,17700,more than downpayment,more than downpayment,0,3900
6HB5ZJ5T,3900,10/17/2019,9900,6HB5ZJ5T,21600,more than downpayment,more than downpayment,0,3900
6HB5ZJ5T,3900,11/13/2019,9900,6HB5ZJ5T,25500,more than downpayment,more than downpayment,0,3900
6HB5ZJ5T,2000,12/18/2019,9900,6HB5ZJ5T,27500,more than downpayment,more than downpayment,0,2000
6HB5ZJ5T,1900,1/4/2020,9900,6HB5ZJ5T,29400,more than downpayment,more than downpayment,0,1900
6HB5ZJ5T,3900,2/5/2020,9900,6HB5ZJ5T,33300,more than downpayment,more than downpayment,0,3900
6hOtbZfA,9000,5/7/2019,8900,,9000,more than downpayment,,8900,100
6hOtbZfA,4100,5/31/2019,8900,6hOtbZfA,13100,more than downpayment,more than downpayment,0,4100
6hOtbZfA,4100,7/2/2019,8900,6hOtbZfA,17200,more than downpayment,more than downpayment,0,4100
6hOtbZfA,4100,8/7/2019,8900,6hOtbZfA,21300,more than downpayment,more than downpayment,0,4100
6hOtbZfA,4000,9/4/2019,8900,6hOtbZfA,25300,more than downpayment,more than downpayment,0,4000
6hOtbZfA,3900,10/14/2019,8900,6hOtbZfA,29200,more than downpayment,more than downpayment,0,3900
6hOtbZfA,3900,11/11/2019,8900,6hOtbZfA,33100,more than downpayment,more than downpayment,0,3900
6hOtbZfA,4000,12/10/2019,8900,6hOtbZfA,37100,more than downpayment,more than downpayment,0,4000
6hOtbZfA,4000,12/23/2019,8900,6hOtbZfA,41100,more than downpayment,more than downpayment,0,4000
6J5hFfT0,8900,7/31/2019,8900,,8900,equal to downpayment,,8900,0
6J5hFfT0,3900,9/30/2019,8900,6J5hFfT0,12800,more than downpayment,equal to downpayment,0,3900
6J5hFfT0,3900,10/31/2019,8900,6J5hFfT0,16700,more than downpayment,more than downpayment,0,3900
6J5hFfT0,3900,12/5/2019,8900,6J5hFfT0,20600,more than downpayment,more than downpayment,0,3900
6J5hFfT0,3900,1/7/2020,8900,6J5hFfT0,24500,more than downpayment,more than downpayment,0,3900
6JYJJO5P,8900,8/5/2019,8900,,8900,equal to downpayment,,8900,0
6JYJJO5P,3900,10/5/2019,8900,6JYJJO5P,12800,more than downpayment,equal to downpayment,0,3900
6JYJJO5P,3900,11/2/2019,8900,6JYJJO5P,16700,more than downpayment,more than downpayment,0,3900
6JYJJO5P,3900,12/3/2019,8900,6JYJJO5P,20600,more than downpayment,more than downpayment,0,3900
6JYJJO5P,3900,12/31/2019,8900,6JYJJO5P,24500,more than downpayment,more than downpayment,0,3900
6JYJJO5P,3900,1/24/2020,8900,6JYJJO5P,28400,more than downpayment,more than downpayment,0,3900
6JYPTRFC,9900,1/10/2020,8900,,9900,more than downpayment,,8900,1000
6Mulhvyl,13000,5/14/2019,8900,,13000,more than downpayment,,8900,4100
6Mulhvyl,4000,6/5/2019,8900,6Mulhvyl,17000,more than downpayment,more than downpayment,0,4000
6Mulhvyl,4000,7/7/2019,8900,6Mulhvyl,21000,more than downpayment,more than downpayment,0,4000
6Mulhvyl,3900,8/9/2019,8900,6Mulhvyl,24900,more than downpayment,more than downpayment,0,3900
6Mulhvyl,3000,9/21/2019,8900,6Mulhvyl,27900,more than downpayment,more than downpayment,0,3000
6Mulhvyl,4000,10/19/2019,8900,6Mulhvyl,31900,more than downpayment,more than downpayment,0,4000
6Mulhvyl,4000,11/6/2019,8900,6Mulhvyl,35900,more than downpayment,more than downpayment,0,4000
6Mulhvyl,4000,12/7/2019,8900,6Mulhvyl,39900,more than downpayment,more than downpayment,0,4000
6Mulhvyl,5000,2/4/2020,8900,6Mulhvyl,44900,more than downpayment,more than downpayment,0,5000
6NOMZKFU,9900,1/15/2020,9900,,9900,equal to downpayment,,9900,0
6nrDEPqu,24500,6/22/2019,8900,,24500,more than downpayment,,8900,15600
6OFQW1I2,9900,6/15/2019,8900,,9900,more than downpayment,,8900,1000
6OFQW1I2,3900,8/24/2019,8900,6OFQW1I2,13800,more than downpayment,more than downpayment,0,3900
6OFQW1I2,3900,9/25/2019,8900,6OFQW1I2,17700,more than downpayment,more than downpayment,0,3900
6OFQW1I2,3900,10/25/2019,8900,6OFQW1I2,21600,more than downpayment,more than downpayment,0,3900
6OFQW1I2,3900,11/25/2019,8900,6OFQW1I2,25500,more than downpayment,more than downpayment,0,3900
6OFQW1I2,3900,12/24/2019,8900,6OFQW1I2,29400,more than downpayment,more than downpayment,0,3900
6OFQW1I2,3900,1/24/2020,8900,6OFQW1I2,33300,more than downpayment,more than downpayment,0,3900
6oGn3cvv,10000,9/25/2018,10000,,10000,equal to downpayment,,10000,0
6oGn3cvv,4500,10/20/2018,10000,6oGn3cvv,14500,more than downpayment,equal to downpayment,0,4500
6oGn3cvv,4500,11/24/2018,10000,6oGn3cvv,19000,more than downpayment,more than downpayment,0,4500
6oGn3cvv,4500,12/24/2018,10000,6oGn3cvv,23500,more than downpayment,more than downpayment,0,4500
6oGn3cvv,4500,1/20/2019,10000,6oGn3cvv,28000,more than downpayment,more than downpayment,0,4500
6oGn3cvv,4500,2/24/2019,10000,6oGn3cvv,32500,more than downpayment,more than downpayment,0,4500
6oGn3cvv,4500,3/24/2019,10000,6oGn3cvv,37000,more than downpayment,more than downpayment,0,4500
6oGn3cvv,4500,4/24/2019,10000,6oGn3cvv,41500,more than downpayment,more than downpayment,0,4500
6oGn3cvv,4500,5/24/2019,10000,6oGn3cvv,46000,more than downpayment,more than downpayment,0,4500
6oGn3cvv,4500,6/24/2019,10000,6oGn3cvv,50500,more than downpayment,more than downpayment,0,4500
6oGn3cvv,4500,7/25/2019,10000,6oGn3cvv,55000,more than downpayment,more than downpayment,0,4500
6oGn3cvv,4500,8/23/2019,10000,6oGn3cvv,59500,more than downpayment,more than downpayment,0,4500
6oGn3cvv,4500,9/24/2019,10000,6oGn3cvv,64000,more than downpayment,more than downpayment,0,4500
6pcdvtwT,10000,9/30/2017,10000,,10000,equal to downpayment,,10000,0
6pcdvtwT,5000,11/6/2017,10000,6pcdvtwT,15000,more than downpayment,equal to downpayment,0,5000
6pcdvtwT,5000,12/6/2017,10000,6pcdvtwT,20000,more than downpayment,more than downpayment,0,5000
6pcdvtwT,5000,1/6/2018,10000,6pcdvtwT,25000,more than downpayment,more than downpayment,0,5000
6pcdvtwT,5000,2/13/2018,10000,6pcdvtwT,30000,more than downpayment,more than downpayment,0,5000
6pcdvtwT,5000,3/13/2018,10000,6pcdvtwT,35000,more than downpayment,more than downpayment,0,5000
6pcdvtwT,5000,4/15/2018,10000,6pcdvtwT,40000,more than downpayment,more than downpayment,0,5000
6pcdvtwT,5000,5/17/2018,10000,6pcdvtwT,45000,more than downpayment,more than downpayment,0,5000
6pcdvtwT,5000,6/11/2018,10000,6pcdvtwT,50000,more than downpayment,more than downpayment,0,5000
6POwGh26,10000,9/14/2018,10000,,10000,equal to downpayment,,10000,0
6POwGh26,4500,10/15/2018,10000,6POwGh26,14500,more than downpayment,equal to downpayment,0,4500
6POwGh26,4500,11/15/2018,10000,6POwGh26,19000,more than downpayment,more than downpayment,0,4500
6POwGh26,4500,12/21/2018,10000,6POwGh26,23500,more than downpayment,more than downpayment,0,4500
6POwGh26,4500,1/16/2019,10000,6POwGh26,28000,more than downpayment,more than downpayment,0,4500
6POwGh26,4500,2/24/2019,10000,6POwGh26,32500,more than downpayment,more than downpayment,0,4500
6POwGh26,4500,3/19/2019,10000,6POwGh26,37000,more than downpayment,more than downpayment,0,4500
6POwGh26,4500,5/10/2019,10000,6POwGh26,41500,more than downpayment,more than downpayment,0,4500
6POwGh26,4500,5/31/2019,10000,6POwGh26,46000,more than downpayment,more than downpayment,0,4500
6POwGh26,4500,6/30/2019,10000,6POwGh26,50500,more than downpayment,more than downpayment,0,4500
6POwGh26,13500,12/31/2019,10000,6POwGh26,64000,more than downpayment,more than downpayment,0,13500
6PTsH98n,8900,9/4/2019,8900,,8900,equal to downpayment,,8900,0
6PTsH98n,4000,12/4/2019,8900,6PTsH98n,12900,more than downpayment,equal to downpayment,0,4000
6PTsH98n,4000,1/3/2020,8900,6PTsH98n,16900,more than downpayment,more than downpayment,0,4000
6PTsH98n,3900,2/7/2020,8900,6PTsH98n,20800,more than downpayment,more than downpayment,0,3900
6q4a7uEH,8900,1/31/2019,8900,,8900,equal to downpayment,,8900,0
6q4a7uEH,3900,3/22/2019,8900,6q4a7uEH,12800,more than downpayment,equal to downpayment,0,3900
6q4a7uEH,3900,4/29/2019,8900,6q4a7uEH,16700,more than downpayment,more than downpayment,0,3900
6qU8RvMP,8900,5/20/2019,8900,,8900,equal to downpayment,,8900,0
6qU8RvMP,300,8/29/2019,8900,6qU8RvMP,9200,more than downpayment,equal to downpayment,0,300
6qU8RvMP,400,9/17/2019,8900,6qU8RvMP,9600,more than downpayment,more than downpayment,0,400
6QZHOMJS,9900,1/20/2020,9900,,9900,equal to downpayment,,9900,0
6R5HFI3P,20,10/20/2019,8900,,20,less than downpayment,,20,0
6RR4WVHD,9900,8/30/2019,9900,,9900,equal to downpayment,,9900,0
6RR4WVHD,3900,12/3/2019,9900,6RR4WVHD,13800,more than downpayment,equal to downpayment,0,3900
6RR4WVHD,3900,2/5/2020,9900,6RR4WVHD,17700,more than downpayment,more than downpayment,0,3900
6SB1I8PD,5000,12/18/2019,7900,,5000,less than downpayment,,5000,0
6seVyTtJ,10000,11/27/2018,10000,,10000,equal to downpayment,,10000,0
6seVyTtJ,4500,1/3/2019,10000,6seVyTtJ,14500,more than downpayment,equal to downpayment,0,4500
6seVyTtJ,9000,2/12/2019,10000,6seVyTtJ,23500,more than downpayment,more than downpayment,0,9000
6seVyTtJ,9000,4/12/2019,10000,6seVyTtJ,32500,more than downpayment,more than downpayment,0,9000
6seVyTtJ,4500,6/10/2019,10000,6seVyTtJ,37000,more than downpayment,more than downpayment,0,4500
6seVyTtJ,5000,8/5/2019,10000,6seVyTtJ,42000,more than downpayment,more than downpayment,0,5000
6TYLGXP9,9900,12/16/2019,9900,,9900,equal to downpayment,,9900,0
6UYN7TW8,1100,1/14/2020,9900,,1100,less than downpayment,,1100,0
6VBCMGN8,9900,1/16/2020,9900,,9900,equal to downpayment,,9900,0
6vmE9FSb,20000,7/13/2017,10000,,20000,more than downpayment,,10000,10000
6vmE9FSb,5000,8/2/2017,10000,6vmE9FSb,25000,more than downpayment,more than downpayment,0,5000
6vmE9FSb,2502,1/31/2018,10000,6vmE9FSb,27502,more than downpayment,more than downpayment,0,2502
6vmE9FSb,2917,2/21/2018,10000,6vmE9FSb,30419,more than downpayment,more than downpayment,0,2917
6vmE9FSb,2502,3/20/2018,10000,6vmE9FSb,32921,more than downpayment,more than downpayment,0,2502
6vmE9FSb,1700,4/19/2018,10000,6vmE9FSb,34621,more than downpayment,more than downpayment,0,1700
6vmE9FSb,2000,5/2/2018,10000,6vmE9FSb,36621,more than downpayment,more than downpayment,0,2000
6vmE9FSb,2000,6/8/2018,10000,6vmE9FSb,38621,more than downpayment,more than downpayment,0,2000
6vmE9FSb,6379,8/15/2018,10000,6vmE9FSb,45000,more than downpayment,more than downpayment,0,6379
6WGK9MNQ,10000,1/15/2020,9900,,10000,more than downpayment,,9900,100
6wXu0A9y,10000,11/26/2018,10000,,10000,equal to downpayment,,10000,0
6wXu0A9y,8000,1/10/2019,10000,6wXu0A9y,18000,more than downpayment,equal to downpayment,0,8000
6wXu0A9y,4500,2/6/2019,10000,6wXu0A9y,22500,more than downpayment,more than downpayment,0,4500
6wXu0A9y,5000,3/2/2019,10000,6wXu0A9y,27500,more than downpayment,more than downpayment,0,5000
6wXu0A9y,5000,3/27/2019,10000,6wXu0A9y,32500,more than downpayment,more than downpayment,0,5000
6wXu0A9y,5000,4/26/2019,10000,6wXu0A9y,37500,more than downpayment,more than downpayment,0,5000
6wXu0A9y,5000,5/27/2019,10000,6wXu0A9y,42500,more than downpayment,more than downpayment,0,5000
6wXu0A9y,5000,6/26/2019,10000,6wXu0A9y,47500,more than downpayment,more than downpayment,0,5000
6wXu0A9y,5000,7/19/2019,10000,6wXu0A9y,52500,more than downpayment,more than downpayment,0,5000
6wXu0A9y,5000,8/27/2019,10000,6wXu0A9y,57500,more than downpayment,more than downpayment,0,5000
6wXu0A9y,5000,9/25/2019,10000,6wXu0A9y,62500,more than downpayment,more than downpayment,0,5000
6wXu0A9y,1500,9/26/2019,10000,6wXu0A9y,64000,more than downpayment,more than downpayment,0,1500
6xBfIKVe,8900,1/30/2019,8900,,8900,equal to downpayment,,8900,0
6xBfIKVe,3900,3/4/2019,8900,6xBfIKVe,12800,more than downpayment,equal to downpayment,0,3900
6xBfIKVe,3900,4/8/2019,8900,6xBfIKVe,16700,more than downpayment,more than downpayment,0,3900
6xBfIKVe,3900,5/3/2019,8900,6xBfIKVe,20600,more than downpayment,more than downpayment,0,3900
6xBfIKVe,3900,6/5/2019,8900,6xBfIKVe,24500,more than downpayment,more than downpayment,0,3900
6xBfIKVe,3900,7/6/2019,8900,6xBfIKVe,28400,more than downpayment,more than downpayment,0,3900
6xBfIKVe,3900,8/2/2019,8900,6xBfIKVe,32300,more than downpayment,more than downpayment,0,3900
6xBfIKVe,3900,8/31/2019,8900,6xBfIKVe,36200,more than downpayment,more than downpayment,0,3900
6xBfIKVe,3900,10/7/2019,8900,6xBfIKVe,40100,more than downpayment,more than downpayment,0,3900
6xBfIKVe,3900,11/4/2019,8900,6xBfIKVe,44000,more than downpayment,more than downpayment,0,3900
6xBfIKVe,3900,12/4/2019,8900,6xBfIKVe,47900,more than downpayment,more than downpayment,0,3900
6xBfIKVe,3900,12/26/2019,8900,6xBfIKVe,51800,more than downpayment,more than downpayment,0,3900
6xBfIKVe,3900,2/6/2020,8900,6xBfIKVe,55700,more than downpayment,more than downpayment,0,3900
6yaE2u0H,3900,8/25/2019,8900,,3900,less than downpayment,,3900,0
6yaE2u0H,9900,8/30/2019,8900,6yaE2u0H,13800,more than downpayment,less than downpayment,5000,4900
6yaE2u0H,3900,12/1/2019,8900,6yaE2u0H,17700,more than downpayment,more than downpayment,0,3900
6yaE2u0H,3900,12/30/2019,8900,6yaE2u0H,21600,more than downpayment,more than downpayment,0,3900
6YqrXDIE,8900,4/3/2019,8900,,8900,equal to downpayment,,8900,0
6YqrXDIE,3900,5/5/2019,8900,6YqrXDIE,12800,more than downpayment,equal to downpayment,0,3900
6YqrXDIE,3900,6/4/2019,8900,6YqrXDIE,16700,more than downpayment,more than downpayment,0,3900
6YqrXDIE,3900,7/6/2019,8900,6YqrXDIE,20600,more than downpayment,more than downpayment,0,3900
6YqrXDIE,3900,8/6/2019,8900,6YqrXDIE,24500,more than downpayment,more than downpayment,0,3900
6YqrXDIE,3900,9/6/2019,8900,6YqrXDIE,28400,more than downpayment,more than downpayment,0,3900
6YqrXDIE,3900,10/6/2019,8900,6YqrXDIE,32300,more than downpayment,more than downpayment,0,3900
6YqrXDIE,3900,11/5/2019,8900,6YqrXDIE,36200,more than downpayment,more than downpayment,0,3900
6YqrXDIE,3900,12/5/2019,8900,6YqrXDIE,40100,more than downpayment,more than downpayment,0,3900
6YqrXDIE,3900,1/8/2020,8900,6YqrXDIE,44000,more than downpayment,more than downpayment,0,3900
6YqrXDIE,3900,2/6/2020,8900,6YqrXDIE,47900,more than downpayment,more than downpayment,0,3900
7004041e,9900,10/2/2019,9900,,9900,equal to downpayment,,9900,0
7004041e,1000,12/16/2019,9900,7004041e,10900,more than downpayment,equal to downpayment,0,1000
7004041e,2900,12/18/2019,9900,7004041e,13800,more than downpayment,more than downpayment,0,2900
7004041e,850,12/27/2019,9900,7004041e,14650,more than downpayment,more than downpayment,0,850
7004041e,850,12/29/2019,9900,7004041e,15500,more than downpayment,more than downpayment,0,850
7004041e,1000,1/1/2020,9900,7004041e,16500,more than downpayment,more than downpayment,0,1000
7004041e,400,1/5/2020,9900,7004041e,16900,more than downpayment,more than downpayment,0,400
7004041e,800,1/9/2020,9900,7004041e,17700,more than downpayment,more than downpayment,0,800
7004041e,500,1/25/2020,9900,7004041e,18200,more than downpayment,more than downpayment,0,500
7004041e,3400,2/3/2020,9900,7004041e,21600,more than downpayment,more than downpayment,0,3400
700b47d0,8900,9/13/2019,8900,,8900,equal to downpayment,,8900,0
700b47d0,4000,10/13/2019,8900,700b47d0,12900,more than downpayment,equal to downpayment,0,4000
700b47d0,4000,11/29/2019,8900,700b47d0,16900,more than downpayment,more than downpayment,0,4000
700b47d0,3900,12/26/2019,8900,700b47d0,20800,more than downpayment,more than downpayment,0,3900
700b47d0,3700,1/28/2020,8900,700b47d0,24500,more than downpayment,more than downpayment,0,3700
7028176f,8900,10/31/2019,8900,,8900,equal to downpayment,,8900,0
7028176f,1000,11/11/2019,8900,7028176f,9900,more than downpayment,equal to downpayment,0,1000
7028176f,4000,12/28/2019,8900,7028176f,13900,more than downpayment,more than downpayment,0,4000
702de2ae,9900,10/25/2019,9900,,9900,equal to downpayment,,9900,0
702de2ae,3900,12/4/2019,9900,702de2ae,13800,more than downpayment,equal to downpayment,0,3900
702de2ae,3900,12/27/2019,9900,702de2ae,17700,more than downpayment,more than downpayment,0,3900
702de2ae,3900,2/3/2020,9900,702de2ae,21600,more than downpayment,more than downpayment,0,3900
70b3a89b,8900,1/11/2020,8900,,8900,equal to downpayment,,8900,0
70JXlA2K,8900,5/21/2019,8900,,8900,equal to downpayment,,8900,0
70JXlA2K,8000,8/9/2019,8900,70JXlA2K,16900,more than downpayment,equal to downpayment,0,8000
714d54ed,9900,1/3/2020,9900,,9900,equal to downpayment,,9900,0
71724bf4,8900,12/21/2019,8900,,8900,equal to downpayment,,8900,0
717icZSX,10000,9/28/2018,10000,,10000,equal to downpayment,,10000,0
717icZSX,10000,10/21/2018,10000,717icZSX,20000,more than downpayment,equal to downpayment,0,10000
717icZSX,5500,11/9/2018,10000,717icZSX,25500,more than downpayment,more than downpayment,0,5500
717icZSX,10000,12/8/2018,10000,717icZSX,35500,more than downpayment,more than downpayment,0,10000
717icZSX,5500,1/15/2019,10000,717icZSX,41000,more than downpayment,more than downpayment,0,5500
717icZSX,5500,2/2/2019,10000,717icZSX,46500,more than downpayment,more than downpayment,0,5500
717icZSX,10000,3/4/2019,10000,717icZSX,56500,more than downpayment,more than downpayment,0,10000
717icZSX,4500,4/4/2019,10000,717icZSX,61000,more than downpayment,more than downpayment,0,4500
717icZSX,5500,5/11/2019,10000,717icZSX,66500,more than downpayment,more than downpayment,0,5500
717icZSX,5300,8/5/2019,10000,717icZSX,71800,more than downpayment,more than downpayment,0,5300
717icZSX,5000,8/24/2019,10000,717icZSX,76800,more than downpayment,more than downpayment,0,5000
717J3EME,10000,12/4/2019,9900,,10000,more than downpayment,,9900,100
717J3EME,130,2/6/2020,9900,717J3EME,10130,more than downpayment,more than downpayment,0,130
717J3EME,130,2/7/2020,9900,717J3EME,10260,more than downpayment,more than downpayment,0,130
718CNBYW,8900,8/29/2019,8900,,8900,equal to downpayment,,8900,0
718CNBYW,10000,11/23/2019,8900,718CNBYW,18900,more than downpayment,equal to downpayment,0,10000
718CNBYW,10000,1/22/2020,8900,718CNBYW,28900,more than downpayment,more than downpayment,0,10000
7192dbec,9900,9/27/2019,9900,,9900,equal to downpayment,,9900,0
7192dbec,3900,11/6/2019,9900,7192dbec,13800,more than downpayment,equal to downpayment,0,3900
7192dbec,7800,12/24/2019,9900,7192dbec,21600,more than downpayment,more than downpayment,0,7800
719AL3HR,9900,2/6/2020,9900,,9900,equal to downpayment,,9900,0
719eeede,8900,1/18/2020,8900,,8900,equal to downpayment,,8900,0
71ATLVDR,9900,11/14/2019,9900,,9900,equal to downpayment,,9900,0
71ATLVDR,3900,1/17/2020,9900,71ATLVDR,13800,more than downpayment,equal to downpayment,0,3900
71b6b92d,8900,10/9/2019,8900,,8900,equal to downpayment,,8900,0
71b6b92d,3900,11/2/2019,8900,71b6b92d,12800,more than downpayment,equal to downpayment,0,3900
71b6b92d,3900,12/4/2019,8900,71b6b92d,16700,more than downpayment,more than downpayment,0,3900
71b6b92d,3900,1/5/2020,8900,71b6b92d,20600,more than downpayment,more than downpayment,0,3900
71b6b92d,3900,2/7/2020,8900,71b6b92d,24500,more than downpayment,more than downpayment,0,3900
7206d522,8000,11/12/2019,7900,,8000,more than downpayment,,7900,100
7206d522,4000,12/4/2019,7900,7206d522,12000,more than downpayment,more than downpayment,0,4000
7206d522,4500,12/25/2019,7900,7206d522,16500,more than downpayment,more than downpayment,0,4500
7206d522,4000,1/30/2020,7900,7206d522,20500,more than downpayment,more than downpayment,0,4000
726b39f0,9900,12/11/2019,9900,,9900,equal to downpayment,,9900,0
726b39f0,5000,2/7/2020,9900,726b39f0,14900,more than downpayment,equal to downpayment,0,5000
7279c434,9900,1/21/2020,9900,,9900,equal to downpayment,,9900,0
72aa1273,9900,11/5/2019,9900,,9900,equal to downpayment,,9900,0
72aa1273,3900,12/25/2019,9900,72aa1273,13800,more than downpayment,equal to downpayment,0,3900
72aa1273,3900,1/24/2020,9900,72aa1273,17700,more than downpayment,more than downpayment,0,3900
72ba83cf,8900,11/18/2019,8900,,8900,equal to downpayment,,8900,0
72ba83cf,3900,1/17/2020,8900,72ba83cf,12800,more than downpayment,equal to downpayment,0,3900
72KEHL3E,10000,6/5/2019,9900,,10000,more than downpayment,,9900,100
72KEHL3E,4000,7/20/2019,9900,72KEHL3E,14000,more than downpayment,more than downpayment,0,4000
72KEHL3E,4000,8/23/2019,9900,72KEHL3E,18000,more than downpayment,more than downpayment,0,4000
72KEHL3E,4000,9/22/2019,9900,72KEHL3E,22000,more than downpayment,more than downpayment,0,4000
72KEHL3E,4000,10/24/2019,9900,72KEHL3E,26000,more than downpayment,more than downpayment,0,4000
72KEHL3E,4000,11/24/2019,9900,72KEHL3E,30000,more than downpayment,more than downpayment,0,4000
72KEHL3E,4000,12/26/2019,9900,72KEHL3E,34000,more than downpayment,more than downpayment,0,4000
72KEHL3E,4000,1/25/2020,9900,72KEHL3E,38000,more than downpayment,more than downpayment,0,4000
731H8GBK,8900,9/16/2019,8900,,8900,equal to downpayment,,8900,0
731H8GBK,4000,11/4/2019,8900,731H8GBK,12900,more than downpayment,equal to downpayment,0,4000
731H8GBK,5000,12/4/2019,8900,731H8GBK,17900,more than downpayment,more than downpayment,0,5000
731H8GBK,5000,1/3/2020,8900,731H8GBK,22900,more than downpayment,more than downpayment,0,5000
731H8GBK,5000,2/4/2020,8900,731H8GBK,27900,more than downpayment,more than downpayment,0,5000
732434b6,8900,11/12/2019,8900,,8900,equal to downpayment,,8900,0
732434b6,3900,12/9/2019,8900,732434b6,12800,more than downpayment,equal to downpayment,0,3900
732434b6,3900,12/26/2019,8900,732434b6,16700,more than downpayment,more than downpayment,0,3900
732434b6,3900,2/1/2020,8900,732434b6,20600,more than downpayment,more than downpayment,0,3900
73L9UNLM,8900,8/6/2019,8900,,8900,equal to downpayment,,8900,0
73L9UNLM,3900,10/3/2019,8900,73L9UNLM,12800,more than downpayment,equal to downpayment,0,3900
73L9UNLM,3900,11/2/2019,8900,73L9UNLM,16700,more than downpayment,more than downpayment,0,3900
73L9UNLM,3900,12/5/2019,8900,73L9UNLM,20600,more than downpayment,more than downpayment,0,3900
73L9UNLM,3900,12/31/2019,8900,73L9UNLM,24500,more than downpayment,more than downpayment,0,3900
73L9UNLM,3900,2/3/2020,8900,73L9UNLM,28400,more than downpayment,more than downpayment,0,3900
73S9QGNV,1600,10/14/2019,1594,,1600,more than downpayment,,1594,6
73S9QGNV,3100,12/6/2019,1594,73S9QGNV,4700,more than downpayment,more than downpayment,0,3100
73S9QGNV,3100,1/6/2020,1594,73S9QGNV,7800,more than downpayment,more than downpayment,0,3100
73S9QGNV,3100,2/5/2020,1594,73S9QGNV,10900,more than downpayment,more than downpayment,0,3100
74202d08,8900,10/29/2019,8900,,8900,equal to downpayment,,8900,0
74202d08,3900,12/31/2019,8900,74202d08,12800,more than downpayment,equal to downpayment,0,3900
74202d08,3900,2/3/2020,8900,74202d08,16700,more than downpayment,more than downpayment,0,3900
74a6221a,9900,11/28/2019,9900,,9900,equal to downpayment,,9900,0
74a6221a,4000,1/30/2020,9900,74a6221a,13900,more than downpayment,equal to downpayment,0,4000
74b36eee,9900,9/19/2019,9900,,9900,equal to downpayment,,9900,0
74b36eee,150,9/20/2019,9900,74b36eee,10050,more than downpayment,equal to downpayment,0,150
74b36eee,150,9/21/2019,9900,74b36eee,10200,more than downpayment,more than downpayment,0,150
74b36eee,150,9/22/2019,9900,74b36eee,10350,more than downpayment,more than downpayment,0,150
74b36eee,150,9/23/2019,9900,74b36eee,10500,more than downpayment,more than downpayment,0,150
74b36eee,300,9/25/2019,9900,74b36eee,10800,more than downpayment,more than downpayment,0,300
74b36eee,150,9/27/2019,9900,74b36eee,10950,more than downpayment,more than downpayment,0,150
74b36eee,300,9/28/2019,9900,74b36eee,11250,more than downpayment,more than downpayment,0,300
74b36eee,300,10/1/2019,9900,74b36eee,11550,more than downpayment,more than downpayment,0,300
74b36eee,150,10/2/2019,9900,74b36eee,11700,more than downpayment,more than downpayment,0,150
74b36eee,300,10/3/2019,9900,74b36eee,12000,more than downpayment,more than downpayment,0,300
74b36eee,450,10/6/2019,9900,74b36eee,12450,more than downpayment,more than downpayment,0,450
74b36eee,600,10/10/2019,9900,74b36eee,13050,more than downpayment,more than downpayment,0,600
74b36eee,420,10/13/2019,9900,74b36eee,13470,more than downpayment,more than downpayment,0,420
74b36eee,200,10/16/2019,9900,74b36eee,13670,more than downpayment,more than downpayment,0,200
74b36eee,880,10/20/2019,9900,74b36eee,14550,more than downpayment,more than downpayment,0,880
74b36eee,150,10/21/2019,9900,74b36eee,14700,more than downpayment,more than downpayment,0,150
74b36eee,1500,10/31/2019,9900,74b36eee,16200,more than downpayment,more than downpayment,0,1500
74b36eee,300,11/2/2019,9900,74b36eee,16500,more than downpayment,more than downpayment,0,300
74b36eee,300,11/4/2019,9900,74b36eee,16800,more than downpayment,more than downpayment,0,300
74b36eee,600,11/8/2019,9900,74b36eee,17400,more than downpayment,more than downpayment,0,600
74b36eee,250,11/23/2019,9900,74b36eee,17650,more than downpayment,more than downpayment,0,250
74b36eee,180,11/29/2019,9900,74b36eee,17830,more than downpayment,more than downpayment,0,180
74b36eee,130,11/30/2019,9900,74b36eee,17960,more than downpayment,more than downpayment,0,130
74b36eee,2730,12/1/2019,9900,74b36eee,20690,more than downpayment,more than downpayment,0,2730
74b36eee,260,12/2/2019,9900,74b36eee,20950,more than downpayment,more than downpayment,0,260
74b36eee,130,12/4/2019,9900,74b36eee,21080,more than downpayment,more than downpayment,0,130
74b36eee,390,12/7/2019,9900,74b36eee,21470,more than downpayment,more than downpayment,0,390
74b36eee,390,12/8/2019,9900,74b36eee,21860,more than downpayment,more than downpayment,0,390
74b36eee,390,12/11/2019,9900,74b36eee,22250,more than downpayment,more than downpayment,0,390
74b36eee,390,12/15/2019,9900,74b36eee,22640,more than downpayment,more than downpayment,0,390
74b36eee,390,12/18/2019,9900,74b36eee,23030,more than downpayment,more than downpayment,0,390
74b36eee,1000,12/21/2019,9900,74b36eee,24030,more than downpayment,more than downpayment,0,1000
74b36eee,2000,12/30/2019,9900,74b36eee,26030,more than downpayment,more than downpayment,0,2000
74b36eee,130,1/2/2020,9900,74b36eee,26160,more than downpayment,more than downpayment,0,130
74b36eee,1000,1/10/2020,9900,74b36eee,27160,more than downpayment,more than downpayment,0,1000
74b36eee,500,1/20/2020,9900,74b36eee,27660,more than downpayment,more than downpayment,0,500
74b36eee,500,1/21/2020,9900,74b36eee,28160,more than downpayment,more than downpayment,0,500
74b36eee,1000,1/28/2020,9900,74b36eee,29160,more than downpayment,more than downpayment,0,1000
74b36eee,500,2/4/2020,9900,74b36eee,29660,more than downpayment,more than downpayment,0,500
74b36eee,500,2/5/2020,9900,74b36eee,30160,more than downpayment,more than downpayment,0,500
75YBWDMJ,9900,6/18/2019,8900,,9900,more than downpayment,,8900,1000
75YBWDMJ,4000,9/19/2019,8900,75YBWDMJ,13900,more than downpayment,more than downpayment,0,4000
75YBWDMJ,4000,10/21/2019,8900,75YBWDMJ,17900,more than downpayment,more than downpayment,0,4000
75YBWDMJ,4000,11/25/2019,8900,75YBWDMJ,21900,more than downpayment,more than downpayment,0,4000
76docBjE,8900,8/5/2019,8900,,8900,equal to downpayment,,8900,0
76docBjE,3900,9/25/2019,8900,76docBjE,12800,more than downpayment,equal to downpayment,0,3900
76docBjE,3900,10/28/2019,8900,76docBjE,16700,more than downpayment,more than downpayment,0,3900
76docBjE,3900,11/25/2019,8900,76docBjE,20600,more than downpayment,more than downpayment,0,3900
76docBjE,3900,12/19/2019,8900,76docBjE,24500,more than downpayment,more than downpayment,0,3900
76docBjE,3900,1/24/2020,8900,76docBjE,28400,more than downpayment,more than downpayment,0,3900
76F6DRN3,9900,10/14/2019,9900,,9900,equal to downpayment,,9900,0
76F6DRN3,3000,12/8/2019,9900,76F6DRN3,12900,more than downpayment,equal to downpayment,0,3000
76F6DRN3,900,12/22/2019,9900,76F6DRN3,13800,more than downpayment,more than downpayment,0,900
76F6DRN3,3000,1/22/2020,9900,76F6DRN3,16800,more than downpayment,more than downpayment,0,3000
76F6DRN3,900,1/25/2020,9900,76F6DRN3,17700,more than downpayment,more than downpayment,0,900
7735ffcf,9900,10/1/2019,9900,,9900,equal to downpayment,,9900,0
7735ffcf,3900,11/11/2019,9900,7735ffcf,13800,more than downpayment,equal to downpayment,0,3900
7735ffcf,3900,12/10/2019,9900,7735ffcf,17700,more than downpayment,more than downpayment,0,3900
7735ffcf,3900,1/12/2020,9900,7735ffcf,21600,more than downpayment,more than downpayment,0,3900
7735ffcf,3900,2/3/2020,9900,7735ffcf,25500,more than downpayment,more than downpayment,0,3900
77da72bb,9900,9/30/2019,9900,,9900,equal to downpayment,,9900,0
77da72bb,3900,11/29/2019,9900,77da72bb,13800,more than downpayment,equal to downpayment,0,3900
77da72bb,1250,1/11/2020,9900,77da72bb,15050,more than downpayment,more than downpayment,0,1250
77da72bb,2650,1/15/2020,9900,77da72bb,17700,more than downpayment,more than downpayment,0,2650
77e5aa7b,1595,10/14/2019,1594,,1595,more than downpayment,,1594,1
77e5aa7b,3100,12/2/2019,1594,77e5aa7b,4695,more than downpayment,more than downpayment,0,3100
77e5aa7b,3100,1/3/2020,1594,77e5aa7b,7795,more than downpayment,more than downpayment,0,3100
77e5aa7b,3100,2/4/2020,1594,77e5aa7b,10895,more than downpayment,more than downpayment,0,3100
7851aafd,9900,11/11/2019,9900,,9900,equal to downpayment,,9900,0
7851aafd,7800,1/17/2020,9900,7851aafd,17700,more than downpayment,equal to downpayment,0,7800
785ff642,5000,9/27/2019,8900,,5000,less than downpayment,,5000,0
785ff642,3900,9/30/2019,8900,785ff642,8900,equal to downpayment,less than downpayment,3900,0
785ff642,3900,10/28/2019,8900,785ff642,12800,more than downpayment,equal to downpayment,0,3900
785ff642,3900,11/25/2019,8900,785ff642,16700,more than downpayment,more than downpayment,0,3900
785ff642,3900,12/31/2019,8900,785ff642,20600,more than downpayment,more than downpayment,0,3900
785ff642,3900,1/24/2020,8900,785ff642,24500,more than downpayment,more than downpayment,0,3900
78a74b44,9900,11/13/2019,9900,,9900,equal to downpayment,,9900,0
78a74b44,3900,12/5/2019,9900,78a74b44,13800,more than downpayment,equal to downpayment,0,3900
78a74b44,3950,1/3/2020,9900,78a74b44,17750,more than downpayment,more than downpayment,0,3950
78a74b44,3900,2/5/2020,9900,78a74b44,21650,more than downpayment,more than downpayment,0,3900
78HFDDPW,8900,8/4/2019,8900,,8900,equal to downpayment,,8900,0
78HFDDPW,7800,8/26/2019,8900,78HFDDPW,16700,more than downpayment,equal to downpayment,0,7800
78HFDDPW,1000,8/27/2019,8900,78HFDDPW,17700,more than downpayment,more than downpayment,0,1000
78HFDDPW,7000,10/26/2019,8900,78HFDDPW,24700,more than downpayment,more than downpayment,0,7000
78HFDDPW,5200,11/4/2019,8900,78HFDDPW,29900,more than downpayment,more than downpayment,0,5200
78HFDDPW,7800,11/10/2019,8900,78HFDDPW,37700,more than downpayment,more than downpayment,0,7800
78HFDDPW,1500,1/31/2020,8900,78HFDDPW,39200,more than downpayment,more than downpayment,0,1500
78HFDDPW,1000,2/9/2020,8900,78HFDDPW,40200,more than downpayment,more than downpayment,0,1000
79wjfUQV,8900,7/23/2019,8900,,8900,equal to downpayment,,8900,0
79wjfUQV,3900,9/27/2019,8900,79wjfUQV,12800,more than downpayment,equal to downpayment,0,3900
79wjfUQV,3900,10/18/2019,8900,79wjfUQV,16700,more than downpayment,more than downpayment,0,3900
79wjfUQV,3900,11/22/2019,8900,79wjfUQV,20600,more than downpayment,more than downpayment,0,3900
79wjfUQV,3900,1/9/2020,8900,79wjfUQV,24500,more than downpayment,more than downpayment,0,3900
79wjfUQV,4000,1/29/2020,8900,79wjfUQV,28500,more than downpayment,more than downpayment,0,4000
7a58a3e6,9900,10/15/2019,9900,,9900,equal to downpayment,,9900,0
7a58a3e6,3900,11/23/2019,9900,7a58a3e6,13800,more than downpayment,equal to downpayment,0,3900
7a58a3e6,3900,12/27/2019,9900,7a58a3e6,17700,more than downpayment,more than downpayment,0,3900
7a58a3e6,3900,2/9/2020,9900,7a58a3e6,21600,more than downpayment,more than downpayment,0,3900
7AB45Y62,57000,12/28/2019,8900,,57000,more than downpayment,,8900,48100
7b36b91f,1594,10/14/2019,1594,,1594,equal to downpayment,,1594,0
7b36b91f,3100,12/12/2019,1594,7b36b91f,4694,more than downpayment,equal to downpayment,0,3100
7b43aa18,4999,12/17/2019,4999,,4999,equal to downpayment,,4999,0
7b46e1cb,9900,1/17/2020,9900,,9900,equal to downpayment,,9900,0
7B7FN83A,9900,1/23/2020,9900,,9900,equal to downpayment,,9900,0
7b8472c0,9900,10/31/2019,9900,,9900,equal to downpayment,,9900,0
7b8472c0,7800,1/8/2020,9900,7b8472c0,17700,more than downpayment,equal to downpayment,0,7800
7BAK4JNB,9900,12/9/2019,9900,,9900,equal to downpayment,,9900,0
7BAV1HZV,9900,10/1/2019,9900,,9900,equal to downpayment,,9900,0
7BAV1HZV,3900,11/25/2019,9900,7BAV1HZV,13800,more than downpayment,equal to downpayment,0,3900
7BAV1HZV,3900,1/8/2020,9900,7BAV1HZV,17700,more than downpayment,more than downpayment,0,3900
7BAV1HZV,3900,2/4/2020,9900,7BAV1HZV,21600,more than downpayment,more than downpayment,0,3900
7C3QC2UR,2000,11/4/2019,9900,,2000,less than downpayment,,2000,0
7C3QC2UR,2000,11/8/2019,9900,7C3QC2UR,4000,less than downpayment,less than downpayment,2000,0
7c86d510,9900,12/4/2019,9900,,9900,equal to downpayment,,9900,0
7c86d510,3900,1/21/2020,9900,7c86d510,13800,more than downpayment,equal to downpayment,0,3900
7CRVR8LD,9900,10/21/2019,9900,,9900,equal to downpayment,,9900,0
7CRVR8LD,3900,12/5/2019,9900,7CRVR8LD,13800,more than downpayment,equal to downpayment,0,3900
7CRVR8LD,3900,1/14/2020,9900,7CRVR8LD,17700,more than downpayment,more than downpayment,0,3900
7CRVR8LD,3900,2/5/2020,9900,7CRVR8LD,21600,more than downpayment,more than downpayment,0,3900
7d378473,1594,10/14/2019,7900,,1594,less than downpayment,,1594,0
7d4dfcd8,4999,1/11/2020,9900,,4999,less than downpayment,,4999,0
7d4dfcd8,4000,1/12/2020,9900,7d4dfcd8,8999,less than downpayment,less than downpayment,4000,0
7d4dfcd8,1000,1/19/2020,9900,7d4dfcd8,9999,more than downpayment,less than downpayment,901,99
7d52693c,10000,10/11/2019,9900,,10000,more than downpayment,,9900,100
7d52693c,3900,11/13/2019,9900,7d52693c,13900,more than downpayment,more than downpayment,0,3900
7d52693c,3900,12/3/2019,9900,7d52693c,17800,more than downpayment,more than downpayment,0,3900
7d52693c,3900,12/24/2019,9900,7d52693c,21700,more than downpayment,more than downpayment,0,3900
7d52693c,3900,2/3/2020,9900,7d52693c,25600,more than downpayment,more than downpayment,0,3900
7d5f070f,1594,10/14/2019,1594,,1594,equal to downpayment,,1594,0
7d5f070f,3100,12/21/2019,1594,7d5f070f,4694,more than downpayment,equal to downpayment,0,3100
7d5f070f,3100,1/25/2020,1594,7d5f070f,7794,more than downpayment,more than downpayment,0,3100
7d7cc0f1,9900,1/3/2020,9900,,9900,equal to downpayment,,9900,0
7DIY2D7H,9900,11/21/2019,9900,,9900,equal to downpayment,,9900,0
7e177fd1,9900,10/27/2019,9900,,9900,equal to downpayment,,9900,0
7E8UNBRO,9900,1/15/2020,9900,,9900,equal to downpayment,,9900,0
7eb5IpkO,10000,11/14/2018,10000,,10000,equal to downpayment,,10000,0
7eb5IpkO,4500,12/17/2018,10000,7eb5IpkO,14500,more than downpayment,equal to downpayment,0,4500
7eb5IpkO,4500,1/16/2019,10000,7eb5IpkO,19000,more than downpayment,more than downpayment,0,4500
7eb5IpkO,4500,2/25/2019,10000,7eb5IpkO,23500,more than downpayment,more than downpayment,0,4500
7eb5IpkO,4500,3/13/2019,10000,7eb5IpkO,28000,more than downpayment,more than downpayment,0,4500
7eb5IpkO,9000,5/24/2019,10000,7eb5IpkO,37000,more than downpayment,more than downpayment,0,9000
7eb5IpkO,2000,6/20/2019,10000,7eb5IpkO,39000,more than downpayment,more than downpayment,0,2000
7eb5IpkO,2100,7/26/2019,10000,7eb5IpkO,41100,more than downpayment,more than downpayment,0,2100
7eb5IpkO,4500,8/30/2019,10000,7eb5IpkO,45600,more than downpayment,more than downpayment,0,4500
7eb5IpkO,4500,9/30/2019,10000,7eb5IpkO,50100,more than downpayment,more than downpayment,0,4500
7eb5IpkO,3000,10/4/2019,10000,7eb5IpkO,53100,more than downpayment,more than downpayment,0,3000
7eb5IpkO,1800,10/23/2019,10000,7eb5IpkO,54900,more than downpayment,more than downpayment,0,1800
7eb5IpkO,2500,11/7/2019,10000,7eb5IpkO,57400,more than downpayment,more than downpayment,0,2500
7eb5IpkO,4000,12/11/2019,10000,7eb5IpkO,61400,more than downpayment,more than downpayment,0,4000
7eb5IpkO,2400,1/14/2020,10000,7eb5IpkO,63800,more than downpayment,more than downpayment,0,2400
7eb5IpkO,200,1/20/2020,10000,7eb5IpkO,64000,more than downpayment,more than downpayment,0,200
7EBV3YQZ,9900,10/24/2019,9900,,9900,equal to downpayment,,9900,0
7EBV3YQZ,3900,12/20/2019,9900,7EBV3YQZ,13800,more than downpayment,equal to downpayment,0,3900
7EBV3YQZ,3900,1/24/2020,9900,7EBV3YQZ,17700,more than downpayment,more than downpayment,0,3900
7F1AE7WP,1599,10/14/2019,1594,,1599,more than downpayment,,1594,5
7F1AE7WP,3100,12/18/2019,1594,7F1AE7WP,4699,more than downpayment,more than downpayment,0,3100
7F1AE7WP,2000,2/4/2020,1594,7F1AE7WP,6699,more than downpayment,more than downpayment,0,2000
7f816a3e,2,7/15/2019,9900,,2,less than downpayment,,2,0
7f816a3e,8900,9/6/2019,9900,7f816a3e,8902,less than downpayment,less than downpayment,8900,0
7f816a3e,1000,10/14/2019,9900,7f816a3e,9902,more than downpayment,less than downpayment,998,2
7f816a3e,4000,11/5/2019,9900,7f816a3e,13902,more than downpayment,more than downpayment,0,4000
7f816a3e,3800,12/20/2019,9900,7f816a3e,17702,more than downpayment,more than downpayment,0,3800
7f816a3e,4000,1/25/2020,9900,7f816a3e,21702,more than downpayment,more than downpayment,0,4000
7FE7E675,10000,11/23/2019,8900,,10000,more than downpayment,,8900,1100
7FE7E675,3900,2/5/2020,8900,7FE7E675,13900,more than downpayment,more than downpayment,0,3900
7FFZIWRY,10000,7/29/2019,9900,,10000,more than downpayment,,9900,100
7FFZIWRY,4000,9/16/2019,9900,7FFZIWRY,14000,more than downpayment,more than downpayment,0,4000
7FFZIWRY,4000,10/18/2019,9900,7FFZIWRY,18000,more than downpayment,more than downpayment,0,4000
7FFZIWRY,4000,11/29/2019,9900,7FFZIWRY,22000,more than downpayment,more than downpayment,0,4000
7FFZIWRY,4000,12/24/2019,9900,7FFZIWRY,26000,more than downpayment,more than downpayment,0,4000
7FFZIWRY,4000,1/26/2020,9900,7FFZIWRY,30000,more than downpayment,more than downpayment,0,4000
7GUA3IDL,9900,7/12/2019,8900,,9900,more than downpayment,,8900,1000
7GUA3IDL,4000,9/5/2019,8900,7GUA3IDL,13900,more than downpayment,more than downpayment,0,4000
7GUA3IDL,4000,10/4/2019,8900,7GUA3IDL,17900,more than downpayment,more than downpayment,0,4000
7GUA3IDL,4000,11/6/2019,8900,7GUA3IDL,21900,more than downpayment,more than downpayment,0,4000
7GUA3IDL,4000,12/12/2019,8900,7GUA3IDL,25900,more than downpayment,more than downpayment,0,4000
7GUA3IDL,4000,1/15/2020,8900,7GUA3IDL,29900,more than downpayment,more than downpayment,0,4000
7GXF4YR6,40000,4/9/2019,10000,,40000,more than downpayment,,10000,30000
7GXF4YR6,12000,5/14/2019,10000,7GXF4YR6,52000,more than downpayment,more than downpayment,0,12000
7gzX4fft,9900,7/20/2019,9900,,9900,equal to downpayment,,9900,0
7gzX4fft,22600,7/22/2019,9900,7gzX4fft,32500,more than downpayment,equal to downpayment,0,22600
7gzX4fft,7500,7/23/2019,9900,7gzX4fft,40000,more than downpayment,more than downpayment,0,7500
7gzX4fft,30000,8/14/2019,9900,7gzX4fft,70000,more than downpayment,more than downpayment,0,30000
7gzX4fft,30000,8/29/2019,9900,7gzX4fft,100000,more than downpayment,more than downpayment,0,30000
7H8PRV3I,8900,1/21/2020,8900,,8900,equal to downpayment,,8900,0
7HIO7FBD,1600,10/14/2019,1594,,1600,more than downpayment,,1594,6
7HIO7FBD,7400,1/7/2020,1594,7HIO7FBD,9000,more than downpayment,more than downpayment,0,7400
7HIO7FBD,1050,2/5/2020,1594,7HIO7FBD,10050,more than downpayment,more than downpayment,0,1050
7iyAgLcd,14400,7/23/2019,9900,,14400,more than downpayment,,9900,4500
7iyAgLcd,3900,10/22/2019,9900,7iyAgLcd,18300,more than downpayment,more than downpayment,0,3900
7iyAgLcd,3900,11/25/2019,9900,7iyAgLcd,22200,more than downpayment,more than downpayment,0,3900
7iyAgLcd,3900,1/30/2020,9900,7iyAgLcd,26100,more than downpayment,more than downpayment,0,3900
7J3ENCDU,9900,2/3/2020,9900,,9900,equal to downpayment,,9900,0
7J67SY13,23400,11/11/2019,23400,,23400,equal to downpayment,,23400,0
7J67SY13,7300,12/5/2019,23400,7J67SY13,30700,more than downpayment,equal to downpayment,0,7300
7J67SY13,7300,12/14/2019,23400,7J67SY13,38000,more than downpayment,more than downpayment,0,7300
7J67SY13,36500,1/20/2020,23400,7J67SY13,74500,more than downpayment,more than downpayment,0,36500
7J67SY13,7300,2/8/2020,23400,7J67SY13,81800,more than downpayment,more than downpayment,0,7300
7jSx7tLC,8900,1/21/2019,8900,,8900,equal to downpayment,,8900,0
7jSx7tLC,7800,2/24/2019,8900,7jSx7tLC,16700,more than downpayment,equal to downpayment,0,7800
7jSx7tLC,3900,4/24/2019,8900,7jSx7tLC,20600,more than downpayment,more than downpayment,0,3900
7jSx7tLC,3900,5/25/2019,8900,7jSx7tLC,24500,more than downpayment,more than downpayment,0,3900
7jSx7tLC,3900,6/27/2019,8900,7jSx7tLC,28400,more than downpayment,more than downpayment,0,3900
7jSx7tLC,3900,7/31/2019,8900,7jSx7tLC,32300,more than downpayment,more than downpayment,0,3900
7jSx7tLC,3900,8/27/2019,8900,7jSx7tLC,36200,more than downpayment,more than downpayment,0,3900
7jSx7tLC,3900,9/27/2019,8900,7jSx7tLC,40100,more than downpayment,more than downpayment,0,3900
7jSx7tLC,3900,10/29/2019,8900,7jSx7tLC,44000,more than downpayment,more than downpayment,0,3900
7jSx7tLC,3900,11/28/2019,8900,7jSx7tLC,47900,more than downpayment,more than downpayment,0,3900
7jSx7tLC,3900,1/14/2020,8900,7jSx7tLC,51800,more than downpayment,more than downpayment,0,3900
7jSx7tLC,3900,1/30/2020,8900,7jSx7tLC,55700,more than downpayment,more than downpayment,0,3900
7L5D7KKO,9900,11/20/2019,9900,,9900,equal to downpayment,,9900,0
7L5D7KKO,3900,1/15/2020,9900,7L5D7KKO,13800,more than downpayment,equal to downpayment,0,3900
7lFMz21i,12400,7/29/2019,9900,,12400,more than downpayment,,9900,2500
7lFMz21i,4000,10/4/2019,9900,7lFMz21i,16400,more than downpayment,more than downpayment,0,4000
7lFMz21i,4000,10/23/2019,9900,7lFMz21i,20400,more than downpayment,more than downpayment,0,4000
7lFMz21i,4000,11/25/2019,9900,7lFMz21i,24400,more than downpayment,more than downpayment,0,4000
7lFMz21i,4000,12/25/2019,9900,7lFMz21i,28400,more than downpayment,more than downpayment,0,4000
7lFMz21i,4000,1/24/2020,9900,7lFMz21i,32400,more than downpayment,more than downpayment,0,4000
7LM9CTF5,9900,7/31/2019,9900,,9900,equal to downpayment,,9900,0
7LM9CTF5,7800,9/14/2019,9900,7LM9CTF5,17700,more than downpayment,equal to downpayment,0,7800
7LM9CTF5,3900,11/14/2019,9900,7LM9CTF5,21600,more than downpayment,more than downpayment,0,3900
7LM9CTF5,3900,12/5/2019,9900,7LM9CTF5,25500,more than downpayment,more than downpayment,0,3900
7LM9CTF5,3990,1/23/2020,9900,7LM9CTF5,29490,more than downpayment,more than downpayment,0,3990
7LM9CTF5,3900,2/7/2020,9900,7LM9CTF5,33390,more than downpayment,more than downpayment,0,3900
7LPM8GX2,5100,9/24/2019,9900,,5100,less than downpayment,,5100,0
7LPM8GX2,4800,9/27/2019,9900,7LPM8GX2,9900,equal to downpayment,less than downpayment,4800,0
7LPM8GX2,3900,11/6/2019,9900,7LPM8GX2,13800,more than downpayment,equal to downpayment,0,3900
7LPM8GX2,3900,12/10/2019,9900,7LPM8GX2,17700,more than downpayment,more than downpayment,0,3900
7LPM8GX2,3900,1/14/2020,9900,7LPM8GX2,21600,more than downpayment,more than downpayment,0,3900
7ltHu37C,5500,5/13/2017,5500,,5500,equal to downpayment,,5500,0
7ltHu37C,1500,6/15/2017,5500,7ltHu37C,7000,more than downpayment,equal to downpayment,0,1500
7ltHu37C,1500,7/11/2017,5500,7ltHu37C,8500,more than downpayment,more than downpayment,0,1500
7ltHu37C,950,11/4/2017,5500,7ltHu37C,9450,more than downpayment,more than downpayment,0,950
7ltHu37C,2000,2/13/2018,5500,7ltHu37C,11450,more than downpayment,more than downpayment,0,2000
7ltHu37C,4500,3/29/2018,5500,7ltHu37C,15950,more than downpayment,more than downpayment,0,4500
7ltHu37C,500,4/10/2018,5500,7ltHu37C,16450,more than downpayment,more than downpayment,0,500
7ltHu37C,5000,5/2/2018,5500,7ltHu37C,21450,more than downpayment,more than downpayment,0,5000
7ltHu37C,2500,6/25/2018,5500,7ltHu37C,23950,more than downpayment,more than downpayment,0,2500
7ltHu37C,4000,7/8/2018,5500,7ltHu37C,27950,more than downpayment,more than downpayment,0,4000
7ltHu37C,1000,9/5/2018,5500,7ltHu37C,28950,more than downpayment,more than downpayment,0,1000
7ltHu37C,3000,10/15/2018,5500,7ltHu37C,31950,more than downpayment,more than downpayment,0,3000
7ltHu37C,2000,2/3/2019,5500,7ltHu37C,33950,more than downpayment,more than downpayment,0,2000
7ltHu37C,550,3/12/2019,5500,7ltHu37C,34500,more than downpayment,more than downpayment,0,550
7ltHu37C,500,3/20/2019,5500,7ltHu37C,35000,more than downpayment,more than downpayment,0,500
7lvYzUeZ,9900,11/5/2018,9900,,9900,equal to downpayment,,9900,0
7lvYzUeZ,4500,12/30/2018,9900,7lvYzUeZ,14400,more than downpayment,equal to downpayment,0,4500
7lvYzUeZ,4500,1/31/2019,9900,7lvYzUeZ,18900,more than downpayment,more than downpayment,0,4500
7lvYzUeZ,4500,3/2/2019,9900,7lvYzUeZ,23400,more than downpayment,more than downpayment,0,4500
7lvYzUeZ,2700,4/23/2019,9900,7lvYzUeZ,26100,more than downpayment,more than downpayment,0,2700
7lvYzUeZ,1800,5/5/2019,9900,7lvYzUeZ,27900,more than downpayment,more than downpayment,0,1800
7lvYzUeZ,3000,5/23/2019,9900,7lvYzUeZ,30900,more than downpayment,more than downpayment,0,3000
7lvYzUeZ,1500,5/30/2019,9900,7lvYzUeZ,32400,more than downpayment,more than downpayment,0,1500
7lvYzUeZ,3900,6/22/2019,9900,7lvYzUeZ,36300,more than downpayment,more than downpayment,0,3900
7M5NZY2N,9900,11/22/2019,9900,,9900,equal to downpayment,,9900,0
7MPS33Z2,9900,10/7/2019,9900,,9900,equal to downpayment,,9900,0
7MPS33Z2,3900,12/10/2019,9900,7MPS33Z2,13800,more than downpayment,equal to downpayment,0,3900
7MPS33Z2,3900,1/10/2020,9900,7MPS33Z2,17700,more than downpayment,more than downpayment,0,3900
7MV3VN4Z,9900,12/17/2019,9900,,9900,equal to downpayment,,9900,0
7NMUFI4T,9900,8/9/2019,9900,,9900,equal to downpayment,,9900,0
7NMUFI4T,3900,10/12/2019,9900,7NMUFI4T,13800,more than downpayment,equal to downpayment,0,3900
7NMUFI4T,3900,11/13/2019,9900,7NMUFI4T,17700,more than downpayment,more than downpayment,0,3900
7NMUFI4T,1000,12/10/2019,9900,7NMUFI4T,18700,more than downpayment,more than downpayment,0,1000
7NMUFI4T,2900,12/16/2019,9900,7NMUFI4T,21600,more than downpayment,more than downpayment,0,2900
7NMUFI4T,3900,1/8/2020,9900,7NMUFI4T,25500,more than downpayment,more than downpayment,0,3900
7NRG47V7,8000,10/29/2019,8900,,8000,less than downpayment,,8000,0
7NRG47V7,1000,10/30/2019,8900,7NRG47V7,9000,more than downpayment,less than downpayment,900,100
7NRG47V7,8000,12/4/2019,8900,7NRG47V7,17000,more than downpayment,more than downpayment,0,8000
7Ns9Ifj9,8900,3/1/2019,8900,,8900,equal to downpayment,,8900,0
7Ns9Ifj9,3900,5/2/2019,8900,7Ns9Ifj9,12800,more than downpayment,equal to downpayment,0,3900
7Ns9Ifj9,3900,6/6/2019,8900,7Ns9Ifj9,16700,more than downpayment,more than downpayment,0,3900
7Ns9Ifj9,3900,7/5/2019,8900,7Ns9Ifj9,20600,more than downpayment,more than downpayment,0,3900
7Ns9Ifj9,3900,8/5/2019,8900,7Ns9Ifj9,24500,more than downpayment,more than downpayment,0,3900
7Ns9Ifj9,3900,9/5/2019,8900,7Ns9Ifj9,28400,more than downpayment,more than downpayment,0,3900
7Ns9Ifj9,3900,10/5/2019,8900,7Ns9Ifj9,32300,more than downpayment,more than downpayment,0,3900
7Ns9Ifj9,3900,11/5/2019,8900,7Ns9Ifj9,36200,more than downpayment,more than downpayment,0,3900
7Ns9Ifj9,3900,12/17/2019,8900,7Ns9Ifj9,40100,more than downpayment,more than downpayment,0,3900
7Ns9Ifj9,3900,1/13/2020,8900,7Ns9Ifj9,44000,more than downpayment,more than downpayment,0,3900
7o4ikny9,20000,6/7/2019,8900,,20000,more than downpayment,,8900,11100
7o4ikny9,4000,6/14/2019,8900,7o4ikny9,24000,more than downpayment,more than downpayment,0,4000
7o4ikny9,4000,7/13/2019,8900,7o4ikny9,28000,more than downpayment,more than downpayment,0,4000
7o4ikny9,3900,8/13/2019,8900,7o4ikny9,31900,more than downpayment,more than downpayment,0,3900
7o4ikny9,4000,9/13/2019,8900,7o4ikny9,35900,more than downpayment,more than downpayment,0,4000
7o4ikny9,3900,10/15/2019,8900,7o4ikny9,39800,more than downpayment,more than downpayment,0,3900
7o4ikny9,3900,11/12/2019,8900,7o4ikny9,43700,more than downpayment,more than downpayment,0,3900
7o4ikny9,3900,12/15/2019,8900,7o4ikny9,47600,more than downpayment,more than downpayment,0,3900
7o4ikny9,3900,1/13/2020,8900,7o4ikny9,51500,more than downpayment,more than downpayment,0,3900
7ovF37nN,9900,12/3/2018,9900,,9900,equal to downpayment,,9900,0
7ovF37nN,15000,12/27/2019,9900,7ovF37nN,24900,more than downpayment,equal to downpayment,0,15000
7oxCJvsE,9900,6/15/2019,9900,,9900,equal to downpayment,,9900,0
7PDI8TFW,16700,1/17/2020,8900,,16700,more than downpayment,,8900,7800
7PuL3gLL,8900,1/18/2019,8900,,8900,equal to downpayment,,8900,0
7PuL3gLL,3900,3/2/2019,8900,7PuL3gLL,12800,more than downpayment,equal to downpayment,0,3900
7PuL3gLL,3900,4/4/2019,8900,7PuL3gLL,16700,more than downpayment,more than downpayment,0,3900
7PuL3gLL,3900,5/2/2019,8900,7PuL3gLL,20600,more than downpayment,more than downpayment,0,3900
7PuL3gLL,3900,5/31/2019,8900,7PuL3gLL,24500,more than downpayment,more than downpayment,0,3900
7PuL3gLL,3900,7/1/2019,8900,7PuL3gLL,28400,more than downpayment,more than downpayment,0,3900
7PuL3gLL,3900,8/2/2019,8900,7PuL3gLL,32300,more than downpayment,more than downpayment,0,3900
7PuL3gLL,3900,9/4/2019,8900,7PuL3gLL,36200,more than downpayment,more than downpayment,0,3900
7PuL3gLL,3900,10/2/2019,8900,7PuL3gLL,40100,more than downpayment,more than downpayment,0,3900
7PuL3gLL,3900,11/1/2019,8900,7PuL3gLL,44000,more than downpayment,more than downpayment,0,3900
7PuL3gLL,3900,12/5/2019,8900,7PuL3gLL,47900,more than downpayment,more than downpayment,0,3900
7PuL3gLL,3900,12/25/2019,8900,7PuL3gLL,51800,more than downpayment,more than downpayment,0,3900
7PuL3gLL,3900,1/28/2020,8900,7PuL3gLL,55700,more than downpayment,more than downpayment,0,3900
7QBoz0co,8900,3/4/2019,8900,,8900,equal to downpayment,,8900,0
7QBoz0co,4000,5/2/2019,8900,7QBoz0co,12900,more than downpayment,equal to downpayment,0,4000
7QBoz0co,4000,6/4/2019,8900,7QBoz0co,16900,more than downpayment,more than downpayment,0,4000
7QBoz0co,4000,7/5/2019,8900,7QBoz0co,20900,more than downpayment,more than downpayment,0,4000
7QBoz0co,4000,8/5/2019,8900,7QBoz0co,24900,more than downpayment,more than downpayment,0,4000
7QBoz0co,4000,9/1/2019,8900,7QBoz0co,28900,more than downpayment,more than downpayment,0,4000
7QBoz0co,4000,9/30/2019,8900,7QBoz0co,32900,more than downpayment,more than downpayment,0,4000
7QBoz0co,4000,10/26/2019,8900,7QBoz0co,36900,more than downpayment,more than downpayment,0,4000
7QBoz0co,4000,11/25/2019,8900,7QBoz0co,40900,more than downpayment,more than downpayment,0,4000
7QBoz0co,4000,12/24/2019,8900,7QBoz0co,44900,more than downpayment,more than downpayment,0,4000
7QBoz0co,4000,1/25/2020,8900,7QBoz0co,48900,more than downpayment,more than downpayment,0,4000
7QOOH8U8,9900,8/19/2019,9900,,9900,equal to downpayment,,9900,0
7QOOH8U8,3900,10/12/2019,9900,7QOOH8U8,13800,more than downpayment,equal to downpayment,0,3900
7QOOH8U8,3900,11/6/2019,9900,7QOOH8U8,17700,more than downpayment,more than downpayment,0,3900
7QOOH8U8,3900,12/10/2019,9900,7QOOH8U8,21600,more than downpayment,more than downpayment,0,3900
7QOOH8U8,3900,1/8/2020,9900,7QOOH8U8,25500,more than downpayment,more than downpayment,0,3900
7QOOH8U8,3900,2/7/2020,9900,7QOOH8U8,29400,more than downpayment,more than downpayment,0,3900
7R5AA2O5,8900,8/21/2019,8900,,8900,equal to downpayment,,8900,0
7R5AA2O5,3900,9/20/2019,8900,7R5AA2O5,12800,more than downpayment,equal to downpayment,0,3900
7R5AA2O5,3900,10/12/2019,8900,7R5AA2O5,16700,more than downpayment,more than downpayment,0,3900
7R5AA2O5,3900,11/3/2019,8900,7R5AA2O5,20600,more than downpayment,more than downpayment,0,3900
7R5AA2O5,3900,11/28/2019,8900,7R5AA2O5,24500,more than downpayment,more than downpayment,0,3900
7R5AA2O5,3900,12/8/2019,8900,7R5AA2O5,28400,more than downpayment,more than downpayment,0,3900
7R5AA2O5,3900,12/20/2019,8900,7R5AA2O5,32300,more than downpayment,more than downpayment,0,3900
7R5AA2O5,3900,1/8/2020,8900,7R5AA2O5,36200,more than downpayment,more than downpayment,0,3900
7R5AA2O5,3900,1/24/2020,8900,7R5AA2O5,40100,more than downpayment,more than downpayment,0,3900
7R711cHb,8900,2/13/2019,8900,,8900,equal to downpayment,,8900,0
7R711cHb,3900,3/20/2019,8900,7R711cHb,12800,more than downpayment,equal to downpayment,0,3900
7R711cHb,3999,4/23/2019,8900,7R711cHb,16799,more than downpayment,more than downpayment,0,3999
7R711cHb,3900,5/24/2019,8900,7R711cHb,20699,more than downpayment,more than downpayment,0,3900
7R711cHb,3900,6/20/2019,8900,7R711cHb,24599,more than downpayment,more than downpayment,0,3900
7R711cHb,3900,7/24/2019,8900,7R711cHb,28499,more than downpayment,more than downpayment,0,3900
7R711cHb,3900,8/23/2019,8900,7R711cHb,32399,more than downpayment,more than downpayment,0,3900
7R711cHb,3900,9/25/2019,8900,7R711cHb,36299,more than downpayment,more than downpayment,0,3900
7R711cHb,3900,10/24/2019,8900,7R711cHb,40199,more than downpayment,more than downpayment,0,3900
7R711cHb,3900,11/25/2019,8900,7R711cHb,44099,more than downpayment,more than downpayment,0,3900
7R711cHb,3900,12/20/2019,8900,7R711cHb,47999,more than downpayment,more than downpayment,0,3900
7R711cHb,3900,1/24/2020,8900,7R711cHb,51899,more than downpayment,more than downpayment,0,3900
7RNLL5WC,9900,7/31/2019,9900,,9900,equal to downpayment,,9900,0
7RNLL5WC,3900,9/11/2019,9900,7RNLL5WC,13800,more than downpayment,equal to downpayment,0,3900
7RNLL5WC,3900,10/15/2019,9900,7RNLL5WC,17700,more than downpayment,more than downpayment,0,3900
7RNLL5WC,3900,11/16/2019,9900,7RNLL5WC,21600,more than downpayment,more than downpayment,0,3900
7RNLL5WC,3900,12/17/2019,9900,7RNLL5WC,25500,more than downpayment,more than downpayment,0,3900
7RNLL5WC,3900,1/16/2020,9900,7RNLL5WC,29400,more than downpayment,more than downpayment,0,3900
7S6Kd1xW,8900,2/15/2019,8900,,8900,equal to downpayment,,8900,0
7S6Kd1xW,3900,3/24/2019,8900,7S6Kd1xW,12800,more than downpayment,equal to downpayment,0,3900
7S6Kd1xW,3900,5/3/2019,8900,7S6Kd1xW,16700,more than downpayment,more than downpayment,0,3900
7S6Kd1xW,3900,6/3/2019,8900,7S6Kd1xW,20600,more than downpayment,more than downpayment,0,3900
7S6Kd1xW,3900,7/10/2019,8900,7S6Kd1xW,24500,more than downpayment,more than downpayment,0,3900
7S6Kd1xW,3900,8/2/2019,8900,7S6Kd1xW,28400,more than downpayment,more than downpayment,0,3900
7S6Kd1xW,3900,9/3/2019,8900,7S6Kd1xW,32300,more than downpayment,more than downpayment,0,3900
7S6Kd1xW,3900,10/9/2019,8900,7S6Kd1xW,36200,more than downpayment,more than downpayment,0,3900
7S6Kd1xW,3900,11/11/2019,8900,7S6Kd1xW,40100,more than downpayment,more than downpayment,0,3900
7S6Kd1xW,3900,12/11/2019,8900,7S6Kd1xW,44000,more than downpayment,more than downpayment,0,3900
7S6Kd1xW,3900,1/8/2020,8900,7S6Kd1xW,47900,more than downpayment,more than downpayment,0,3900
7S6Kd1xW,4200,2/7/2020,8900,7S6Kd1xW,52100,more than downpayment,more than downpayment,0,4200
7SL4ADAB,7900,9/14/2019,1999,,7900,more than downpayment,,1999,5901
7SL4ADAB,3100,10/30/2019,1999,7SL4ADAB,11000,more than downpayment,more than downpayment,0,3100
7SL4ADAB,3100,11/24/2019,1999,7SL4ADAB,14100,more than downpayment,more than downpayment,0,3100
7SL4ADAB,3100,12/31/2019,1999,7SL4ADAB,17200,more than downpayment,more than downpayment,0,3100
7SL4ADAB,3100,2/3/2020,1999,7SL4ADAB,20300,more than downpayment,more than downpayment,0,3100
7SMLELEA,9900,9/29/2019,9900,,9900,equal to downpayment,,9900,0
7SMLELEA,3900,11/12/2019,9900,7SMLELEA,13800,more than downpayment,equal to downpayment,0,3900
7SMLELEA,3900,12/8/2019,9900,7SMLELEA,17700,more than downpayment,more than downpayment,0,3900
7SX4G3NI,9900,11/20/2019,9900,,9900,equal to downpayment,,9900,0
7SX4G3NI,20000,1/7/2020,9900,7SX4G3NI,29900,more than downpayment,equal to downpayment,0,20000
7SX4G3NI,10000,2/4/2020,9900,7SX4G3NI,39900,more than downpayment,more than downpayment,0,10000
7tkZ32io,8900,5/31/2019,8900,,8900,equal to downpayment,,8900,0
7tkZ32io,3900,7/22/2019,8900,7tkZ32io,12800,more than downpayment,equal to downpayment,0,3900
7tkZ32io,3900,8/30/2019,8900,7tkZ32io,16700,more than downpayment,more than downpayment,0,3900
7tkZ32io,3900,9/30/2019,8900,7tkZ32io,20600,more than downpayment,more than downpayment,0,3900
7tkZ32io,3900,10/31/2019,8900,7tkZ32io,24500,more than downpayment,more than downpayment,0,3900
7tkZ32io,3900,12/2/2019,8900,7tkZ32io,28400,more than downpayment,more than downpayment,0,3900
7tkZ32io,3900,12/26/2019,8900,7tkZ32io,32300,more than downpayment,more than downpayment,0,3900
7tkZ32io,3900,1/31/2020,8900,7tkZ32io,36200,more than downpayment,more than downpayment,0,3900
7TUL1N8M,8900,7/1/2019,8900,,8900,equal to downpayment,,8900,0
7TUL1N8M,1000,7/11/2019,8900,7TUL1N8M,9900,more than downpayment,equal to downpayment,0,1000
7TUL1N8M,3900,8/1/2019,8900,7TUL1N8M,13800,more than downpayment,more than downpayment,0,3900
7TUL1N8M,3900,9/1/2019,8900,7TUL1N8M,17700,more than downpayment,more than downpayment,0,3900
7TUL1N8M,3900,9/24/2019,8900,7TUL1N8M,21600,more than downpayment,more than downpayment,0,3900
7TUL1N8M,3900,10/24/2019,8900,7TUL1N8M,25500,more than downpayment,more than downpayment,0,3900
7TUL1N8M,3900,11/24/2019,8900,7TUL1N8M,29400,more than downpayment,more than downpayment,0,3900
7TUL1N8M,3900,12/19/2019,8900,7TUL1N8M,33300,more than downpayment,more than downpayment,0,3900
7TUL1N8M,3900,1/21/2020,8900,7TUL1N8M,37200,more than downpayment,more than downpayment,0,3900
7Twj0RYp,8900,8/21/2019,8900,,8900,equal to downpayment,,8900,0
7Twj0RYp,3900,10/15/2019,8900,7Twj0RYp,12800,more than downpayment,equal to downpayment,0,3900
7Twj0RYp,3900,11/13/2019,8900,7Twj0RYp,16700,more than downpayment,more than downpayment,0,3900
7Twj0RYp,3900,12/15/2019,8900,7Twj0RYp,20600,more than downpayment,more than downpayment,0,3900
7Twj0RYp,3900,1/17/2020,8900,7Twj0RYp,24500,more than downpayment,more than downpayment,0,3900
7U7L5QQL,10000,12/6/2019,9900,,10000,more than downpayment,,9900,100
7U7L5QQL,3900,1/25/2020,9900,7U7L5QQL,13900,more than downpayment,more than downpayment,0,3900
7UaDGyuV,10000,7/20/2018,10000,,10000,equal to downpayment,,10000,0
7UaDGyuV,5600,8/5/2018,10000,7UaDGyuV,15600,more than downpayment,equal to downpayment,0,5600
7UaDGyuV,5600,9/9/2018,10000,7UaDGyuV,21200,more than downpayment,more than downpayment,0,5600
7UaDGyuV,5700,10/15/2018,10000,7UaDGyuV,26900,more than downpayment,more than downpayment,0,5700
7UaDGyuV,5700,11/15/2018,10000,7UaDGyuV,32600,more than downpayment,more than downpayment,0,5700
7UaDGyuV,5700,12/11/2018,10000,7UaDGyuV,38300,more than downpayment,more than downpayment,0,5700
7UaDGyuV,5700,1/10/2019,10000,7UaDGyuV,44000,more than downpayment,more than downpayment,0,5700
7UaDGyuV,5700,2/11/2019,10000,7UaDGyuV,49700,more than downpayment,more than downpayment,0,5700
7UaDGyuV,5700,3/15/2019,10000,7UaDGyuV,55400,more than downpayment,more than downpayment,0,5700
7UaDGyuV,5700,4/17/2019,10000,7UaDGyuV,61100,more than downpayment,more than downpayment,0,5700
7UaDGyuV,5700,5/11/2019,10000,7UaDGyuV,66800,more than downpayment,more than downpayment,0,5700
7UaDGyuV,6000,6/24/2019,10000,7UaDGyuV,72800,more than downpayment,more than downpayment,0,6000
7UaDGyuV,4000,7/17/2019,10000,7UaDGyuV,76800,more than downpayment,more than downpayment,0,4000
7vsTXXN7,10000,8/3/2018,10000,,10000,equal to downpayment,,10000,0
7vsTXXN7,4500,9/5/2018,10000,7vsTXXN7,14500,more than downpayment,equal to downpayment,0,4500
7vsTXXN7,4500,10/4/2018,10000,7vsTXXN7,19000,more than downpayment,more than downpayment,0,4500
7vsTXXN7,4500,11/2/2018,10000,7vsTXXN7,23500,more than downpayment,more than downpayment,0,4500
7vsTXXN7,4500,12/4/2018,10000,7vsTXXN7,28000,more than downpayment,more than downpayment,0,4500
7vsTXXN7,4500,1/4/2019,10000,7vsTXXN7,32500,more than downpayment,more than downpayment,0,4500
7vsTXXN7,4500,2/5/2019,10000,7vsTXXN7,37000,more than downpayment,more than downpayment,0,4500
7vsTXXN7,4500,3/5/2019,10000,7vsTXXN7,41500,more than downpayment,more than downpayment,0,4500
7vsTXXN7,4500,4/5/2019,10000,7vsTXXN7,46000,more than downpayment,more than downpayment,0,4500
7vsTXXN7,4500,5/5/2019,10000,7vsTXXN7,50500,more than downpayment,more than downpayment,0,4500
7vsTXXN7,4500,6/7/2019,10000,7vsTXXN7,55000,more than downpayment,more than downpayment,0,4500
7vsTXXN7,4500,7/6/2019,10000,7vsTXXN7,59500,more than downpayment,more than downpayment,0,4500
7vsTXXN7,4500,8/6/2019,10000,7vsTXXN7,64000,more than downpayment,more than downpayment,0,4500
7W7cHlxb,9000,2/5/2019,8900,,9000,more than downpayment,,8900,100
7W7cHlxb,5000,3/10/2019,8900,7W7cHlxb,14000,more than downpayment,more than downpayment,0,5000
7W7cHlxb,6000,4/5/2019,8900,7W7cHlxb,20000,more than downpayment,more than downpayment,0,6000
7W7cHlxb,3900,5/4/2019,8900,7W7cHlxb,23900,more than downpayment,more than downpayment,0,3900
7W7cHlxb,3900,5/29/2019,8900,7W7cHlxb,27800,more than downpayment,more than downpayment,0,3900
7W7cHlxb,3900,7/5/2019,8900,7W7cHlxb,31700,more than downpayment,more than downpayment,0,3900
7W7cHlxb,3900,8/1/2019,8900,7W7cHlxb,35600,more than downpayment,more than downpayment,0,3900
7W7cHlxb,3900,9/5/2019,8900,7W7cHlxb,39500,more than downpayment,more than downpayment,0,3900
7W7cHlxb,3900,10/5/2019,8900,7W7cHlxb,43400,more than downpayment,more than downpayment,0,3900
7W7cHlxb,3900,11/5/2019,8900,7W7cHlxb,47300,more than downpayment,more than downpayment,0,3900
7W7cHlxb,3900,11/24/2019,8900,7W7cHlxb,51200,more than downpayment,more than downpayment,0,3900
7W7cHlxb,3900,1/1/2020,8900,7W7cHlxb,55100,more than downpayment,more than downpayment,0,3900
7W7cHlxb,3900,2/5/2020,8900,7W7cHlxb,59000,more than downpayment,more than downpayment,0,3900
7Wc8PFlJ,8900,5/14/2019,8900,,8900,equal to downpayment,,8900,0
7Wc8PFlJ,3900,6/24/2019,8900,7Wc8PFlJ,12800,more than downpayment,equal to downpayment,0,3900
7Wc8PFlJ,4000,7/31/2019,8900,7Wc8PFlJ,16800,more than downpayment,more than downpayment,0,4000
7Wc8PFlJ,4000,8/29/2019,8900,7Wc8PFlJ,20800,more than downpayment,more than downpayment,0,4000
7Wc8PFlJ,4000,9/27/2019,8900,7Wc8PFlJ,24800,more than downpayment,more than downpayment,0,4000
7Wc8PFlJ,3900,10/28/2019,8900,7Wc8PFlJ,28700,more than downpayment,more than downpayment,0,3900
7Wc8PFlJ,3999,12/5/2019,8900,7Wc8PFlJ,32699,more than downpayment,more than downpayment,0,3999
7Wc8PFlJ,3900,12/30/2019,8900,7Wc8PFlJ,36599,more than downpayment,more than downpayment,0,3900
7Wc8PFlJ,3900,1/30/2020,8900,7Wc8PFlJ,40499,more than downpayment,more than downpayment,0,3900
7X8JZXQM,9900,7/25/2019,9900,,9900,equal to downpayment,,9900,0
7X8JZXQM,3900,9/13/2019,9900,7X8JZXQM,13800,more than downpayment,equal to downpayment,0,3900
7X8JZXQM,3900,10/14/2019,9900,7X8JZXQM,17700,more than downpayment,more than downpayment,0,3900
7X8JZXQM,3900,11/28/2019,9900,7X8JZXQM,21600,more than downpayment,more than downpayment,0,3900
7X8JZXQM,3900,12/15/2019,9900,7X8JZXQM,25500,more than downpayment,more than downpayment,0,3900
7X8JZXQM,3750,1/16/2020,9900,7X8JZXQM,29250,more than downpayment,more than downpayment,0,3750
7X8JZXQM,150,1/30/2020,9900,7X8JZXQM,29400,more than downpayment,more than downpayment,0,150
7XI5OVGG,9900,11/18/2019,9900,,9900,equal to downpayment,,9900,0
7XI5OVGG,3900,12/26/2019,9900,7XI5OVGG,13800,more than downpayment,equal to downpayment,0,3900
7XI5OVGG,3900,1/24/2020,9900,7XI5OVGG,17700,more than downpayment,more than downpayment,0,3900
7XKP1AMW,9900,11/25/2019,9900,,9900,equal to downpayment,,9900,0
7XKP1AMW,3900,1/17/2020,9900,7XKP1AMW,13800,more than downpayment,equal to downpayment,0,3900
7XMLY7H6,9900,12/7/2019,9900,,9900,equal to downpayment,,9900,0
7XMLY7H6,4000,1/30/2020,9900,7XMLY7H6,13900,more than downpayment,equal to downpayment,0,4000
7Z1CKZ7E,26250,10/11/2019,8900,,26250,more than downpayment,,8900,17350
7Z1CKZ7E,26250,10/28/2019,8900,7Z1CKZ7E,52500,more than downpayment,more than downpayment,0,26250
7Z1CKZ7E,26250,11/25/2019,8900,7Z1CKZ7E,78750,more than downpayment,more than downpayment,0,26250
7Z1CKZ7E,26250,12/28/2019,8900,7Z1CKZ7E,105000,more than downpayment,more than downpayment,0,26250
7Z2DM75O,9900,9/24/2019,9900,,9900,equal to downpayment,,9900,0
7Z2DM75O,4000,11/28/2019,9900,7Z2DM75O,13900,more than downpayment,equal to downpayment,0,4000
7Z2DM75O,500,1/13/2020,9900,7Z2DM75O,14400,more than downpayment,more than downpayment,0,500
7Z2DM75O,500,1/29/2020,9900,7Z2DM75O,14900,more than downpayment,more than downpayment,0,500
7Z2DM75O,6400,2/7/2020,9900,7Z2DM75O,21300,more than downpayment,more than downpayment,0,6400
7Z6293RD,10000,1/25/2020,9900,,10000,more than downpayment,,9900,100
7ZCURXN6,9900,9/11/2019,9900,,9900,equal to downpayment,,9900,0
7ZCURXN6,3900,11/4/2019,9900,7ZCURXN6,13800,more than downpayment,equal to downpayment,0,3900
7ZCURXN6,3900,12/4/2019,9900,7ZCURXN6,17700,more than downpayment,more than downpayment,0,3900
7ZCURXN6,3900,1/6/2020,9900,7ZCURXN6,21600,more than downpayment,more than downpayment,0,3900
7ZCURXN6,3900,2/5/2020,9900,7ZCURXN6,25500,more than downpayment,more than downpayment,0,3900
7ZCXI5O2,10000,10/8/2019,9900,,10000,more than downpayment,,9900,100
7ZCXI5O2,3900,12/9/2019,9900,7ZCXI5O2,13900,more than downpayment,more than downpayment,0,3900
7ZCXI5O2,3900,1/12/2020,9900,7ZCXI5O2,17800,more than downpayment,more than downpayment,0,3900
7zs6maTi,10000,6/10/2019,8900,,10000,more than downpayment,,8900,1100
7zs6maTi,4000,7/20/2019,8900,7zs6maTi,14000,more than downpayment,more than downpayment,0,4000
7zs6maTi,4000,8/27/2019,8900,7zs6maTi,18000,more than downpayment,more than downpayment,0,4000
7zs6maTi,4000,9/19/2019,8900,7zs6maTi,22000,more than downpayment,more than downpayment,0,4000
7zs6maTi,4000,10/3/2019,8900,7zs6maTi,26000,more than downpayment,more than downpayment,0,4000
7zs6maTi,4000,11/15/2019,8900,7zs6maTi,30000,more than downpayment,more than downpayment,0,4000
7zs6maTi,4000,12/5/2019,8900,7zs6maTi,34000,more than downpayment,more than downpayment,0,4000
7zs6maTi,3000,1/27/2020,8900,7zs6maTi,37000,more than downpayment,more than downpayment,0,3000
7ZyfU38T,9900,6/13/2019,9900,,9900,equal to downpayment,,9900,0
7ZyfU38T,7800,8/20/2019,9900,7ZyfU38T,17700,more than downpayment,equal to downpayment,0,7800
7ZyfU38T,3900,9/25/2019,9900,7ZyfU38T,21600,more than downpayment,more than downpayment,0,3900
7ZyfU38T,3900,11/28/2019,9900,7ZyfU38T,25500,more than downpayment,more than downpayment,0,3900
7ZyfU38T,3900,1/2/2020,9900,7ZyfU38T,29400,more than downpayment,more than downpayment,0,3900
7ZyfU38T,3900,1/24/2020,9900,7ZyfU38T,33300,more than downpayment,more than downpayment,0,3900
80337cce,8900,1/23/2020,8900,,8900,equal to downpayment,,8900,0
80O1ERDx,9900,7/22/2019,9900,,9900,equal to downpayment,,9900,0
80yp1dnd,8900,8/6/2019,8900,,8900,equal to downpayment,,8900,0
80yp1dnd,3900,9/5/2019,8900,80yp1dnd,12800,more than downpayment,equal to downpayment,0,3900
80yp1dnd,3900,10/4/2019,8900,80yp1dnd,16700,more than downpayment,more than downpayment,0,3900
80yp1dnd,3900,11/5/2019,8900,80yp1dnd,20600,more than downpayment,more than downpayment,0,3900
80yp1dnd,3900,12/15/2019,8900,80yp1dnd,24500,more than downpayment,more than downpayment,0,3900
80yp1dnd,3900,1/13/2020,8900,80yp1dnd,28400,more than downpayment,more than downpayment,0,3900
80yp1dnd,3900,2/5/2020,8900,80yp1dnd,32300,more than downpayment,more than downpayment,0,3900
81ac62d9,8900,1/18/2020,8900,,8900,equal to downpayment,,8900,0
81RS879Z,1599,10/14/2019,1594,,1599,more than downpayment,,1594,5
81RS879Z,3100,1/6/2020,1594,81RS879Z,4699,more than downpayment,more than downpayment,0,3100
81RS879Z,3100,2/5/2020,1594,81RS879Z,7799,more than downpayment,more than downpayment,0,3100
8277EPIF,9900,7/31/2019,9900,,9900,equal to downpayment,,9900,0
82b174fa,9900,1/8/2020,9900,,9900,equal to downpayment,,9900,0
82c35b80,8900,1/20/2020,8900,,8900,equal to downpayment,,8900,0
82db3608,8900,1/27/2020,8900,,8900,equal to downpayment,,8900,0
82Ru2NBt,8900,2/12/2019,8900,,8900,equal to downpayment,,8900,0
82Ru2NBt,3900,3/16/2019,8900,82Ru2NBt,12800,more than downpayment,equal to downpayment,0,3900
82Ru2NBt,3900,4/16/2019,8900,82Ru2NBt,16700,more than downpayment,more than downpayment,0,3900
82Ru2NBt,3900,5/21/2019,8900,82Ru2NBt,20600,more than downpayment,more than downpayment,0,3900
82Ru2NBt,3900,6/28/2019,8900,82Ru2NBt,24500,more than downpayment,more than downpayment,0,3900
82Ru2NBt,3900,8/7/2019,8900,82Ru2NBt,28400,more than downpayment,more than downpayment,0,3900
82Ru2NBt,3900,9/7/2019,8900,82Ru2NBt,32300,more than downpayment,more than downpayment,0,3900
82Ru2NBt,3900,10/11/2019,8900,82Ru2NBt,36200,more than downpayment,more than downpayment,0,3900
82Ru2NBt,3900,11/15/2019,8900,82Ru2NBt,40100,more than downpayment,more than downpayment,0,3900
82Ru2NBt,3900,12/24/2019,8900,82Ru2NBt,44000,more than downpayment,more than downpayment,0,3900
82SHiwhu,9900,12/18/2018,9900,,9900,equal to downpayment,,9900,0
82SHiwhu,4500,2/5/2019,9900,82SHiwhu,14400,more than downpayment,equal to downpayment,0,4500
82SHiwhu,4500,3/1/2019,9900,82SHiwhu,18900,more than downpayment,more than downpayment,0,4500
82SHiwhu,4500,5/12/2019,9900,82SHiwhu,23400,more than downpayment,more than downpayment,0,4500
82SHiwhu,18000,7/11/2019,9900,82SHiwhu,41400,more than downpayment,more than downpayment,0,18000
82SHiwhu,4500,9/2/2019,9900,82SHiwhu,45900,more than downpayment,more than downpayment,0,4500
82SHiwhu,9000,10/13/2019,9900,82SHiwhu,54900,more than downpayment,more than downpayment,0,9000
82SHiwhu,4500,1/10/2020,9900,82SHiwhu,59400,more than downpayment,more than downpayment,0,4500
82YBH9FT,8900,11/8/2019,8900,,8900,equal to downpayment,,8900,0
82YBH9FT,3900,12/6/2019,8900,82YBH9FT,12800,more than downpayment,equal to downpayment,0,3900
82YBH9FT,3900,1/12/2020,8900,82YBH9FT,16700,more than downpayment,more than downpayment,0,3900
8.34E+10,29488,9/23/2019,7900,,29488,more than downpayment,,7900,21588
8.34E+10,3100,11/19/2019,7900,8.34E+10,32588,more than downpayment,more than downpayment,0,3100
83742725,8900,2/6/2020,8900,,8900,equal to downpayment,,8900,0
8387ae44,9900,11/22/2019,9900,,9900,equal to downpayment,,9900,0
83dbdcfc,5000,2/8/2020,4999,,5000,more than downpayment,,4999,1
83eafcb1,9900,1/23/2020,9900,,9900,equal to downpayment,,9900,0
83Li6710,10000,11/30/2017,10000,,10000,equal to downpayment,,10000,0
83Li6710,4500,3/5/2018,10000,83Li6710,14500,more than downpayment,equal to downpayment,0,4500
83Li6710,4500,4/15/2018,10000,83Li6710,19000,more than downpayment,more than downpayment,0,4500
83Li6710,5000,5/14/2018,10000,83Li6710,24000,more than downpayment,more than downpayment,0,5000
83Li6710,4000,5/19/2018,10000,83Li6710,28000,more than downpayment,more than downpayment,0,4000
83Li6710,5000,7/14/2018,10000,83Li6710,33000,more than downpayment,more than downpayment,0,5000
83Li6710,3000,8/15/2018,10000,83Li6710,36000,more than downpayment,more than downpayment,0,3000
83Li6710,4500,8/20/2018,10000,83Li6710,40500,more than downpayment,more than downpayment,0,4500
83Li6710,8000,9/13/2018,10000,83Li6710,48500,more than downpayment,more than downpayment,0,8000
83Li6710,2000,10/15/2018,10000,83Li6710,50500,more than downpayment,more than downpayment,0,2000
83Li6710,4600,11/15/2018,10000,83Li6710,55100,more than downpayment,more than downpayment,0,4600
83Li6710,4600,12/15/2018,10000,83Li6710,59700,more than downpayment,more than downpayment,0,4600
83Li6710,4300,1/14/2019,10000,83Li6710,64000,more than downpayment,more than downpayment,0,4300
83Li6710,2000,7/12/2019,10000,83Li6710,66000,more than downpayment,more than downpayment,0,2000
83Li6710,2000,9/16/2019,10000,83Li6710,68000,more than downpayment,more than downpayment,0,2000
83ZTYWUO,9900,12/3/2019,9900,,9900,equal to downpayment,,9900,0
842d56ef,10100,10/2/2019,9900,,10100,more than downpayment,,9900,200
842d56ef,4200,10/30/2019,9900,842d56ef,14300,more than downpayment,more than downpayment,0,4200
842d56ef,4000,11/29/2019,9900,842d56ef,18300,more than downpayment,more than downpayment,0,4000
842d56ef,4000,12/26/2019,9900,842d56ef,22300,more than downpayment,more than downpayment,0,4000
842d56ef,4000,1/24/2020,9900,842d56ef,26300,more than downpayment,more than downpayment,0,4000
8471e6e0,9000,10/2/2019,26250,,9000,less than downpayment,,9000,0
84805aad,7900,11/9/2019,7900,,7900,equal to downpayment,,7900,0
84805aad,3000,12/4/2019,7900,84805aad,10900,more than downpayment,equal to downpayment,0,3000
84805aad,200,12/30/2019,7900,84805aad,11100,more than downpayment,more than downpayment,0,200
84805aad,3500,1/3/2020,7900,84805aad,14600,more than downpayment,more than downpayment,0,3500
84805aad,3100,2/3/2020,7900,84805aad,17700,more than downpayment,more than downpayment,0,3100
84a7c6f4,23500,10/29/2019,23400,,23500,more than downpayment,,23400,100
84a7c6f4,7300,12/19/2019,23400,84a7c6f4,30800,more than downpayment,more than downpayment,0,7300
84a7c6f4,7300,1/28/2020,23400,84a7c6f4,38100,more than downpayment,more than downpayment,0,7300
84bed5e0,8900,1/6/2020,8900,,8900,equal to downpayment,,8900,0
84WWV9HL,2000,9/25/2019,8900,,2000,less than downpayment,,2000,0
84WWV9HL,6900,10/2/2019,8900,84WWV9HL,8900,equal to downpayment,less than downpayment,6900,0
84WWV9HL,2000,11/7/2019,8900,84WWV9HL,10900,more than downpayment,equal to downpayment,0,2000
84WWV9HL,1900,11/21/2019,8900,84WWV9HL,12800,more than downpayment,more than downpayment,0,1900
84WWV9HL,3900,11/28/2019,8900,84WWV9HL,16700,more than downpayment,more than downpayment,0,3900
84WWV9HL,3900,1/1/2020,8900,84WWV9HL,20600,more than downpayment,more than downpayment,0,3900
84WWV9HL,3900,1/24/2020,8900,84WWV9HL,24500,more than downpayment,more than downpayment,0,3900
8545370f,9900,10/26/2019,9900,,9900,equal to downpayment,,9900,0
8545370f,4000,12/23/2019,9900,8545370f,13900,more than downpayment,equal to downpayment,0,4000
8545370f,3900,1/21/2020,9900,8545370f,17800,more than downpayment,more than downpayment,0,3900
855XU9LD,9900,1/27/2020,9900,,9900,equal to downpayment,,9900,0
85d7be56,1594,10/14/2019,8900,,1594,less than downpayment,,1594,0
862401ac,1594,10/14/2019,1594,,1594,equal to downpayment,,1594,0
8741c4b2,9900,11/20/2019,9900,,9900,equal to downpayment,,9900,0
8741c4b2,3900,1/6/2020,9900,8741c4b2,13800,more than downpayment,equal to downpayment,0,3900
8741c4b2,3900,2/5/2020,9900,8741c4b2,17700,more than downpayment,more than downpayment,0,3900
87IW5XJY,8900,10/2/2019,8900,,8900,equal to downpayment,,8900,0
87IW5XJY,3900,12/5/2019,8900,87IW5XJY,12800,more than downpayment,equal to downpayment,0,3900
87IW5XJY,3900,1/7/2020,8900,87IW5XJY,16700,more than downpayment,more than downpayment,0,3900
87IW5XJY,3900,2/4/2020,8900,87IW5XJY,20600,more than downpayment,more than downpayment,0,3900
887bd444,1594,10/14/2019,1594,,1594,equal to downpayment,,1594,0
887bd444,3100,11/22/2019,1594,887bd444,4694,more than downpayment,equal to downpayment,0,3100
887bd444,1500,1/26/2020,1594,887bd444,6194,more than downpayment,more than downpayment,0,1500
89e98893,9900,12/30/2019,9900,,9900,equal to downpayment,,9900,0
89XNHAI2,9900,11/25/2019,9900,,9900,equal to downpayment,,9900,0
89XNHAI2,8000,12/27/2019,9900,89XNHAI2,17900,more than downpayment,equal to downpayment,0,8000
89XNHAI2,5000,1/25/2020,9900,89XNHAI2,22900,more than downpayment,more than downpayment,0,5000
8a0Y9cqw,10000,11/30/2018,10000,,10000,equal to downpayment,,10000,0
8a0Y9cqw,4000,1/30/2019,10000,8a0Y9cqw,14000,more than downpayment,equal to downpayment,0,4000
8a0Y9cqw,500,2/8/2019,10000,8a0Y9cqw,14500,more than downpayment,more than downpayment,0,500
8a0Y9cqw,1600,3/6/2019,10000,8a0Y9cqw,16100,more than downpayment,more than downpayment,0,1600
8a512f34,9900,1/7/2020,9900,,9900,equal to downpayment,,9900,0
8adf10a7,8900,9/19/2019,8900,,8900,equal to downpayment,,8900,0
8adf10a7,3900,10/29/2019,8900,8adf10a7,12800,more than downpayment,equal to downpayment,0,3900
8adf10a7,3900,11/25/2019,8900,8adf10a7,16700,more than downpayment,more than downpayment,0,3900
8adf10a7,3900,12/26/2019,8900,8adf10a7,20600,more than downpayment,more than downpayment,0,3900
8adf10a7,3900,1/27/2020,8900,8adf10a7,24500,more than downpayment,more than downpayment,0,3900
8aYUdttS,9900,7/6/2019,9900,,9900,equal to downpayment,,9900,0
8aYUdttS,3900,8/26/2019,9900,8aYUdttS,13800,more than downpayment,equal to downpayment,0,3900
8aYUdttS,3900,9/25/2019,9900,8aYUdttS,17700,more than downpayment,more than downpayment,0,3900
8aYUdttS,3900,10/25/2019,9900,8aYUdttS,21600,more than downpayment,more than downpayment,0,3900
8aYUdttS,3900,11/25/2019,9900,8aYUdttS,25500,more than downpayment,more than downpayment,0,3900
8aYUdttS,3900,12/25/2019,9900,8aYUdttS,29400,more than downpayment,more than downpayment,0,3900
8aYUdttS,3900,1/25/2020,9900,8aYUdttS,33300,more than downpayment,more than downpayment,0,3900
8b365ff4,8900,1/14/2020,8900,,8900,equal to downpayment,,8900,0
8be14dce,8900,11/20/2019,8900,,8900,equal to downpayment,,8900,0
8c68edf4,20000,10/15/2019,9900,,20000,more than downpayment,,9900,10100
8c833d9f,9900,1/9/2020,9900,,9900,equal to downpayment,,9900,0
8C8Z7HO6,9900,11/11/2019,9900,,9900,equal to downpayment,,9900,0
8C8Z7HO6,3900,12/10/2019,9900,8C8Z7HO6,13800,more than downpayment,equal to downpayment,0,3900
8C8Z7HO6,3900,1/5/2020,9900,8C8Z7HO6,17700,more than downpayment,more than downpayment,0,3900
8cecf681,9900,10/24/2019,9900,,9900,equal to downpayment,,9900,0
8cecf681,10000,12/13/2019,9900,8cecf681,19900,more than downpayment,equal to downpayment,0,10000
8cecf681,10000,1/3/2020,9900,8cecf681,29900,more than downpayment,more than downpayment,0,10000
8cecf681,10000,2/8/2020,9900,8cecf681,39900,more than downpayment,more than downpayment,0,10000
8cfc1d10,7900,11/1/2019,7900,,7900,equal to downpayment,,7900,0
8cfc1d10,3100,12/8/2019,7900,8cfc1d10,11000,more than downpayment,equal to downpayment,0,3100
8cfc1d10,3100,1/6/2020,7900,8cfc1d10,14100,more than downpayment,more than downpayment,0,3100
8cfc1d10,3100,2/5/2020,7900,8cfc1d10,17200,more than downpayment,more than downpayment,0,3100
8CGPVFVY,9900,1/2/2020,9900,,9900,equal to downpayment,,9900,0
8CMUDX11,9900,8/30/2019,9900,,9900,equal to downpayment,,9900,0
8CMUDX11,3800,1/4/2020,9900,8CMUDX11,13700,more than downpayment,equal to downpayment,0,3800
8CMUDX11,2000,1/6/2020,9900,8CMUDX11,15700,more than downpayment,more than downpayment,0,2000
8CMUDX11,2000,1/20/2020,9900,8CMUDX11,17700,more than downpayment,more than downpayment,0,2000
8CMUDX11,1500,1/23/2020,9900,8CMUDX11,19200,more than downpayment,more than downpayment,0,1500
8CMUDX11,2400,1/31/2020,9900,8CMUDX11,21600,more than downpayment,more than downpayment,0,2400
8COY9LFU,9900,9/22/2019,8900,,9900,more than downpayment,,8900,1000
8COY9LFU,3900,12/5/2019,8900,8COY9LFU,13800,more than downpayment,more than downpayment,0,3900
8COY9LFU,3900,1/6/2020,8900,8COY9LFU,17700,more than downpayment,more than downpayment,0,3900
8COY9LFU,3900,2/4/2020,8900,8COY9LFU,21600,more than downpayment,more than downpayment,0,3900
8D11HGOZ,8900,11/17/2019,9900,,8900,less than downpayment,,8900,0
8D11HGOZ,1000,12/30/2019,9900,8D11HGOZ,9900,equal to downpayment,less than downpayment,1000,0
8d7d88a0,100,10/19/2019,8900,,100,less than downpayment,,100,0
8dbc0312,9900,1/6/2020,9900,,9900,equal to downpayment,,9900,0
8dy4uH2Z,10000,7/25/2019,8900,,10000,more than downpayment,,8900,1100
8dy4uH2Z,4000,10/11/2019,8900,8dy4uH2Z,14000,more than downpayment,more than downpayment,0,4000
8dy4uH2Z,3000,10/27/2019,8900,8dy4uH2Z,17000,more than downpayment,more than downpayment,0,3000
8dy4uH2Z,900,10/29/2019,8900,8dy4uH2Z,17900,more than downpayment,more than downpayment,0,900
8dy4uH2Z,3900,11/22/2019,8900,8dy4uH2Z,21800,more than downpayment,more than downpayment,0,3900
8dy4uH2Z,7800,1/23/2020,8900,8dy4uH2Z,29600,more than downpayment,more than downpayment,0,7800
8DZKBZPF,9900,8/15/2019,9900,,9900,equal to downpayment,,9900,0
8DZKBZPF,3900,9/24/2019,9900,8DZKBZPF,13800,more than downpayment,equal to downpayment,0,3900
8DZKBZPF,400,10/14/2019,9900,8DZKBZPF,14200,more than downpayment,more than downpayment,0,400
8DZKBZPF,500,10/17/2019,9900,8DZKBZPF,14700,more than downpayment,more than downpayment,0,500
8DZKBZPF,1000,10/19/2019,9900,8DZKBZPF,15700,more than downpayment,more than downpayment,0,1000
8DZKBZPF,2000,10/29/2019,9900,8DZKBZPF,17700,more than downpayment,more than downpayment,0,2000
8DZKBZPF,3900,12/9/2019,9900,8DZKBZPF,21600,more than downpayment,more than downpayment,0,3900
8DZKBZPF,3900,1/1/2020,9900,8DZKBZPF,25500,more than downpayment,more than downpayment,0,3900
8DZKBZPF,3000,2/3/2020,9900,8DZKBZPF,28500,more than downpayment,more than downpayment,0,3000
8DZKBZPF,900,2/5/2020,9900,8DZKBZPF,29400,more than downpayment,more than downpayment,0,900
8E2J7Eik,9900,6/10/2019,8900,,9900,more than downpayment,,8900,1000
8E2J7Eik,3900,7/25/2019,8900,8E2J7Eik,13800,more than downpayment,more than downpayment,0,3900
8E2J7Eik,1900,8/29/2019,8900,8E2J7Eik,15700,more than downpayment,more than downpayment,0,1900
8E2J7Eik,1000,9/13/2019,8900,8E2J7Eik,16700,more than downpayment,more than downpayment,0,1000
8E2J7Eik,1000,10/1/2019,8900,8E2J7Eik,17700,more than downpayment,more than downpayment,0,1000
8E2J7Eik,1000,10/7/2019,8900,8E2J7Eik,18700,more than downpayment,more than downpayment,0,1000
8E2J7Eik,2200,10/28/2019,8900,8E2J7Eik,20900,more than downpayment,more than downpayment,0,2200
8E2J7Eik,700,10/31/2019,8900,8E2J7Eik,21600,more than downpayment,more than downpayment,0,700
8E2J7Eik,300,11/7/2019,8900,8E2J7Eik,21900,more than downpayment,more than downpayment,0,300
8E2J7Eik,400,11/24/2019,8900,8E2J7Eik,22300,more than downpayment,more than downpayment,0,400
8E2J7Eik,450,11/26/2019,8900,8E2J7Eik,22750,more than downpayment,more than downpayment,0,450
8E2J7Eik,3000,11/27/2019,8900,8E2J7Eik,25750,more than downpayment,more than downpayment,0,3000
8E2J7Eik,450,12/22/2019,8900,8E2J7Eik,26200,more than downpayment,more than downpayment,0,450
8E2J7Eik,1550,12/23/2019,8900,8E2J7Eik,27750,more than downpayment,more than downpayment,0,1550
8E2J7Eik,1950,1/12/2020,8900,8E2J7Eik,29700,more than downpayment,more than downpayment,0,1950
8E2J7Eik,450,1/14/2020,8900,8E2J7Eik,30150,more than downpayment,more than downpayment,0,450
8E2J7Eik,2000,1/21/2020,8900,8E2J7Eik,32150,more than downpayment,more than downpayment,0,2000
8e840e3c,9900,12/18/2019,9900,,9900,equal to downpayment,,9900,0
8e89ae3a,9900,9/9/2019,9900,,9900,equal to downpayment,,9900,0
8e89ae3a,3900,12/16/2019,9900,8e89ae3a,13800,more than downpayment,equal to downpayment,0,3900
8ebe7752,9900,9/26/2019,9900,,9900,equal to downpayment,,9900,0
8ebe7752,3900,10/20/2019,9900,8ebe7752,13800,more than downpayment,equal to downpayment,0,3900
8ebe7752,3900,11/30/2019,9900,8ebe7752,17700,more than downpayment,more than downpayment,0,3900
8ebe7752,2000,12/20/2019,9900,8ebe7752,19700,more than downpayment,more than downpayment,0,2000
8ebe7752,1900,1/2/2020,9900,8ebe7752,21600,more than downpayment,more than downpayment,0,1900
8ebe7752,3900,2/1/2020,9900,8ebe7752,25500,more than downpayment,more than downpayment,0,3900
8ELGVO2L,7500,12/14/2019,9900,,7500,less than downpayment,,7500,0
8ELGVO2L,1400,12/17/2019,9900,8ELGVO2L,8900,less than downpayment,less than downpayment,1400,0
8ELGVO2L,1000,12/21/2019,9900,8ELGVO2L,9900,equal to downpayment,less than downpayment,1000,0
8fcd0055,9900,9/17/2019,9900,,9900,equal to downpayment,,9900,0
8fGFiY0k,8900,11/15/2019,8900,,8900,equal to downpayment,,8900,0
8fGFiY0k,3250,12/29/2019,8900,8fGFiY0k,12150,more than downpayment,equal to downpayment,0,3250
8fGFiY0k,800,1/15/2020,8900,8fGFiY0k,12950,more than downpayment,more than downpayment,0,800
8GXV27E8,9900,9/28/2019,9900,,9900,equal to downpayment,,9900,0
8GXV27E8,3900,11/19/2019,9900,8GXV27E8,13800,more than downpayment,equal to downpayment,0,3900
8GXV27E8,3900,12/21/2019,9900,8GXV27E8,17700,more than downpayment,more than downpayment,0,3900
8GXV27E8,3900,1/22/2020,9900,8GXV27E8,21600,more than downpayment,more than downpayment,0,3900
8Heql6PG,3900,9/21/2018,8900,,3900,less than downpayment,,3900,0
8Heql6PG,8900,5/28/2019,8900,8Heql6PG,12800,more than downpayment,less than downpayment,5000,3900
8Heql6PG,3900,7/11/2019,8900,8Heql6PG,16700,more than downpayment,more than downpayment,0,3900
8Heql6PG,3900,8/18/2019,8900,8Heql6PG,20600,more than downpayment,more than downpayment,0,3900
8Heql6PG,3900,10/7/2019,8900,8Heql6PG,24500,more than downpayment,more than downpayment,0,3900
8Heql6PG,3000,11/14/2019,8900,8Heql6PG,27500,more than downpayment,more than downpayment,0,3000
8Heql6PG,900,11/29/2019,8900,8Heql6PG,28400,more than downpayment,more than downpayment,0,900
8Heql6PG,3000,1/22/2020,8900,8Heql6PG,31400,more than downpayment,more than downpayment,0,3000
8Heql6PG,4800,1/29/2020,8900,8Heql6PG,36200,more than downpayment,more than downpayment,0,4800
8HO78STD,9900,11/2/2019,9900,,9900,equal to downpayment,,9900,0
8HO78STD,3900,1/2/2020,9900,8HO78STD,13800,more than downpayment,equal to downpayment,0,3900
8HO78STD,3900,2/3/2020,9900,8HO78STD,17700,more than downpayment,more than downpayment,0,3900
8hTDOgwW,8900,7/29/2019,8900,,8900,equal to downpayment,,8900,0
8hTDOgwW,3900,10/4/2019,8900,8hTDOgwW,12800,more than downpayment,equal to downpayment,0,3900
8hTDOgwW,3900,11/15/2019,8900,8hTDOgwW,16700,more than downpayment,more than downpayment,0,3900
8hTDOgwW,3900,12/6/2019,8900,8hTDOgwW,20600,more than downpayment,more than downpayment,0,3900
8hTDOgwW,3900,1/22/2020,8900,8hTDOgwW,24500,more than downpayment,more than downpayment,0,3900
8hTDOgwW,3900,1/26/2020,8900,8hTDOgwW,28400,more than downpayment,more than downpayment,0,3900
8HWI8JWJ,8900,9/30/2019,8900,,8900,equal to downpayment,,8900,0
8HWI8JWJ,3900,12/3/2019,8900,8HWI8JWJ,12800,more than downpayment,equal to downpayment,0,3900
8HWI8JWJ,3900,12/26/2019,8900,8HWI8JWJ,16700,more than downpayment,more than downpayment,0,3900
8HWI8JWJ,3900,1/28/2020,8900,8HWI8JWJ,20600,more than downpayment,more than downpayment,0,3900
8IPLKAZW,8900,11/8/2019,8900,,8900,equal to downpayment,,8900,0
8IPLKAZW,3900,12/27/2019,8900,8IPLKAZW,12800,more than downpayment,equal to downpayment,0,3900
8IPLKAZW,3900,1/25/2020,8900,8IPLKAZW,16700,more than downpayment,more than downpayment,0,3900
8k3Vwvlp,10000,6/27/2019,9900,,10000,more than downpayment,,9900,100
8k3Vwvlp,4000,9/9/2019,9900,8k3Vwvlp,14000,more than downpayment,more than downpayment,0,4000
8k3Vwvlp,16000,1/1/2020,9900,8k3Vwvlp,30000,more than downpayment,more than downpayment,0,16000
8L46NHQ6,9900,11/15/2019,9900,,9900,equal to downpayment,,9900,0
8L46NHQ6,3900,1/18/2020,9900,8L46NHQ6,13800,more than downpayment,equal to downpayment,0,3900
8L46NHQ6,3900,2/6/2020,9900,8L46NHQ6,17700,more than downpayment,more than downpayment,0,3900
8L6OOUOH,13800,8/6/2019,9900,,13800,more than downpayment,,9900,3900
8L6OOUOH,3900,10/6/2019,9900,8L6OOUOH,17700,more than downpayment,more than downpayment,0,3900
8L6OOUOH,7800,1/25/2020,9900,8L6OOUOH,25500,more than downpayment,more than downpayment,0,7800
8LhNtNZu,9000,4/19/2019,8900,,9000,more than downpayment,,8900,100
8LhNtNZu,3900,6/15/2019,8900,8LhNtNZu,12900,more than downpayment,more than downpayment,0,3900
8LhNtNZu,3900,7/20/2019,8900,8LhNtNZu,16800,more than downpayment,more than downpayment,0,3900
8LhNtNZu,3900,8/22/2019,8900,8LhNtNZu,20700,more than downpayment,more than downpayment,0,3900
8LhNtNZu,3900,9/17/2019,8900,8LhNtNZu,24600,more than downpayment,more than downpayment,0,3900
8LhNtNZu,3900,10/15/2019,8900,8LhNtNZu,28500,more than downpayment,more than downpayment,0,3900
8LhNtNZu,3999,12/15/2019,8900,8LhNtNZu,32499,more than downpayment,more than downpayment,0,3999
8LhNtNZu,4500,2/3/2020,8900,8LhNtNZu,36999,more than downpayment,more than downpayment,0,4500
8LQ4QGKV,8900,7/12/2019,8900,,8900,equal to downpayment,,8900,0
8LQ4QGKV,3900,9/5/2019,8900,8LQ4QGKV,12800,more than downpayment,equal to downpayment,0,3900
8LQ4QGKV,3900,10/5/2019,8900,8LQ4QGKV,16700,more than downpayment,more than downpayment,0,3900
8LQ4QGKV,3900,11/5/2019,8900,8LQ4QGKV,20600,more than downpayment,more than downpayment,0,3900
8LQ4QGKV,3900,12/7/2019,8900,8LQ4QGKV,24500,more than downpayment,more than downpayment,0,3900
8LQ4QGKV,3900,1/7/2020,8900,8LQ4QGKV,28400,more than downpayment,more than downpayment,0,3900
8LQ4QGKV,3900,2/5/2020,8900,8LQ4QGKV,32300,more than downpayment,more than downpayment,0,3900
8NguTkvL,8900,4/18/2019,8900,,8900,equal to downpayment,,8900,0
8NguTkvL,3900,5/23/2019,8900,8NguTkvL,12800,more than downpayment,equal to downpayment,0,3900
8NguTkvL,3900,6/23/2019,8900,8NguTkvL,16700,more than downpayment,more than downpayment,0,3900
8NguTkvL,3900,7/25/2019,8900,8NguTkvL,20600,more than downpayment,more than downpayment,0,3900
8NguTkvL,3900,8/25/2019,8900,8NguTkvL,24500,more than downpayment,more than downpayment,0,3900
8NguTkvL,3900,9/25/2019,8900,8NguTkvL,28400,more than downpayment,more than downpayment,0,3900
8NguTkvL,3900,10/25/2019,8900,8NguTkvL,32300,more than downpayment,more than downpayment,0,3900
8NguTkvL,3900,11/24/2019,8900,8NguTkvL,36200,more than downpayment,more than downpayment,0,3900
8NguTkvL,3900,12/24/2019,8900,8NguTkvL,40100,more than downpayment,more than downpayment,0,3900
8NguTkvL,3900,1/25/2020,8900,8NguTkvL,44000,more than downpayment,more than downpayment,0,3900
8O3Jcueh,8900,5/16/2019,8900,,8900,equal to downpayment,,8900,0
8O3Jcueh,3900,6/9/2019,8900,8O3Jcueh,12800,more than downpayment,equal to downpayment,0,3900
8O3Jcueh,3900,7/15/2019,8900,8O3Jcueh,16700,more than downpayment,more than downpayment,0,3900
8O3Jcueh,3900,8/11/2019,8900,8O3Jcueh,20600,more than downpayment,more than downpayment,0,3900
8O3Jcueh,200,9/30/2019,8900,8O3Jcueh,20800,more than downpayment,more than downpayment,0,200
8O3Jcueh,600,10/2/2019,8900,8O3Jcueh,21400,more than downpayment,more than downpayment,0,600
8O3Jcueh,1000,10/3/2019,8900,8O3Jcueh,22400,more than downpayment,more than downpayment,0,1000
8O3Jcueh,2100,10/4/2019,8900,8O3Jcueh,24500,more than downpayment,more than downpayment,0,2100
8O3Jcueh,3900,10/23/2019,8900,8O3Jcueh,28400,more than downpayment,more than downpayment,0,3900
8O3Jcueh,4900,11/7/2019,8900,8O3Jcueh,33300,more than downpayment,more than downpayment,0,4900
8O3Jcueh,3900,12/12/2019,8900,8O3Jcueh,37200,more than downpayment,more than downpayment,0,3900
8O3Jcueh,3900,1/18/2020,8900,8O3Jcueh,41100,more than downpayment,more than downpayment,0,3900
8oFUda5c,8900,5/3/2019,8900,,8900,equal to downpayment,,8900,0
8oFUda5c,3900,5/6/2019,8900,8oFUda5c,12800,more than downpayment,equal to downpayment,0,3900
8oFUda5c,3900,5/27/2019,8900,8oFUda5c,16700,more than downpayment,more than downpayment,0,3900
8oFUda5c,3900,8/5/2019,8900,8oFUda5c,20600,more than downpayment,more than downpayment,0,3900
8oFUda5c,3900,10/2/2019,8900,8oFUda5c,24500,more than downpayment,more than downpayment,0,3900
8oFUda5c,3900,11/4/2019,8900,8oFUda5c,28400,more than downpayment,more than downpayment,0,3900
8oFUda5c,3900,12/6/2019,8900,8oFUda5c,32300,more than downpayment,more than downpayment,0,3900
8oFUda5c,2000,1/28/2020,8900,8oFUda5c,34300,more than downpayment,more than downpayment,0,2000
8oFUda5c,2000,1/30/2020,8900,8oFUda5c,36300,more than downpayment,more than downpayment,0,2000
8oFUda5c,2000,2/2/2020,8900,8oFUda5c,38300,more than downpayment,more than downpayment,0,2000
8p8Lk6pZ,8900,5/3/2019,8900,,8900,equal to downpayment,,8900,0
8p8Lk6pZ,4000,6/12/2019,8900,8p8Lk6pZ,12900,more than downpayment,equal to downpayment,0,4000
8p8Lk6pZ,4000,7/15/2019,8900,8p8Lk6pZ,16900,more than downpayment,more than downpayment,0,4000
8p8Lk6pZ,4000,8/15/2019,8900,8p8Lk6pZ,20900,more than downpayment,more than downpayment,0,4000
8p8Lk6pZ,4000,9/11/2019,8900,8p8Lk6pZ,24900,more than downpayment,more than downpayment,0,4000
8p8Lk6pZ,4000,10/15/2019,8900,8p8Lk6pZ,28900,more than downpayment,more than downpayment,0,4000
8p8Lk6pZ,4000,11/15/2019,8900,8p8Lk6pZ,32900,more than downpayment,more than downpayment,0,4000
8p8Lk6pZ,4000,12/14/2019,8900,8p8Lk6pZ,36900,more than downpayment,more than downpayment,0,4000
8p8Lk6pZ,3900,1/15/2020,8900,8p8Lk6pZ,40800,more than downpayment,more than downpayment,0,3900
8PAUO714,9900,10/5/2019,9900,,9900,equal to downpayment,,9900,0
8PR12D88,9900,11/27/2019,9900,,9900,equal to downpayment,,9900,0
8pv9ZM4b,8900,1/19/2019,8900,,8900,equal to downpayment,,8900,0
8pv9ZM4b,4000,2/2/2019,8900,8pv9ZM4b,12900,more than downpayment,equal to downpayment,0,4000
8pv9ZM4b,4000,3/5/2019,8900,8pv9ZM4b,16900,more than downpayment,more than downpayment,0,4000
8pv9ZM4b,1000,3/12/2019,8900,8pv9ZM4b,17900,more than downpayment,more than downpayment,0,1000
8pv9ZM4b,4000,3/25/2019,8900,8pv9ZM4b,21900,more than downpayment,more than downpayment,0,4000
8pv9ZM4b,3000,4/25/2019,8900,8pv9ZM4b,24900,more than downpayment,more than downpayment,0,3000
8pv9ZM4b,3900,6/4/2019,8900,8pv9ZM4b,28800,more than downpayment,more than downpayment,0,3900
8pv9ZM4b,3900,7/9/2019,8900,8pv9ZM4b,32700,more than downpayment,more than downpayment,0,3900
8pv9ZM4b,3900,8/21/2019,8900,8pv9ZM4b,36600,more than downpayment,more than downpayment,0,3900
8pv9ZM4b,3900,9/26/2019,8900,8pv9ZM4b,40500,more than downpayment,more than downpayment,0,3900
8pv9ZM4b,3900,10/25/2019,8900,8pv9ZM4b,44400,more than downpayment,more than downpayment,0,3900
8pv9ZM4b,3900,11/26/2019,8900,8pv9ZM4b,48300,more than downpayment,more than downpayment,0,3900
8pv9ZM4b,3900,12/26/2019,8900,8pv9ZM4b,52200,more than downpayment,more than downpayment,0,3900
8pv9ZM4b,3900,1/26/2020,8900,8pv9ZM4b,56100,more than downpayment,more than downpayment,0,3900
8qmSpnA7,10000,7/23/2017,10000,,10000,equal to downpayment,,10000,0
8qmSpnA7,4000,12/18/2017,10000,8qmSpnA7,14000,more than downpayment,equal to downpayment,0,4000
8qmSpnA7,5000,6/13/2019,10000,8qmSpnA7,19000,more than downpayment,more than downpayment,0,5000
8R9KSSVY,1600,10/14/2019,1594,,1600,more than downpayment,,1594,6
8R9KSSVY,3100,12/13/2019,1594,8R9KSSVY,4700,more than downpayment,more than downpayment,0,3100
8R9KSSVY,3100,1/12/2020,1594,8R9KSSVY,7800,more than downpayment,more than downpayment,0,3100
8SR7SVKK,10000,7/13/2019,8900,,10000,more than downpayment,,8900,1100
8SR7SVKK,4000,8/24/2019,8900,8SR7SVKK,14000,more than downpayment,more than downpayment,0,4000
8SR7SVKK,4000,9/20/2019,8900,8SR7SVKK,18000,more than downpayment,more than downpayment,0,4000
8SR7SVKK,4000,10/14/2019,8900,8SR7SVKK,22000,more than downpayment,more than downpayment,0,4000
8SR7SVKK,4000,11/11/2019,8900,8SR7SVKK,26000,more than downpayment,more than downpayment,0,4000
8SR7SVKK,4000,12/10/2019,8900,8SR7SVKK,30000,more than downpayment,more than downpayment,0,4000
8SR7SVKK,4000,1/15/2020,8900,8SR7SVKK,34000,more than downpayment,more than downpayment,0,4000
8sy8ripa,12000,3/14/2019,8900,,12000,more than downpayment,,8900,3100
8sy8ripa,4000,4/10/2019,8900,8sy8ripa,16000,more than downpayment,more than downpayment,0,4000
8sy8ripa,4000,5/10/2019,8900,8sy8ripa,20000,more than downpayment,more than downpayment,0,4000
8sy8ripa,4000,6/8/2019,8900,8sy8ripa,24000,more than downpayment,more than downpayment,0,4000
8sy8ripa,4000,7/2/2019,8900,8sy8ripa,28000,more than downpayment,more than downpayment,0,4000
8sy8ripa,4000,8/12/2019,8900,8sy8ripa,32000,more than downpayment,more than downpayment,0,4000
8sy8ripa,4000,9/14/2019,8900,8sy8ripa,36000,more than downpayment,more than downpayment,0,4000
8sy8ripa,4000,10/11/2019,8900,8sy8ripa,40000,more than downpayment,more than downpayment,0,4000
8sy8ripa,4000,11/9/2019,8900,8sy8ripa,44000,more than downpayment,more than downpayment,0,4000
8sy8ripa,4000,12/11/2019,8900,8sy8ripa,48000,more than downpayment,more than downpayment,0,4000
8sy8ripa,4000,1/10/2020,8900,8sy8ripa,52000,more than downpayment,more than downpayment,0,4000
8sy8ripa,4000,2/1/2020,8900,8sy8ripa,56000,more than downpayment,more than downpayment,0,4000
8syp2lZp,10000,11/30/2018,9900,,10000,more than downpayment,,9900,100
8syp2lZp,4500,1/15/2019,9900,8syp2lZp,14500,more than downpayment,more than downpayment,0,4500
8syp2lZp,4500,2/15/2019,9900,8syp2lZp,19000,more than downpayment,more than downpayment,0,4500
8syp2lZp,4500,3/26/2019,9900,8syp2lZp,23500,more than downpayment,more than downpayment,0,4500
8syp2lZp,4500,4/10/2019,9900,8syp2lZp,28000,more than downpayment,more than downpayment,0,4500
8syp2lZp,4500,5/15/2019,9900,8syp2lZp,32500,more than downpayment,more than downpayment,0,4500
8syp2lZp,4500,6/15/2019,9900,8syp2lZp,37000,more than downpayment,more than downpayment,0,4500
8syp2lZp,4500,7/23/2019,9900,8syp2lZp,41500,more than downpayment,more than downpayment,0,4500
8syp2lZp,4500,9/4/2019,9900,8syp2lZp,46000,more than downpayment,more than downpayment,0,4500
8syp2lZp,4500,9/25/2019,9900,8syp2lZp,50500,more than downpayment,more than downpayment,0,4500
8syp2lZp,4500,11/11/2019,9900,8syp2lZp,55000,more than downpayment,more than downpayment,0,4500
8syp2lZp,4500,11/25/2019,9900,8syp2lZp,59500,more than downpayment,more than downpayment,0,4500
8syp2lZp,4400,1/11/2020,9900,8syp2lZp,63900,more than downpayment,more than downpayment,0,4400
8tbGnFCL,10000,10/8/2018,10000,,10000,equal to downpayment,,10000,0
8tbGnFCL,4500,12/3/2018,10000,8tbGnFCL,14500,more than downpayment,equal to downpayment,0,4500
8tbGnFCL,4500,1/4/2019,10000,8tbGnFCL,19000,more than downpayment,more than downpayment,0,4500
8tbGnFCL,4500,2/5/2019,10000,8tbGnFCL,23500,more than downpayment,more than downpayment,0,4500
8tbGnFCL,4500,3/5/2019,10000,8tbGnFCL,28000,more than downpayment,more than downpayment,0,4500
8tbGnFCL,4500,4/5/2019,10000,8tbGnFCL,32500,more than downpayment,more than downpayment,0,4500
8tbGnFCL,4500,5/5/2019,10000,8tbGnFCL,37000,more than downpayment,more than downpayment,0,4500
8tbGnFCL,4500,6/10/2019,10000,8tbGnFCL,41500,more than downpayment,more than downpayment,0,4500
8tbGnFCL,4500,7/14/2019,10000,8tbGnFCL,46000,more than downpayment,more than downpayment,0,4500
8tbGnFCL,4500,10/7/2019,10000,8tbGnFCL,50500,more than downpayment,more than downpayment,0,4500
8tbGnFCL,2000,10/23/2019,10000,8tbGnFCL,52500,more than downpayment,more than downpayment,0,2000
8tbGnFCL,3000,11/5/2019,10000,8tbGnFCL,55500,more than downpayment,more than downpayment,0,3000
8tbGnFCL,4000,12/2/2019,10000,8tbGnFCL,59500,more than downpayment,more than downpayment,0,4000
8tbGnFCL,1000,1/15/2020,10000,8tbGnFCL,60500,more than downpayment,more than downpayment,0,1000
8UC99G44,2000,11/30/2019,9900,,2000,less than downpayment,,2000,0
8UC99G44,7900,1/10/2020,9900,8UC99G44,9900,equal to downpayment,less than downpayment,7900,0
8UPgXcjc,8900,3/25/2019,8900,,8900,equal to downpayment,,8900,0
8UPgXcjc,3900,4/29/2019,8900,8UPgXcjc,12800,more than downpayment,equal to downpayment,0,3900
8uw4iE13,9000,5/7/2019,8900,,9000,more than downpayment,,8900,100
8uw4iE13,3900,6/21/2019,8900,8uw4iE13,12900,more than downpayment,more than downpayment,0,3900
8uw4iE13,3900,7/13/2019,8900,8uw4iE13,16800,more than downpayment,more than downpayment,0,3900
8uw4iE13,3900,8/16/2019,8900,8uw4iE13,20700,more than downpayment,more than downpayment,0,3900
8uw4iE13,3900,9/15/2019,8900,8uw4iE13,24600,more than downpayment,more than downpayment,0,3900
8uw4iE13,3900,10/18/2019,8900,8uw4iE13,28500,more than downpayment,more than downpayment,0,3900
8uw4iE13,3900,11/23/2019,8900,8uw4iE13,32400,more than downpayment,more than downpayment,0,3900
8uw4iE13,3800,12/31/2019,8900,8uw4iE13,36200,more than downpayment,more than downpayment,0,3800
8uw4iE13,3900,1/20/2020,8900,8uw4iE13,40100,more than downpayment,more than downpayment,0,3900
8VXKVH3T,9900,10/14/2019,9900,,9900,equal to downpayment,,9900,0
8VXKVH3T,3900,12/16/2019,9900,8VXKVH3T,13800,more than downpayment,equal to downpayment,0,3900
8WQTPLAB,8900,12/19/2019,8900,,8900,equal to downpayment,,8900,0
8X8ABYXM,9900,1/4/2020,9900,,9900,equal to downpayment,,9900,0
8Y2MJPCM,4999,1/28/2020,4999,,4999,equal to downpayment,,4999,0
8YseuJVA,9900,6/10/2019,8900,,9900,more than downpayment,,8900,1000
8YseuJVA,3900,8/4/2019,8900,8YseuJVA,13800,more than downpayment,more than downpayment,0,3900
8YseuJVA,3900,9/4/2019,8900,8YseuJVA,17700,more than downpayment,more than downpayment,0,3900
8YseuJVA,1500,10/25/2019,8900,8YseuJVA,19200,more than downpayment,more than downpayment,0,1500
8YseuJVA,5000,10/31/2019,8900,8YseuJVA,24200,more than downpayment,more than downpayment,0,5000
8YseuJVA,2600,11/7/2019,8900,8YseuJVA,26800,more than downpayment,more than downpayment,0,2600
8YseuJVA,3900,12/4/2019,8900,8YseuJVA,30700,more than downpayment,more than downpayment,0,3900
8YseuJVA,3900,1/7/2020,8900,8YseuJVA,34600,more than downpayment,more than downpayment,0,3900
8YseuJVA,3900,2/4/2020,8900,8YseuJVA,38500,more than downpayment,more than downpayment,0,3900
8YTSHREA,7900,10/2/2019,7900,,7900,equal to downpayment,,7900,0
8YTSHREA,10000,11/11/2019,7900,8YTSHREA,17900,more than downpayment,equal to downpayment,0,10000
8YTSHREA,4000,12/4/2019,7900,8YTSHREA,21900,more than downpayment,more than downpayment,0,4000
8z7XGAyD,9900,6/7/2019,8900,,9900,more than downpayment,,8900,1000
8z7XGAyD,3900,7/22/2019,8900,8z7XGAyD,13800,more than downpayment,more than downpayment,0,3900
8z7XGAyD,3900,8/27/2019,8900,8z7XGAyD,17700,more than downpayment,more than downpayment,0,3900
8z7XGAyD,3900,9/26/2019,8900,8z7XGAyD,21600,more than downpayment,more than downpayment,0,3900
8z7XGAyD,3900,10/27/2019,8900,8z7XGAyD,25500,more than downpayment,more than downpayment,0,3900
8z7XGAyD,2900,12/1/2019,8900,8z7XGAyD,28400,more than downpayment,more than downpayment,0,2900
8z7XGAyD,1000,12/10/2019,8900,8z7XGAyD,29400,more than downpayment,more than downpayment,0,1000
8z7XGAyD,3400,1/7/2020,8900,8z7XGAyD,32800,more than downpayment,more than downpayment,0,3400
8z7XGAyD,3400,1/29/2020,8900,8z7XGAyD,36200,more than downpayment,more than downpayment,0,3400
8ZM2VOIW,9900,1/18/2020,9900,,9900,equal to downpayment,,9900,0
90073ab3,8900,1/10/2020,8900,,8900,equal to downpayment,,8900,0
908a6d1f,34000,10/2/2019,34000,,34000,equal to downpayment,,34000,0
908a6d1f,8253,11/6/2019,34000,908a6d1f,42253,more than downpayment,equal to downpayment,0,8253
908a6d1f,8110,12/11/2019,34000,908a6d1f,50363,more than downpayment,more than downpayment,0,8110
908a6d1f,8968,12/27/2019,34000,908a6d1f,59331,more than downpayment,more than downpayment,0,8968
909b4e5b,9900,10/2/2019,9900,,9900,equal to downpayment,,9900,0
909b4e5b,4000,11/5/2019,9900,909b4e5b,13900,more than downpayment,equal to downpayment,0,4000
909b4e5b,4000,12/6/2019,9900,909b4e5b,17900,more than downpayment,more than downpayment,0,4000
909b4e5b,4000,1/15/2020,9900,909b4e5b,21900,more than downpayment,more than downpayment,0,4000
90c04e17,8900,12/2/2019,8900,,8900,equal to downpayment,,8900,0
90c04e17,3900,2/3/2020,8900,90c04e17,12800,more than downpayment,equal to downpayment,0,3900
90WiecZq,8900,1/7/2019,8900,,8900,equal to downpayment,,8900,0
90WiecZq,3900,2/9/2019,8900,90WiecZq,12800,more than downpayment,equal to downpayment,0,3900
90WiecZq,3900,3/16/2019,8900,90WiecZq,16700,more than downpayment,more than downpayment,0,3900
90WiecZq,3900,4/16/2019,8900,90WiecZq,20600,more than downpayment,more than downpayment,0,3900
90WiecZq,3900,5/10/2019,8900,90WiecZq,24500,more than downpayment,more than downpayment,0,3900
90WiecZq,3900,6/13/2019,8900,90WiecZq,28400,more than downpayment,more than downpayment,0,3900
90WiecZq,3900,7/14/2019,8900,90WiecZq,32300,more than downpayment,more than downpayment,0,3900
90WiecZq,3900,8/15/2019,8900,90WiecZq,36200,more than downpayment,more than downpayment,0,3900
90WiecZq,3900,9/10/2019,8900,90WiecZq,40100,more than downpayment,more than downpayment,0,3900
90WiecZq,3900,10/15/2019,8900,90WiecZq,44000,more than downpayment,more than downpayment,0,3900
90WiecZq,3900,11/14/2019,8900,90WiecZq,47900,more than downpayment,more than downpayment,0,3900
90WiecZq,3900,12/16/2019,8900,90WiecZq,51800,more than downpayment,more than downpayment,0,3900
90WiecZq,3900,1/16/2020,8900,90WiecZq,55700,more than downpayment,more than downpayment,0,3900
913f4fe9,26250,11/8/2019,26250,,26250,equal to downpayment,,26250,0
913f4fe9,26250,12/31/2019,26250,913f4fe9,52500,more than downpayment,equal to downpayment,0,26250
913f4fe9,26250,2/3/2020,26250,913f4fe9,78750,more than downpayment,more than downpayment,0,26250
914a9a0e,8900,10/30/2019,8900,,8900,equal to downpayment,,8900,0
914a9a0e,1000,11/12/2019,8900,914a9a0e,9900,more than downpayment,equal to downpayment,0,1000
92871702,2950,1/20/2020,9900,,2950,less than downpayment,,2950,0
92871702,1050,1/22/2020,9900,92871702,4000,less than downpayment,less than downpayment,1050,0
92871702,1500,1/24/2020,9900,92871702,5500,less than downpayment,less than downpayment,1500,0
92871702,2000,1/25/2020,9900,92871702,7500,less than downpayment,less than downpayment,2000,0
92871702,2000,1/30/2020,9900,92871702,9500,less than downpayment,less than downpayment,2000,0
92871702,400,2/1/2020,9900,92871702,9900,equal to downpayment,less than downpayment,400,0
928c06ea,15000,11/7/2019,8900,,15000,more than downpayment,,8900,6100
928c06ea,5000,12/21/2019,8900,928c06ea,20000,more than downpayment,more than downpayment,0,5000
928c06ea,5000,2/4/2020,8900,928c06ea,25000,more than downpayment,more than downpayment,0,5000
92AN666P,9900,8/6/2019,9900,,9900,equal to downpayment,,9900,0
92AN666P,3999,9/25/2019,9900,92AN666P,13899,more than downpayment,equal to downpayment,0,3999
92AN666P,3900,10/24/2019,9900,92AN666P,17799,more than downpayment,more than downpayment,0,3900
92AN666P,3900,11/26/2019,9900,92AN666P,21699,more than downpayment,more than downpayment,0,3900
92AN666P,3900,12/27/2019,9900,92AN666P,25599,more than downpayment,more than downpayment,0,3900
92AN666P,3800,1/29/2020,9900,92AN666P,29399,more than downpayment,more than downpayment,0,3800
92fc66db,9900,12/20/2019,9900,,9900,equal to downpayment,,9900,0
92G9I2UA,8900,7/5/2019,8900,,8900,equal to downpayment,,8900,0
92G9I2UA,1000,7/8/2019,8900,92G9I2UA,9900,more than downpayment,equal to downpayment,0,1000
92G9I2UA,7597,7/10/2019,8900,92G9I2UA,17497,more than downpayment,more than downpayment,0,7597
92G9I2UA,3900,8/21/2019,8900,92G9I2UA,21397,more than downpayment,more than downpayment,0,3900
92G9I2UA,3900,10/1/2019,8900,92G9I2UA,25297,more than downpayment,more than downpayment,0,3900
92G9I2UA,8700,1/13/2020,8900,92G9I2UA,33997,more than downpayment,more than downpayment,0,8700
92G9I2UA,3000,1/15/2020,8900,92G9I2UA,36997,more than downpayment,more than downpayment,0,3000
92JUIzdx,9900,6/4/2019,8900,,9900,more than downpayment,,8900,1000
92JUIzdx,3900,7/15/2019,8900,92JUIzdx,13800,more than downpayment,more than downpayment,0,3900
92JUIzdx,3900,8/15/2019,8900,92JUIzdx,17700,more than downpayment,more than downpayment,0,3900
92JUIzdx,3900,9/15/2019,8900,92JUIzdx,21600,more than downpayment,more than downpayment,0,3900
92JUIzdx,3900,10/15/2019,8900,92JUIzdx,25500,more than downpayment,more than downpayment,0,3900
92JUIzdx,3900,11/15/2019,8900,92JUIzdx,29400,more than downpayment,more than downpayment,0,3900
92JUIzdx,3900,12/15/2019,8900,92JUIzdx,33300,more than downpayment,more than downpayment,0,3900
92JUIzdx,3900,1/15/2020,8900,92JUIzdx,37200,more than downpayment,more than downpayment,0,3900
92tv8zH7,8900,8/15/2019,8900,,8900,equal to downpayment,,8900,0
92tv8zH7,3900,10/4/2019,8900,92tv8zH7,12800,more than downpayment,equal to downpayment,0,3900
92tv8zH7,3900,11/8/2019,8900,92tv8zH7,16700,more than downpayment,more than downpayment,0,3900
92tv8zH7,3900,12/7/2019,8900,92tv8zH7,20600,more than downpayment,more than downpayment,0,3900
92tv8zH7,3900,1/7/2020,8900,92tv8zH7,24500,more than downpayment,more than downpayment,0,3900
92tv8zH7,3900,2/4/2020,8900,92tv8zH7,28400,more than downpayment,more than downpayment,0,3900
930641eb,8900,11/14/2019,8900,,8900,equal to downpayment,,8900,0
931f6224,9900,12/14/2019,9900,,9900,equal to downpayment,,9900,0
931f6224,3900,1/7/2020,9900,931f6224,13800,more than downpayment,equal to downpayment,0,3900
931f6224,3900,2/4/2020,9900,931f6224,17700,more than downpayment,more than downpayment,0,3900
94bd969d,9900,1/7/2020,9900,,9900,equal to downpayment,,9900,0
94bd969d,1000,2/9/2020,9900,94bd969d,10900,more than downpayment,equal to downpayment,0,1000
95C3IKA2,8900,9/22/2019,8900,,8900,equal to downpayment,,8900,0
95eOqXSw,9900,11/28/2018,9900,,9900,equal to downpayment,,9900,0
95eOqXSw,4500,12/8/2018,9900,95eOqXSw,14400,more than downpayment,equal to downpayment,0,4500
95eOqXSw,4500,1/9/2019,9900,95eOqXSw,18900,more than downpayment,more than downpayment,0,4500
95eOqXSw,4500,2/25/2019,9900,95eOqXSw,23400,more than downpayment,more than downpayment,0,4500
95eOqXSw,4500,3/23/2019,9900,95eOqXSw,27900,more than downpayment,more than downpayment,0,4500
95eOqXSw,4500,4/25/2019,9900,95eOqXSw,32400,more than downpayment,more than downpayment,0,4500
95eOqXSw,4500,5/29/2019,9900,95eOqXSw,36900,more than downpayment,more than downpayment,0,4500
95eOqXSw,4500,9/25/2019,9900,95eOqXSw,41400,more than downpayment,more than downpayment,0,4500
95eOqXSw,5000,10/31/2019,9900,95eOqXSw,46400,more than downpayment,more than downpayment,0,5000
95eOqXSw,13000,11/18/2019,9900,95eOqXSw,59400,more than downpayment,more than downpayment,0,13000
96219a30,9900,10/8/2019,9900,,9900,equal to downpayment,,9900,0
96219a30,3900,11/30/2019,9900,96219a30,13800,more than downpayment,equal to downpayment,0,3900
96219a30,3900,12/28/2019,9900,96219a30,17700,more than downpayment,more than downpayment,0,3900
96219a30,3900,2/4/2020,9900,96219a30,21600,more than downpayment,more than downpayment,0,3900
96gf4Vek,10000,6/9/2017,10000,,10000,equal to downpayment,,10000,0
96gf4Vek,3500,7/14/2017,10000,96gf4Vek,13500,more than downpayment,equal to downpayment,0,3500
96gf4Vek,3500,8/10/2017,10000,96gf4Vek,17000,more than downpayment,more than downpayment,0,3500
96gf4Vek,3500,10/4/2017,10000,96gf4Vek,20500,more than downpayment,more than downpayment,0,3500
96gf4Vek,7000,11/25/2017,10000,96gf4Vek,27500,more than downpayment,more than downpayment,0,7000
96gf4Vek,3500,1/9/2018,10000,96gf4Vek,31000,more than downpayment,more than downpayment,0,3500
96gf4Vek,3500,2/12/2018,10000,96gf4Vek,34500,more than downpayment,more than downpayment,0,3500
96gf4Vek,2500,6/7/2018,10000,96gf4Vek,37000,more than downpayment,more than downpayment,0,2500
96gf4Vek,3000,8/7/2018,10000,96gf4Vek,40000,more than downpayment,more than downpayment,0,3000
96M4IDZS,9900,12/12/2019,9900,,9900,equal to downpayment,,9900,0
96UW5GTJ,1000,9/22/2018,9900,,1000,less than downpayment,,1000,0
96UW5GTJ,9900,7/19/2019,9900,96UW5GTJ,10900,more than downpayment,less than downpayment,8900,1000
96UW5GTJ,1000,8/13/2019,9900,96UW5GTJ,11900,more than downpayment,more than downpayment,0,1000
96UW5GTJ,1000,8/20/2019,9900,96UW5GTJ,12900,more than downpayment,more than downpayment,0,1000
96UW5GTJ,1000,8/29/2019,9900,96UW5GTJ,13900,more than downpayment,more than downpayment,0,1000
96UW5GTJ,1000,9/5/2019,9900,96UW5GTJ,14900,more than downpayment,more than downpayment,0,1000
96UW5GTJ,500,9/12/2019,9900,96UW5GTJ,15400,more than downpayment,more than downpayment,0,500
96UW5GTJ,500,9/13/2019,9900,96UW5GTJ,15900,more than downpayment,more than downpayment,0,500
96UW5GTJ,1000,9/15/2019,9900,96UW5GTJ,16900,more than downpayment,more than downpayment,0,1000
96UW5GTJ,1000,9/24/2019,9900,96UW5GTJ,17900,more than downpayment,more than downpayment,0,1000
96UW5GTJ,1000,9/26/2019,9900,96UW5GTJ,18900,more than downpayment,more than downpayment,0,1000
96UW5GTJ,500,10/1/2019,9900,96UW5GTJ,19400,more than downpayment,more than downpayment,0,500
96UW5GTJ,200,10/3/2019,9900,96UW5GTJ,19600,more than downpayment,more than downpayment,0,200
96UW5GTJ,500,10/11/2019,9900,96UW5GTJ,20100,more than downpayment,more than downpayment,0,500
96UW5GTJ,500,10/17/2019,9900,96UW5GTJ,20600,more than downpayment,more than downpayment,0,500
96UW5GTJ,1000,10/30/2019,9900,96UW5GTJ,21600,more than downpayment,more than downpayment,0,1000
96UW5GTJ,1000,11/1/2019,9900,96UW5GTJ,22600,more than downpayment,more than downpayment,0,1000
96UW5GTJ,2000,11/7/2019,9900,96UW5GTJ,24600,more than downpayment,more than downpayment,0,2000
96UW5GTJ,1000,12/13/2019,9900,96UW5GTJ,25600,more than downpayment,more than downpayment,0,1000
96UW5GTJ,1000,12/17/2019,9900,96UW5GTJ,26600,more than downpayment,more than downpayment,0,1000
96UW5GTJ,1000,12/22/2019,9900,96UW5GTJ,27600,more than downpayment,more than downpayment,0,1000
96UW5GTJ,1000,12/23/2019,9900,96UW5GTJ,28600,more than downpayment,more than downpayment,0,1000
96UW5GTJ,3000,12/29/2019,9900,96UW5GTJ,31600,more than downpayment,more than downpayment,0,3000
96UW5GTJ,4000,1/25/2020,9900,96UW5GTJ,35600,more than downpayment,more than downpayment,0,4000
96UW5GTJ,2400,2/9/2020,9900,96UW5GTJ,38000,more than downpayment,more than downpayment,0,2400
972d10a9,9900,1/24/2020,9900,,9900,equal to downpayment,,9900,0
975fef32,9900,11/25/2019,9900,,9900,equal to downpayment,,9900,0
975fef32,4000,1/23/2020,9900,975fef32,13900,more than downpayment,equal to downpayment,0,4000
97995df4,10000,11/27/2019,9900,,10000,more than downpayment,,9900,100
97995df4,4000,1/23/2020,9900,97995df4,14000,more than downpayment,more than downpayment,0,4000
979T2R48,8900,7/1/2019,8900,,8900,equal to downpayment,,8900,0
979T2R48,3900,8/24/2019,8900,979T2R48,12800,more than downpayment,equal to downpayment,0,3900
979T2R48,3900,11/6/2019,8900,979T2R48,16700,more than downpayment,more than downpayment,0,3900
979T2R48,3900,12/11/2019,8900,979T2R48,20600,more than downpayment,more than downpayment,0,3900
979T2R48,3900,1/17/2020,8900,979T2R48,24500,more than downpayment,more than downpayment,0,3900
97b7c518,9900,2/6/2020,9900,,9900,equal to downpayment,,9900,0
97f4136e,8900,11/25/2019,8900,,8900,equal to downpayment,,8900,0
97f4136e,5000,12/29/2019,8900,97f4136e,13900,more than downpayment,equal to downpayment,0,5000
97f4136e,10000,1/29/2020,8900,97f4136e,23900,more than downpayment,more than downpayment,0,10000
9891d162,10000,9/27/2019,8900,,10000,more than downpayment,,8900,1100
9891d162,15000,10/23/2019,8900,9891d162,25000,more than downpayment,more than downpayment,0,15000
9891d162,5000,12/16/2019,8900,9891d162,30000,more than downpayment,more than downpayment,0,5000
9891d162,3900,1/16/2020,8900,9891d162,33900,more than downpayment,more than downpayment,0,3900
99192f22,9900,1/5/2020,9900,,9900,equal to downpayment,,9900,0
99192f22,3900,2/4/2020,9900,99192f22,13800,more than downpayment,equal to downpayment,0,3900
9977d666,8900,10/24/2019,8900,,8900,equal to downpayment,,8900,0
9977d666,3900,11/28/2019,8900,9977d666,12800,more than downpayment,equal to downpayment,0,3900
9977d666,3900,12/27/2019,8900,9977d666,16700,more than downpayment,more than downpayment,0,3900
9977d666,3900,1/27/2020,8900,9977d666,20600,more than downpayment,more than downpayment,0,3900
99a5a422,7900,9/26/2019,7900,,7900,equal to downpayment,,7900,0
99a5a422,3900,11/6/2019,7900,99a5a422,11800,more than downpayment,equal to downpayment,0,3900
99a5a422,3100,12/5/2019,7900,99a5a422,14900,more than downpayment,more than downpayment,0,3100
99a5a422,500,2/7/2020,7900,99a5a422,15400,more than downpayment,more than downpayment,0,500
99cf8453,9900,12/18/2019,9900,,9900,equal to downpayment,,9900,0
99cf8453,4000,1/24/2020,9900,99cf8453,13900,more than downpayment,equal to downpayment,0,4000
99eba679,7900,1/31/2020,7900,,7900,equal to downpayment,,7900,0
99QPI5Q8,8900,1/9/2020,8900,,8900,equal to downpayment,,8900,0
9a2d6a70,9900,9/6/2019,9900,,9900,equal to downpayment,,9900,0
9a2d6a70,3900,11/26/2019,9900,9a2d6a70,13800,more than downpayment,equal to downpayment,0,3900
9a2d6a70,3900,1/9/2020,9900,9a2d6a70,17700,more than downpayment,more than downpayment,0,3900
9a2d6a70,3900,2/3/2020,9900,9a2d6a70,21600,more than downpayment,more than downpayment,0,3900
9aBAOsaK,10000,7/10/2017,10000,,10000,equal to downpayment,,10000,0
9aBAOsaK,2500,8/14/2017,10000,9aBAOsaK,12500,more than downpayment,equal to downpayment,0,2500
9aBAOsaK,10000,9/5/2017,10000,9aBAOsaK,22500,more than downpayment,more than downpayment,0,10000
9aBAOsaK,10000,10/2/2017,10000,9aBAOsaK,32500,more than downpayment,more than downpayment,0,10000
9aBAOsaK,5000,11/24/2017,10000,9aBAOsaK,37500,more than downpayment,more than downpayment,0,5000
9aBAOsaK,5000,1/25/2018,10000,9aBAOsaK,42500,more than downpayment,more than downpayment,0,5000
9aBAOsaK,5000,3/8/2018,10000,9aBAOsaK,47500,more than downpayment,more than downpayment,0,5000
9abd8181,8900,10/2/2019,8900,,8900,equal to downpayment,,8900,0
9AUH29D1,23500,8/13/2019,23400,,23500,more than downpayment,,23400,100
9AUH29D1,10000,9/16/2019,23400,9AUH29D1,33500,more than downpayment,more than downpayment,0,10000
9AUH29D1,10000,10/16/2019,23400,9AUH29D1,43500,more than downpayment,more than downpayment,0,10000
9AUH29D1,10000,11/16/2019,23400,9AUH29D1,53500,more than downpayment,more than downpayment,0,10000
9AUH29D1,10000,12/17/2019,23400,9AUH29D1,63500,more than downpayment,more than downpayment,0,10000
9AUH29D1,10000,1/16/2020,23400,9AUH29D1,73500,more than downpayment,more than downpayment,0,10000
9AX1LSPO,10000,11/4/2019,9900,,10000,more than downpayment,,9900,100
9AX1LSPO,11700,12/31/2019,9900,9AX1LSPO,21700,more than downpayment,more than downpayment,0,11700
9AY5K9SZ,9900,7/6/2019,9900,,9900,equal to downpayment,,9900,0
9AY5K9SZ,3900,12/6/2019,9900,9AY5K9SZ,13800,more than downpayment,equal to downpayment,0,3900
9AY5K9SZ,3900,1/6/2020,9900,9AY5K9SZ,17700,more than downpayment,more than downpayment,0,3900
9AY5K9SZ,3900,2/5/2020,9900,9AY5K9SZ,21600,more than downpayment,more than downpayment,0,3900
9c37df35,9900,12/11/2019,9900,,9900,equal to downpayment,,9900,0
9c37df35,3900,1/24/2020,9900,9c37df35,13800,more than downpayment,equal to downpayment,0,3900
9c9e4b24,9900,9/19/2019,9900,,9900,equal to downpayment,,9900,0
9c9e4b24,3900,11/6/2019,9900,9c9e4b24,13800,more than downpayment,equal to downpayment,0,3900
9c9e4b24,3900,12/5/2019,9900,9c9e4b24,17700,more than downpayment,more than downpayment,0,3900
9c9e4b24,3900,1/8/2020,9900,9c9e4b24,21600,more than downpayment,more than downpayment,0,3900
9c9e4b24,3900,2/7/2020,9900,9c9e4b24,25500,more than downpayment,more than downpayment,0,3900
9ca3bb4e,9900,1/9/2020,9900,,9900,equal to downpayment,,9900,0
9CDMNCQL,10000,9/16/2019,9900,,10000,more than downpayment,,9900,100
9CDMNCQL,112030,10/29/2019,9900,9CDMNCQL,122030,more than downpayment,more than downpayment,0,112030
9cgBkqwQ,8900,5/8/2019,8900,,8900,equal to downpayment,,8900,0
9cgBkqwQ,3900,6/12/2019,8900,9cgBkqwQ,12800,more than downpayment,equal to downpayment,0,3900
9cgBkqwQ,4000,7/30/2019,8900,9cgBkqwQ,16800,more than downpayment,more than downpayment,0,4000
9cgBkqwQ,3900,9/3/2019,8900,9cgBkqwQ,20700,more than downpayment,more than downpayment,0,3900
9cgBkqwQ,3800,10/4/2019,8900,9cgBkqwQ,24500,more than downpayment,more than downpayment,0,3800
9cgBkqwQ,3900,11/2/2019,8900,9cgBkqwQ,28400,more than downpayment,more than downpayment,0,3900
9cgBkqwQ,3900,11/25/2019,8900,9cgBkqwQ,32300,more than downpayment,more than downpayment,0,3900
9cgBkqwQ,3900,1/8/2020,8900,9cgBkqwQ,36200,more than downpayment,more than downpayment,0,3900
9cgBkqwQ,3900,1/27/2020,8900,9cgBkqwQ,40100,more than downpayment,more than downpayment,0,3900
9da0a5ae,9900,1/3/2020,9900,,9900,equal to downpayment,,9900,0
9e2a517a,8900,1/29/2020,8900,,8900,equal to downpayment,,8900,0
9e3gj0tS,8900,4/3/2019,8900,,8900,equal to downpayment,,8900,0
9e3gj0tS,3900,5/6/2019,8900,9e3gj0tS,12800,more than downpayment,equal to downpayment,0,3900
9e3gj0tS,3900,6/5/2019,8900,9e3gj0tS,16700,more than downpayment,more than downpayment,0,3900
9e3gj0tS,3900,7/6/2019,8900,9e3gj0tS,20600,more than downpayment,more than downpayment,0,3900
9e3gj0tS,3900,8/5/2019,8900,9e3gj0tS,24500,more than downpayment,more than downpayment,0,3900
9e3gj0tS,3900,9/5/2019,8900,9e3gj0tS,28400,more than downpayment,more than downpayment,0,3900
9e3gj0tS,3900,10/5/2019,8900,9e3gj0tS,32300,more than downpayment,more than downpayment,0,3900
9e3gj0tS,3900,11/4/2019,8900,9e3gj0tS,36200,more than downpayment,more than downpayment,0,3900
9e3gj0tS,3900,12/5/2019,8900,9e3gj0tS,40100,more than downpayment,more than downpayment,0,3900
9e3gj0tS,3900,1/5/2020,8900,9e3gj0tS,44000,more than downpayment,more than downpayment,0,3900
9e3gj0tS,3900,2/4/2020,8900,9e3gj0tS,47900,more than downpayment,more than downpayment,0,3900
9e72e6bd,9900,11/18/2019,9900,,9900,equal to downpayment,,9900,0
9e72e6bd,3900,1/5/2020,9900,9e72e6bd,13800,more than downpayment,equal to downpayment,0,3900
9e72e6bd,3900,2/5/2020,9900,9e72e6bd,17700,more than downpayment,more than downpayment,0,3900
9EEP15GC,9900,7/8/2019,8900,,9900,more than downpayment,,8900,1000
9EEP15GC,3900,8/5/2019,8900,9EEP15GC,13800,more than downpayment,more than downpayment,0,3900
9EEP15GC,3900,9/4/2019,8900,9EEP15GC,17700,more than downpayment,more than downpayment,0,3900
9EEP15GC,3900,11/6/2019,8900,9EEP15GC,21600,more than downpayment,more than downpayment,0,3900
9EEP15GC,3900,12/4/2019,8900,9EEP15GC,25500,more than downpayment,more than downpayment,0,3900
9EEP15GC,3900,1/4/2020,8900,9EEP15GC,29400,more than downpayment,more than downpayment,0,3900
9EEP15GC,3900,2/5/2020,8900,9EEP15GC,33300,more than downpayment,more than downpayment,0,3900
9ET8JUKL,9900,11/18/2019,9900,,9900,equal to downpayment,,9900,0
9ET8JUKL,3900,1/10/2020,9900,9ET8JUKL,13800,more than downpayment,equal to downpayment,0,3900
9f6VzYiK,9900,7/17/2019,9900,,9900,equal to downpayment,,9900,0
9f6VzYiK,11700,8/24/2019,9900,9f6VzYiK,21600,more than downpayment,equal to downpayment,0,11700
9f6VzYiK,3900,11/14/2019,9900,9f6VzYiK,25500,more than downpayment,more than downpayment,0,3900
9f6VzYiK,3900,12/23/2019,9900,9f6VzYiK,29400,more than downpayment,more than downpayment,0,3900
9f6VzYiK,3900,1/18/2020,9900,9f6VzYiK,33300,more than downpayment,more than downpayment,0,3900
9FACROHP,9900,12/9/2019,9900,,9900,equal to downpayment,,9900,0
9FACROHP,4000,1/14/2020,9900,9FACROHP,13900,more than downpayment,equal to downpayment,0,4000
9FACROHP,4000,2/9/2020,9900,9FACROHP,17900,more than downpayment,more than downpayment,0,4000
9G3U79NS,9900,8/19/2019,9900,,9900,equal to downpayment,,9900,0
9G3U79NS,3900,10/21/2019,9900,9G3U79NS,13800,more than downpayment,equal to downpayment,0,3900
9G3U79NS,3900,11/19/2019,9900,9G3U79NS,17700,more than downpayment,more than downpayment,0,3900
9G3U79NS,7800,12/31/2019,9900,9G3U79NS,25500,more than downpayment,more than downpayment,0,7800
9h4cvf6G,2500,5/26/2017,10000,,2500,less than downpayment,,2500,0
9h4cvf6G,8700,6/6/2017,10000,9h4cvf6G,11200,more than downpayment,less than downpayment,7500,1200
9h4cvf6G,3000,8/3/2017,10000,9h4cvf6G,14200,more than downpayment,more than downpayment,0,3000
9h4cvf6G,20000,2/28/2018,10000,9h4cvf6G,34200,more than downpayment,more than downpayment,0,20000
9h4cvf6G,9274,3/28/2018,10000,9h4cvf6G,43474,more than downpayment,more than downpayment,0,9274
9H85T1IJ,9900,10/17/2019,9900,,9900,equal to downpayment,,9900,0
9H85T1IJ,3900,12/16/2019,9900,9H85T1IJ,13800,more than downpayment,equal to downpayment,0,3900
9H85T1IJ,3900,1/26/2020,9900,9H85T1IJ,17700,more than downpayment,more than downpayment,0,3900
9HUOvImz,9900,11/20/2018,9900,,9900,equal to downpayment,,9900,0
9HUOvImz,4500,1/4/2019,9900,9HUOvImz,14400,more than downpayment,equal to downpayment,0,4500
9HUOvImz,4500,2/5/2019,9900,9HUOvImz,18900,more than downpayment,more than downpayment,0,4500
9HUOvImz,4500,5/1/2019,9900,9HUOvImz,23400,more than downpayment,more than downpayment,0,4500
9HUOvImz,4500,5/30/2019,9900,9HUOvImz,27900,more than downpayment,more than downpayment,0,4500
9HUOvImz,4500,7/1/2019,9900,9HUOvImz,32400,more than downpayment,more than downpayment,0,4500
9HUOvImz,4500,8/4/2019,9900,9HUOvImz,36900,more than downpayment,more than downpayment,0,4500
9HUOvImz,4500,9/6/2019,9900,9HUOvImz,41400,more than downpayment,more than downpayment,0,4500
9HUOvImz,4500,12/1/2019,9900,9HUOvImz,45900,more than downpayment,more than downpayment,0,4500
9HUOvImz,4500,2/4/2020,9900,9HUOvImz,50400,more than downpayment,more than downpayment,0,4500
9hx4KO8s,8900,1/7/2019,8900,,8900,equal to downpayment,,8900,0
9hx4KO8s,3900,3/5/2019,8900,9hx4KO8s,12800,more than downpayment,equal to downpayment,0,3900
9hx4KO8s,3900,4/3/2019,8900,9hx4KO8s,16700,more than downpayment,more than downpayment,0,3900
9hx4KO8s,3900,5/24/2019,8900,9hx4KO8s,20600,more than downpayment,more than downpayment,0,3900
9hx4KO8s,3900,7/4/2019,8900,9hx4KO8s,24500,more than downpayment,more than downpayment,0,3900
9hx4KO8s,3900,8/23/2019,8900,9hx4KO8s,28400,more than downpayment,more than downpayment,0,3900
9hx4KO8s,2000,9/10/2019,8900,9hx4KO8s,30400,more than downpayment,more than downpayment,0,2000
9hx4KO8s,1000,10/5/2019,8900,9hx4KO8s,31400,more than downpayment,more than downpayment,0,1000
9IA6NYSG,9900,10/5/2019,9900,,9900,equal to downpayment,,9900,0
9IA6NYSG,3900,11/19/2019,9900,9IA6NYSG,13800,more than downpayment,equal to downpayment,0,3900
9IA6NYSG,3900,12/14/2019,9900,9IA6NYSG,17700,more than downpayment,more than downpayment,0,3900
9IA6NYSG,3900,1/17/2020,9900,9IA6NYSG,21600,more than downpayment,more than downpayment,0,3900
9iprDX5L,8900,3/6/2019,8900,,8900,equal to downpayment,,8900,0
9iprDX5L,3900,4/26/2019,8900,9iprDX5L,12800,more than downpayment,equal to downpayment,0,3900
9iprDX5L,3900,5/24/2019,8900,9iprDX5L,16700,more than downpayment,more than downpayment,0,3900
9iprDX5L,3900,6/26/2019,8900,9iprDX5L,20600,more than downpayment,more than downpayment,0,3900
9iprDX5L,3900,7/23/2019,8900,9iprDX5L,24500,more than downpayment,more than downpayment,0,3900
9iprDX5L,3900,8/30/2019,8900,9iprDX5L,28400,more than downpayment,more than downpayment,0,3900
9iprDX5L,3900,9/25/2019,8900,9iprDX5L,32300,more than downpayment,more than downpayment,0,3900
9iprDX5L,3900,10/22/2019,8900,9iprDX5L,36200,more than downpayment,more than downpayment,0,3900
9iprDX5L,3900,11/25/2019,8900,9iprDX5L,40100,more than downpayment,more than downpayment,0,3900
9iprDX5L,3900,12/29/2019,8900,9iprDX5L,44000,more than downpayment,more than downpayment,0,3900
9iprDX5L,3900,1/21/2020,8900,9iprDX5L,47900,more than downpayment,more than downpayment,0,3900
9iprDX5L,500,2/9/2020,8900,9iprDX5L,48400,more than downpayment,more than downpayment,0,500
9IYEPVGL,8900,11/30/2019,8900,,8900,equal to downpayment,,8900,0
9J5hO9im,8900,4/3/2019,8900,,8900,equal to downpayment,,8900,0
9J5hO9im,4500,5/10/2019,8900,9J5hO9im,13400,more than downpayment,equal to downpayment,0,4500
9J5hO9im,4000,6/21/2019,8900,9J5hO9im,17400,more than downpayment,more than downpayment,0,4000
9J5hO9im,4000,7/15/2019,8900,9J5hO9im,21400,more than downpayment,more than downpayment,0,4000
9J5hO9im,3900,8/15/2019,8900,9J5hO9im,25300,more than downpayment,more than downpayment,0,3900
9J5hO9im,3900,9/16/2019,8900,9J5hO9im,29200,more than downpayment,more than downpayment,0,3900
9J5hO9im,4000,11/5/2019,8900,9J5hO9im,33200,more than downpayment,more than downpayment,0,4000
9J5hO9im,3900,11/29/2019,8900,9J5hO9im,37100,more than downpayment,more than downpayment,0,3900
9J5hO9im,3900,1/8/2020,8900,9J5hO9im,41000,more than downpayment,more than downpayment,0,3900
9J5hO9im,3900,1/16/2020,8900,9J5hO9im,44900,more than downpayment,more than downpayment,0,3900
9J7DjagB,8900,4/8/2019,8900,,8900,equal to downpayment,,8900,0
9J7DjagB,3900,4/29/2019,8900,9J7DjagB,12800,more than downpayment,equal to downpayment,0,3900
9J7DjagB,3900,6/5/2019,8900,9J7DjagB,16700,more than downpayment,more than downpayment,0,3900
9J7DjagB,3900,7/4/2019,8900,9J7DjagB,20600,more than downpayment,more than downpayment,0,3900
9J7DjagB,3900,8/4/2019,8900,9J7DjagB,24500,more than downpayment,more than downpayment,0,3900
9J7DjagB,3900,9/5/2019,8900,9J7DjagB,28400,more than downpayment,more than downpayment,0,3900
9J7DjagB,3900,10/7/2019,8900,9J7DjagB,32300,more than downpayment,more than downpayment,0,3900
9J7DjagB,3900,11/8/2019,8900,9J7DjagB,36200,more than downpayment,more than downpayment,0,3900
9J7DjagB,3900,12/3/2019,8900,9J7DjagB,40100,more than downpayment,more than downpayment,0,3900
9J7DjagB,3900,12/29/2019,8900,9J7DjagB,44000,more than downpayment,more than downpayment,0,3900
9JDPY8LR,9900,1/2/2020,9900,,9900,equal to downpayment,,9900,0
9KKZ2KJF,4000,11/13/2019,9900,,4000,less than downpayment,,4000,0
9KKZ2KJF,5900,11/15/2019,9900,9KKZ2KJF,9900,equal to downpayment,less than downpayment,5900,0
9KKZ2KJF,4000,1/15/2020,9900,9KKZ2KJF,13900,more than downpayment,equal to downpayment,0,4000
9KVRFOAJ,10000,1/30/2020,9900,,10000,more than downpayment,,9900,100
9L3Y8R6L,4400,12/17/2019,9900,,4400,less than downpayment,,4400,0
9L3Y8R6L,5500,1/2/2020,9900,9L3Y8R6L,9900,equal to downpayment,less than downpayment,5500,0
9L8z0zEe,8900,8/9/2019,8900,,8900,equal to downpayment,,8900,0
9L8z0zEe,4000,10/1/2019,8900,9L8z0zEe,12900,more than downpayment,equal to downpayment,0,4000
9L8z0zEe,4000,11/4/2019,8900,9L8z0zEe,16900,more than downpayment,more than downpayment,0,4000
9L8z0zEe,4000,12/23/2019,8900,9L8z0zEe,20900,more than downpayment,more than downpayment,0,4000
9L8z0zEe,3900,1/16/2020,8900,9L8z0zEe,24800,more than downpayment,more than downpayment,0,3900
9L8z0zEe,3900,2/5/2020,8900,9L8z0zEe,28700,more than downpayment,more than downpayment,0,3900
9LAIWBGH,8900,8/5/2019,8900,,8900,equal to downpayment,,8900,0
9LAIWBGH,2760,9/25/2019,8900,9LAIWBGH,11660,more than downpayment,equal to downpayment,0,2760
9LAIWBGH,1140,9/26/2019,8900,9LAIWBGH,12800,more than downpayment,more than downpayment,0,1140
9LAIWBGH,3900,10/24/2019,8900,9LAIWBGH,16700,more than downpayment,more than downpayment,0,3900
9LAIWBGH,3900,11/25/2019,8900,9LAIWBGH,20600,more than downpayment,more than downpayment,0,3900
9LTL28DN,5999,6/16/2019,1999,,5999,more than downpayment,,1999,4000
9LTL28DN,2000,8/9/2019,1999,9LTL28DN,7999,more than downpayment,more than downpayment,0,2000
9LTL28DN,2000,9/9/2019,1999,9LTL28DN,9999,more than downpayment,more than downpayment,0,2000
9LTL28DN,4020,11/13/2019,1999,9LTL28DN,14019,more than downpayment,more than downpayment,0,4020
9LTL28DN,2000,12/10/2019,1999,9LTL28DN,16019,more than downpayment,more than downpayment,0,2000
9LTL28DN,2000,1/11/2020,1999,9LTL28DN,18019,more than downpayment,more than downpayment,0,2000
9Mfnglo9,8900,5/9/2019,8900,,8900,equal to downpayment,,8900,0
9Mfnglo9,3900,6/9/2019,8900,9Mfnglo9,12800,more than downpayment,equal to downpayment,0,3900
9Mfnglo9,3900,7/8/2019,8900,9Mfnglo9,16700,more than downpayment,more than downpayment,0,3900
9Mfnglo9,3900,8/7/2019,8900,9Mfnglo9,20600,more than downpayment,more than downpayment,0,3900
9Mfnglo9,3900,9/9/2019,8900,9Mfnglo9,24500,more than downpayment,more than downpayment,0,3900
9Mfnglo9,3900,11/23/2019,8900,9Mfnglo9,28400,more than downpayment,more than downpayment,0,3900
9Mfnglo9,3900,1/10/2020,8900,9Mfnglo9,32300,more than downpayment,more than downpayment,0,3900
9MlDlUCt,8900,3/15/2019,8900,,8900,equal to downpayment,,8900,0
9MlDlUCt,3900,4/27/2019,8900,9MlDlUCt,12800,more than downpayment,equal to downpayment,0,3900
9MlDlUCt,3900,5/30/2019,8900,9MlDlUCt,16700,more than downpayment,more than downpayment,0,3900
9MlDlUCt,3900,6/28/2019,8900,9MlDlUCt,20600,more than downpayment,more than downpayment,0,3900
9MlDlUCt,3900,7/31/2019,8900,9MlDlUCt,24500,more than downpayment,more than downpayment,0,3900
9MlDlUCt,3900,8/24/2019,8900,9MlDlUCt,28400,more than downpayment,more than downpayment,0,3900
9MlDlUCt,3900,9/27/2019,8900,9MlDlUCt,32300,more than downpayment,more than downpayment,0,3900
9MlDlUCt,3900,10/24/2019,8900,9MlDlUCt,36200,more than downpayment,more than downpayment,0,3900
9MlDlUCt,3900,11/25/2019,8900,9MlDlUCt,40100,more than downpayment,more than downpayment,0,3900
9MlDlUCt,3900,12/25/2019,8900,9MlDlUCt,44000,more than downpayment,more than downpayment,0,3900
9MlDlUCt,3900,1/25/2020,8900,9MlDlUCt,47900,more than downpayment,more than downpayment,0,3900
9mXAjFMQ,9900,7/8/2019,9900,,9900,equal to downpayment,,9900,0
9mXAjFMQ,3900,10/5/2019,9900,9mXAjFMQ,13800,more than downpayment,equal to downpayment,0,3900
9mXAjFMQ,3900,11/5/2019,9900,9mXAjFMQ,17700,more than downpayment,more than downpayment,0,3900
9mXAjFMQ,3900,12/5/2019,9900,9mXAjFMQ,21600,more than downpayment,more than downpayment,0,3900
9mXAjFMQ,3900,1/8/2020,9900,9mXAjFMQ,25500,more than downpayment,more than downpayment,0,3900
9mXAjFMQ,3900,2/5/2020,9900,9mXAjFMQ,29400,more than downpayment,more than downpayment,0,3900
9N1NXR11,10000,6/29/2019,9900,,10000,more than downpayment,,9900,100
9N1NXR11,3900,9/11/2019,9900,9N1NXR11,13900,more than downpayment,more than downpayment,0,3900
9N1NXR11,3900,10/7/2019,9900,9N1NXR11,17800,more than downpayment,more than downpayment,0,3900
9N1NXR11,3900,11/28/2019,9900,9N1NXR11,21700,more than downpayment,more than downpayment,0,3900
9N1NXR11,1800,1/6/2020,9900,9N1NXR11,23500,more than downpayment,more than downpayment,0,1800
9N1NXR11,2000,1/9/2020,9900,9N1NXR11,25500,more than downpayment,more than downpayment,0,2000
9N1NXR11,1000,2/1/2020,9900,9N1NXR11,26500,more than downpayment,more than downpayment,0,1000
9N1NXR11,1000,2/4/2020,9900,9N1NXR11,27500,more than downpayment,more than downpayment,0,1000
9N1NXR11,1000,2/7/2020,9900,9N1NXR11,28500,more than downpayment,more than downpayment,0,1000
9NA1N6IL,9900,1/16/2020,9900,,9900,equal to downpayment,,9900,0
9NG7Sl2c,9900,11/13/2018,9900,,9900,equal to downpayment,,9900,0
9NG7Sl2c,18000,3/7/2019,9900,9NG7Sl2c,27900,more than downpayment,equal to downpayment,0,18000
9NG7Sl2c,4500,5/24/2019,9900,9NG7Sl2c,32400,more than downpayment,more than downpayment,0,4500
9NG7Sl2c,4500,7/5/2019,9900,9NG7Sl2c,36900,more than downpayment,more than downpayment,0,4500
9NG7Sl2c,4500,7/11/2019,9900,9NG7Sl2c,41400,more than downpayment,more than downpayment,0,4500
9NG7Sl2c,4500,10/3/2019,9900,9NG7Sl2c,45900,more than downpayment,more than downpayment,0,4500
9NG7Sl2c,4500,10/26/2019,9900,9NG7Sl2c,50400,more than downpayment,more than downpayment,0,4500
9NG7Sl2c,4500,12/3/2019,9900,9NG7Sl2c,54900,more than downpayment,more than downpayment,0,4500
9NG7Sl2c,4500,1/9/2020,9900,9NG7Sl2c,59400,more than downpayment,more than downpayment,0,4500
9NG7Sl2c,4500,2/6/2020,9900,9NG7Sl2c,63900,more than downpayment,more than downpayment,0,4500
9NP3QHEC,9900,10/17/2019,9900,,9900,equal to downpayment,,9900,0
9NP3QHEC,3900,12/9/2019,9900,9NP3QHEC,13800,more than downpayment,equal to downpayment,0,3900
9NP3QHEC,3900,1/13/2020,9900,9NP3QHEC,17700,more than downpayment,more than downpayment,0,3900
9NP3QHEC,3900,2/5/2020,9900,9NP3QHEC,21600,more than downpayment,more than downpayment,0,3900
9O9QMCN8,9900,11/12/2019,9900,,9900,equal to downpayment,,9900,0
9O9QMCN8,3900,12/23/2019,9900,9O9QMCN8,13800,more than downpayment,equal to downpayment,0,3900
9O9QMCN8,3900,1/30/2020,9900,9O9QMCN8,17700,more than downpayment,more than downpayment,0,3900
9P1U6VZ7,9900,10/31/2019,9900,,9900,equal to downpayment,,9900,0
9P1U6VZ7,3900,12/10/2019,9900,9P1U6VZ7,13800,more than downpayment,equal to downpayment,0,3900
9P1U6VZ7,3900,1/22/2020,9900,9P1U6VZ7,17700,more than downpayment,more than downpayment,0,3900
9P4MRT6U,7900,11/29/2019,7900,,7900,equal to downpayment,,7900,0
9P676SRO,1600,10/14/2019,1594,,1600,more than downpayment,,1594,6
9PHTKO7C,9900,9/27/2019,9900,,9900,equal to downpayment,,9900,0
9PHTKO7C,4000,11/6/2019,9900,9PHTKO7C,13900,more than downpayment,equal to downpayment,0,4000
9PHTKO7C,3000,12/13/2019,9900,9PHTKO7C,16900,more than downpayment,more than downpayment,0,3000
9PHTKO7C,900,12/22/2019,9900,9PHTKO7C,17800,more than downpayment,more than downpayment,0,900
9PHTKO7C,3900,1/20/2020,9900,9PHTKO7C,21700,more than downpayment,more than downpayment,0,3900
9PHTKO7C,900,1/30/2020,9900,9PHTKO7C,22600,more than downpayment,more than downpayment,0,900
9POPJDUI,1600,10/14/2019,9900,,1600,less than downpayment,,1600,0
9Q1XKAYA,8900,10/9/2019,8900,,8900,equal to downpayment,,8900,0
9Q1XKAYA,4000,12/5/2019,8900,9Q1XKAYA,12900,more than downpayment,equal to downpayment,0,4000
9Q1XKAYA,3900,1/3/2020,8900,9Q1XKAYA,16800,more than downpayment,more than downpayment,0,3900
9Q1XKAYA,3900,2/5/2020,8900,9Q1XKAYA,20700,more than downpayment,more than downpayment,0,3900
9QE8bGfg,16800,11/13/2018,9900,,16800,more than downpayment,,9900,6900
9QE8bGfg,5000,3/28/2019,9900,9QE8bGfg,21800,more than downpayment,more than downpayment,0,5000
9QE8bGfg,10000,7/3/2019,9900,9QE8bGfg,31800,more than downpayment,more than downpayment,0,10000
9QE8bGfg,5000,10/29/2019,9900,9QE8bGfg,36800,more than downpayment,more than downpayment,0,5000
9QE8bGfg,7500,11/26/2019,9900,9QE8bGfg,44300,more than downpayment,more than downpayment,0,7500
9QI2KEAf,8900,12/14/2018,8900,,8900,equal to downpayment,,8900,0
9QI2KEAf,5000,1/22/2019,8900,9QI2KEAf,13900,more than downpayment,equal to downpayment,0,5000
9QI2KEAf,2800,2/25/2019,8900,9QI2KEAf,16700,more than downpayment,more than downpayment,0,2800
9QI2KEAf,3900,3/27/2019,8900,9QI2KEAf,20600,more than downpayment,more than downpayment,0,3900
9QI2KEAf,3900,4/25/2019,8900,9QI2KEAf,24500,more than downpayment,more than downpayment,0,3900
9QI2KEAf,3900,5/30/2019,8900,9QI2KEAf,28400,more than downpayment,more than downpayment,0,3900
9QI2KEAf,3900,6/25/2019,8900,9QI2KEAf,32300,more than downpayment,more than downpayment,0,3900
9QI2KEAf,3900,7/27/2019,8900,9QI2KEAf,36200,more than downpayment,more than downpayment,0,3900
9QI2KEAf,3900,8/27/2019,8900,9QI2KEAf,40100,more than downpayment,more than downpayment,0,3900
9QI2KEAf,2000,10/1/2019,8900,9QI2KEAf,42100,more than downpayment,more than downpayment,0,2000
9QI2KEAf,1900,10/2/2019,8900,9QI2KEAf,44000,more than downpayment,more than downpayment,0,1900
9QI2KEAf,3900,10/28/2019,8900,9QI2KEAf,47900,more than downpayment,more than downpayment,0,3900
9QI2KEAf,3900,11/25/2019,8900,9QI2KEAf,51800,more than downpayment,more than downpayment,0,3900
9QI2KEAf,2900,1/1/2020,8900,9QI2KEAf,54700,more than downpayment,more than downpayment,0,2900
9QI2KEAf,1000,1/7/2020,8900,9QI2KEAf,55700,more than downpayment,more than downpayment,0,1000
9QI2KEAf,3900,1/29/2020,8900,9QI2KEAf,59600,more than downpayment,more than downpayment,0,3900
9QK11X35,9900,1/29/2020,9900,,9900,equal to downpayment,,9900,0
9qoojhvB,8900,5/6/2019,8900,,8900,equal to downpayment,,8900,0
9qoojhvB,3900,6/18/2019,8900,9qoojhvB,12800,more than downpayment,equal to downpayment,0,3900
9qoojhvB,3900,7/22/2019,8900,9qoojhvB,16700,more than downpayment,more than downpayment,0,3900
9qoojhvB,4000,10/13/2019,8900,9qoojhvB,20700,more than downpayment,more than downpayment,0,4000
9qoojhvB,5000,11/30/2019,8900,9qoojhvB,25700,more than downpayment,more than downpayment,0,5000
9qoojhvB,8600,12/20/2019,8900,9qoojhvB,34300,more than downpayment,more than downpayment,0,8600
9S86RQMH,9900,1/19/2020,9900,,9900,equal to downpayment,,9900,0
9SSo3VMt,8900,2/13/2019,8900,,8900,equal to downpayment,,8900,0
9SSo3VMt,4000,3/19/2019,8900,9SSo3VMt,12900,more than downpayment,equal to downpayment,0,4000
9SSo3VMt,4000,4/16/2019,8900,9SSo3VMt,16900,more than downpayment,more than downpayment,0,4000
9SSo3VMt,4000,5/16/2019,8900,9SSo3VMt,20900,more than downpayment,more than downpayment,0,4000
9SSo3VMt,4000,6/18/2019,8900,9SSo3VMt,24900,more than downpayment,more than downpayment,0,4000
9SSo3VMt,4000,7/16/2019,8900,9SSo3VMt,28900,more than downpayment,more than downpayment,0,4000
9SSo3VMt,4000,8/19/2019,8900,9SSo3VMt,32900,more than downpayment,more than downpayment,0,4000
9SSo3VMt,4000,9/16/2019,8900,9SSo3VMt,36900,more than downpayment,more than downpayment,0,4000
9SSo3VMt,4000,10/17/2019,8900,9SSo3VMt,40900,more than downpayment,more than downpayment,0,4000
9SSo3VMt,4000,11/17/2019,8900,9SSo3VMt,44900,more than downpayment,more than downpayment,0,4000
9SSo3VMt,4000,12/19/2019,8900,9SSo3VMt,48900,more than downpayment,more than downpayment,0,4000
9SSo3VMt,3900,1/17/2020,8900,9SSo3VMt,52800,more than downpayment,more than downpayment,0,3900
9T89M4UI,9900,11/4/2019,9900,,9900,equal to downpayment,,9900,0
9T89M4UI,3900,12/14/2019,9900,9T89M4UI,13800,more than downpayment,equal to downpayment,0,3900
9T89M4UI,3900,1/14/2020,9900,9T89M4UI,17700,more than downpayment,more than downpayment,0,3900
9UFQR1ME,9900,8/7/2019,9900,,9900,equal to downpayment,,9900,0
9UFQR1ME,3900,10/4/2019,9900,9UFQR1ME,13800,more than downpayment,equal to downpayment,0,3900
9UFQR1ME,3900,11/21/2019,9900,9UFQR1ME,17700,more than downpayment,more than downpayment,0,3900
9UFQR1ME,3900,12/9/2019,9900,9UFQR1ME,21600,more than downpayment,more than downpayment,0,3900
9UFQR1ME,3900,1/7/2020,9900,9UFQR1ME,25500,more than downpayment,more than downpayment,0,3900
9UFQR1ME,3900,1/27/2020,9900,9UFQR1ME,29400,more than downpayment,more than downpayment,0,3900
9UmAOdeJ,8900,8/25/2019,8900,,8900,equal to downpayment,,8900,0
9UmAOdeJ,3900,10/25/2019,8900,9UmAOdeJ,12800,more than downpayment,equal to downpayment,0,3900
9UmAOdeJ,3900,11/25/2019,8900,9UmAOdeJ,16700,more than downpayment,more than downpayment,0,3900
9UmAOdeJ,3900,12/20/2019,8900,9UmAOdeJ,20600,more than downpayment,more than downpayment,0,3900
9UmAOdeJ,3900,1/28/2020,8900,9UmAOdeJ,24500,more than downpayment,more than downpayment,0,3900
9WG865FS,9900,11/8/2019,9900,,9900,equal to downpayment,,9900,0
9WG865FS,4000,12/20/2019,9900,9WG865FS,13900,more than downpayment,equal to downpayment,0,4000
9WG865FS,4000,1/19/2020,9900,9WG865FS,17900,more than downpayment,more than downpayment,0,4000
9WG865FS,4000,2/9/2020,9900,9WG865FS,21900,more than downpayment,more than downpayment,0,4000
9WI729PI,11000,10/11/2019,9900,,11000,more than downpayment,,9900,1100
9WI729PI,4000,11/18/2019,9900,9WI729PI,15000,more than downpayment,more than downpayment,0,4000
9WI729PI,4000,12/15/2019,9900,9WI729PI,19000,more than downpayment,more than downpayment,0,4000
9WI729PI,4000,1/11/2020,9900,9WI729PI,23000,more than downpayment,more than downpayment,0,4000
9wpEIk6s,8900,2/7/2019,8900,,8900,equal to downpayment,,8900,0
9wpEIk6s,2000,3/19/2019,8900,9wpEIk6s,10900,more than downpayment,equal to downpayment,0,2000
9wpEIk6s,1900,3/28/2019,8900,9wpEIk6s,12800,more than downpayment,more than downpayment,0,1900
9wpEIk6s,3900,4/17/2019,8900,9wpEIk6s,16700,more than downpayment,more than downpayment,0,3900
9wpEIk6s,2000,6/3/2019,8900,9wpEIk6s,18700,more than downpayment,more than downpayment,0,2000
9wpEIk6s,1000,6/17/2019,8900,9wpEIk6s,19700,more than downpayment,more than downpayment,0,1000
9wpEIk6s,2000,8/8/2019,8900,9wpEIk6s,21700,more than downpayment,more than downpayment,0,2000
9wpEIk6s,2000,10/3/2019,8900,9wpEIk6s,23700,more than downpayment,more than downpayment,0,2000
9wpEIk6s,2000,11/6/2019,8900,9wpEIk6s,25700,more than downpayment,more than downpayment,0,2000
9wpEIk6s,11000,12/11/2019,8900,9wpEIk6s,36700,more than downpayment,more than downpayment,0,11000
9wpEIk6s,3000,1/13/2020,8900,9wpEIk6s,39700,more than downpayment,more than downpayment,0,3000
9wpEIk6s,3000,1/21/2020,8900,9wpEIk6s,42700,more than downpayment,more than downpayment,0,3000
9wpEIk6s,5000,2/8/2020,8900,9wpEIk6s,47700,more than downpayment,more than downpayment,0,5000
9wsaUdY0,10000,2/5/2019,10000,,10000,equal to downpayment,,10000,0
9wsaUdY0,2000,4/8/2019,10000,9wsaUdY0,12000,more than downpayment,equal to downpayment,0,2000
9wsaUdY0,3000,5/13/2019,10000,9wsaUdY0,15000,more than downpayment,more than downpayment,0,3000
9wsaUdY0,5000,6/20/2019,10000,9wsaUdY0,20000,more than downpayment,more than downpayment,0,5000
9wsaUdY0,8000,11/30/2019,10000,9wsaUdY0,28000,more than downpayment,more than downpayment,0,8000
9wsaUdY0,4900,12/16/2019,10000,9wsaUdY0,32900,more than downpayment,more than downpayment,0,4900
9wsaUdY0,7000,1/17/2020,10000,9wsaUdY0,39900,more than downpayment,more than downpayment,0,7000
9WSYO6X5,9900,11/9/2019,9900,,9900,equal to downpayment,,9900,0
9WSYO6X5,3900,1/4/2020,9900,9WSYO6X5,13800,more than downpayment,equal to downpayment,0,3900
9WSYO6X5,3900,1/29/2020,9900,9WSYO6X5,17700,more than downpayment,more than downpayment,0,3900
9XSLF4E7,2000,7/1/2019,1999,,2000,more than downpayment,,1999,1
9XSLF4E7,2000,9/4/2019,1999,9XSLF4E7,4000,more than downpayment,more than downpayment,0,2000
9XSLF4E7,2000,10/2/2019,1999,9XSLF4E7,6000,more than downpayment,more than downpayment,0,2000
9XSLF4E7,2000,11/29/2019,1999,9XSLF4E7,8000,more than downpayment,more than downpayment,0,2000
9XSLF4E7,1900,12/16/2019,1999,9XSLF4E7,9900,more than downpayment,more than downpayment,0,1900
9XSLF4E7,200,12/31/2019,1999,9XSLF4E7,10100,more than downpayment,more than downpayment,0,200
9XUZE8HU,8400,1/4/2020,9900,,8400,less than downpayment,,8400,0
9XUZE8HU,1500,1/7/2020,9900,9XUZE8HU,9900,equal to downpayment,less than downpayment,1500,0
9Y1qPcmT,8900,3/18/2019,8900,,8900,equal to downpayment,,8900,0
9Y1qPcmT,3999,4/23/2019,8900,9Y1qPcmT,12899,more than downpayment,equal to downpayment,0,3999
9Y1qPcmT,3999,5/22/2019,8900,9Y1qPcmT,16898,more than downpayment,more than downpayment,0,3999
9Y1qPcmT,3900,6/26/2019,8900,9Y1qPcmT,20798,more than downpayment,more than downpayment,0,3900
9Y1qPcmT,3900,7/24/2019,8900,9Y1qPcmT,24698,more than downpayment,more than downpayment,0,3900
9Y1qPcmT,3900,8/23/2019,8900,9Y1qPcmT,28598,more than downpayment,more than downpayment,0,3900
9Y1qPcmT,3900,9/26/2019,8900,9Y1qPcmT,32498,more than downpayment,more than downpayment,0,3900
9Y1qPcmT,3900,10/31/2019,8900,9Y1qPcmT,36398,more than downpayment,more than downpayment,0,3900
9Y1qPcmT,3902,12/2/2019,8900,9Y1qPcmT,40300,more than downpayment,more than downpayment,0,3902
9Y1qPcmT,3700,1/6/2020,8900,9Y1qPcmT,44000,more than downpayment,more than downpayment,0,3700
9Y1qPcmT,3900,2/4/2020,8900,9Y1qPcmT,47900,more than downpayment,more than downpayment,0,3900
9yK6XPMk,8900,1/5/2019,8900,,8900,equal to downpayment,,8900,0
9yK6XPMk,3900,2/25/2019,8900,9yK6XPMk,12800,more than downpayment,equal to downpayment,0,3900
9yK6XPMk,3900,3/23/2019,8900,9yK6XPMk,16700,more than downpayment,more than downpayment,0,3900
9yK6XPMk,3100,5/21/2019,8900,9yK6XPMk,19800,more than downpayment,more than downpayment,0,3100
9yK6XPMk,5000,5/28/2019,8900,9yK6XPMk,24800,more than downpayment,more than downpayment,0,5000
9yK6XPMk,3900,6/29/2019,8900,9yK6XPMk,28700,more than downpayment,more than downpayment,0,3900
9yK6XPMk,4500,7/31/2019,8900,9yK6XPMk,33200,more than downpayment,more than downpayment,0,4500
9yK6XPMk,3900,8/23/2019,8900,9yK6XPMk,37100,more than downpayment,more than downpayment,0,3900
9yK6XPMk,3900,9/26/2019,8900,9yK6XPMk,41000,more than downpayment,more than downpayment,0,3900
9yK6XPMk,3900,10/28/2019,8900,9yK6XPMk,44900,more than downpayment,more than downpayment,0,3900
9yK6XPMk,3900,11/26/2019,8900,9yK6XPMk,48800,more than downpayment,more than downpayment,0,3900
9yK6XPMk,3900,12/28/2019,8900,9yK6XPMk,52700,more than downpayment,more than downpayment,0,3900
9yK6XPMk,3400,1/31/2020,8900,9yK6XPMk,56100,more than downpayment,more than downpayment,0,3400
9yK6XPMk,500,2/7/2020,8900,9yK6XPMk,56600,more than downpayment,more than downpayment,0,500
9YXTBIA3,5000,12/17/2019,8900,,5000,less than downpayment,,5000,0
9YXTBIA3,4500,12/18/2019,8900,9YXTBIA3,9500,more than downpayment,less than downpayment,3900,600
9zdPPEvh,9900,6/22/2019,9900,,9900,equal to downpayment,,9900,0
9zdPPEvh,3900,9/2/2019,9900,9zdPPEvh,13800,more than downpayment,equal to downpayment,0,3900
9zdPPEvh,2600,10/5/2019,9900,9zdPPEvh,16400,more than downpayment,more than downpayment,0,2600
9zdPPEvh,1300,10/15/2019,9900,9zdPPEvh,17700,more than downpayment,more than downpayment,0,1300
9zdPPEvh,3100,11/5/2019,9900,9zdPPEvh,20800,more than downpayment,more than downpayment,0,3100
9zdPPEvh,800,11/7/2019,9900,9zdPPEvh,21600,more than downpayment,more than downpayment,0,800
9zdPPEvh,3000,12/5/2019,9900,9zdPPEvh,24600,more than downpayment,more than downpayment,0,3000
9zdPPEvh,900,12/14/2019,9900,9zdPPEvh,25500,more than downpayment,more than downpayment,0,900
9zdPPEvh,2600,1/4/2020,9900,9zdPPEvh,28100,more than downpayment,more than downpayment,0,2600
9zdPPEvh,1300,1/11/2020,9900,9zdPPEvh,29400,more than downpayment,more than downpayment,0,1300
9zdPPEvh,1400,2/5/2020,9900,9zdPPEvh,30800,more than downpayment,more than downpayment,0,1400
9zdPPEvh,500,2/8/2020,9900,9zdPPEvh,31300,more than downpayment,more than downpayment,0,500
9ZL4UWEZ,9900,1/31/2020,9900,,9900,equal to downpayment,,9900,0
a0015a8e,9900,10/26/2019,9900,,9900,equal to downpayment,,9900,0
a0015a8e,4000,12/17/2019,9900,a0015a8e,13900,more than downpayment,equal to downpayment,0,4000
a0015a8e,4000,1/8/2020,9900,a0015a8e,17900,more than downpayment,more than downpayment,0,4000
a00HTcPs,20000,8/12/2017,10000,,20000,more than downpayment,,10000,10000
a00HTcPs,3500,11/2/2017,10000,a00HTcPs,23500,more than downpayment,more than downpayment,0,3500
a00HTcPs,3000,12/11/2017,10000,a00HTcPs,26500,more than downpayment,more than downpayment,0,3000
a00HTcPs,3000,1/17/2018,10000,a00HTcPs,29500,more than downpayment,more than downpayment,0,3000
a00HTcPs,3000,2/13/2018,10000,a00HTcPs,32500,more than downpayment,more than downpayment,0,3000
a00HTcPs,1000,4/15/2018,10000,a00HTcPs,33500,more than downpayment,more than downpayment,0,1000
a00HTcPs,1000,5/28/2018,10000,a00HTcPs,34500,more than downpayment,more than downpayment,0,1000
a00HTcPs,1000,6/18/2018,10000,a00HTcPs,35500,more than downpayment,more than downpayment,0,1000
a00HTcPs,1000,7/25/2018,10000,a00HTcPs,36500,more than downpayment,more than downpayment,0,1000
a00HTcPs,1000,9/18/2018,10000,a00HTcPs,37500,more than downpayment,more than downpayment,0,1000
a00HTcPs,1000,10/18/2018,10000,a00HTcPs,38500,more than downpayment,more than downpayment,0,1000
a00HTcPs,6000,12/17/2018,10000,a00HTcPs,44500,more than downpayment,more than downpayment,0,6000
a00HTcPs,500,1/18/2019,10000,a00HTcPs,45000,more than downpayment,more than downpayment,0,500
A01IyOFD,8900,2/8/2019,8900,,8900,equal to downpayment,,8900,0
A01IyOFD,3900,3/16/2019,8900,A01IyOFD,12800,more than downpayment,equal to downpayment,0,3900
A01IyOFD,3900,4/6/2019,8900,A01IyOFD,16700,more than downpayment,more than downpayment,0,3900
A01IyOFD,4000,5/27/2019,8900,A01IyOFD,20700,more than downpayment,more than downpayment,0,4000
A01IyOFD,4000,6/27/2019,8900,A01IyOFD,24700,more than downpayment,more than downpayment,0,4000
A01IyOFD,4000,7/29/2019,8900,A01IyOFD,28700,more than downpayment,more than downpayment,0,4000
A01IyOFD,3600,8/27/2019,8900,A01IyOFD,32300,more than downpayment,more than downpayment,0,3600
A01IyOFD,4000,10/7/2019,8900,A01IyOFD,36300,more than downpayment,more than downpayment,0,4000
A01IyOFD,4000,10/30/2019,8900,A01IyOFD,40300,more than downpayment,more than downpayment,0,4000
A01IyOFD,4000,12/4/2019,8900,A01IyOFD,44300,more than downpayment,more than downpayment,0,4000
A01IyOFD,3600,12/30/2019,8900,A01IyOFD,47900,more than downpayment,more than downpayment,0,3600
A01IyOFD,4000,1/27/2020,8900,A01IyOFD,51900,more than downpayment,more than downpayment,0,4000
a0317143,8900,1/7/2020,8900,,8900,equal to downpayment,,8900,0
a031da3e,9900,12/19/2019,9900,,9900,equal to downpayment,,9900,0
a0fea33c,8900,1/25/2020,8900,,8900,equal to downpayment,,8900,0
a13982c5,8900,10/9/2019,8900,,8900,equal to downpayment,,8900,0
a13982c5,3900,11/13/2019,8900,a13982c5,12800,more than downpayment,equal to downpayment,0,3900
a13982c5,3900,12/15/2019,8900,a13982c5,16700,more than downpayment,more than downpayment,0,3900
a13982c5,3900,1/12/2020,8900,a13982c5,20600,more than downpayment,more than downpayment,0,3900
a165ffe4,7900,9/17/2019,7900,,7900,equal to downpayment,,7900,0
a165ffe4,3100,10/26/2019,7900,a165ffe4,11000,more than downpayment,equal to downpayment,0,3100
a165ffe4,3200,11/27/2019,7900,a165ffe4,14200,more than downpayment,more than downpayment,0,3200
a165ffe4,2800,12/24/2019,7900,a165ffe4,17000,more than downpayment,more than downpayment,0,2800
a165ffe4,300,12/26/2019,7900,a165ffe4,17300,more than downpayment,more than downpayment,0,300
a165ffe4,3100,1/26/2020,7900,a165ffe4,20400,more than downpayment,more than downpayment,0,3100
a1cffede,9900,12/2/2019,9900,,9900,equal to downpayment,,9900,0
a1d8565b,9900,2/8/2020,9900,,9900,equal to downpayment,,9900,0
a1e44096,9900,1/17/2020,9900,,9900,equal to downpayment,,9900,0
a1ec5ad1,10000,11/18/2019,9900,,10000,more than downpayment,,9900,100
a1ec5ad1,627,12/20/2019,9900,a1ec5ad1,10627,more than downpayment,more than downpayment,0,627
a1ec5ad1,100,12/21/2019,9900,a1ec5ad1,10727,more than downpayment,more than downpayment,0,100
a1ec5ad1,700,12/24/2019,9900,a1ec5ad1,11427,more than downpayment,more than downpayment,0,700
a1ec5ad1,100,12/27/2019,9900,a1ec5ad1,11527,more than downpayment,more than downpayment,0,100
a1ec5ad1,200,12/30/2019,9900,a1ec5ad1,11727,more than downpayment,more than downpayment,0,200
a1ec5ad1,2000,1/1/2020,9900,a1ec5ad1,13727,more than downpayment,more than downpayment,0,2000
a1ec5ad1,1395,1/3/2020,9900,a1ec5ad1,15122,more than downpayment,more than downpayment,0,1395
a1ec5ad1,500,1/6/2020,9900,a1ec5ad1,15622,more than downpayment,more than downpayment,0,500
a1ec5ad1,50,1/7/2020,9900,a1ec5ad1,15672,more than downpayment,more than downpayment,0,50
a1ec5ad1,60,1/8/2020,9900,a1ec5ad1,15732,more than downpayment,more than downpayment,0,60
a1ec5ad1,1000,1/9/2020,9900,a1ec5ad1,16732,more than downpayment,more than downpayment,0,1000
a1ec5ad1,100,1/10/2020,9900,a1ec5ad1,16832,more than downpayment,more than downpayment,0,100
a1ec5ad1,100,1/11/2020,9900,a1ec5ad1,16932,more than downpayment,more than downpayment,0,100
a1ec5ad1,500,1/15/2020,9900,a1ec5ad1,17432,more than downpayment,more than downpayment,0,500
a1ec5ad1,450,1/18/2020,9900,a1ec5ad1,17882,more than downpayment,more than downpayment,0,450
a1ec5ad1,300,1/23/2020,9900,a1ec5ad1,18182,more than downpayment,more than downpayment,0,300
a1ec5ad1,77,1/24/2020,9900,a1ec5ad1,18259,more than downpayment,more than downpayment,0,77
a1ec5ad1,34,1/28/2020,9900,a1ec5ad1,18293,more than downpayment,more than downpayment,0,34
a1ec5ad1,90,2/1/2020,9900,a1ec5ad1,18383,more than downpayment,more than downpayment,0,90
a1ec5ad1,3000,2/3/2020,9900,a1ec5ad1,21383,more than downpayment,more than downpayment,0,3000
a1ec5ad1,1000,2/4/2020,9900,a1ec5ad1,22383,more than downpayment,more than downpayment,0,1000
a1f4ef1c,50000,10/15/2019,34000,,50000,more than downpayment,,34000,16000
a1f4ef1c,8500,11/21/2019,34000,a1f4ef1c,58500,more than downpayment,more than downpayment,0,8500
a1f4ef1c,8500,12/20/2019,34000,a1f4ef1c,67000,more than downpayment,more than downpayment,0,8500
a1f4ef1c,8500,1/21/2020,34000,a1f4ef1c,75500,more than downpayment,more than downpayment,0,8500
a1X44jm4,8900,8/23/2019,8900,,8900,equal to downpayment,,8900,0
a22b1ad5,10000,10/4/2019,9900,,10000,more than downpayment,,9900,100
a22b1ad5,5000,11/19/2019,9900,a22b1ad5,15000,more than downpayment,more than downpayment,0,5000
a22b1ad5,5000,12/14/2019,9900,a22b1ad5,20000,more than downpayment,more than downpayment,0,5000
a22b1ad5,5000,1/14/2020,9900,a22b1ad5,25000,more than downpayment,more than downpayment,0,5000
a2c358cf,9900,12/24/2019,9900,,9900,equal to downpayment,,9900,0
a2cd8f65,8900,10/29/2019,8900,,8900,equal to downpayment,,8900,0
a2cd8f65,3900,12/7/2019,8900,a2cd8f65,12800,more than downpayment,equal to downpayment,0,3900
A2JNQT43,9900,10/18/2019,9900,,9900,equal to downpayment,,9900,0
A2JNQT43,4000,1/1/2020,9900,A2JNQT43,13900,more than downpayment,equal to downpayment,0,4000
A2JNQT43,4000,1/15/2020,9900,A2JNQT43,17900,more than downpayment,more than downpayment,0,4000
A2JNQT43,4000,1/26/2020,9900,A2JNQT43,21900,more than downpayment,more than downpayment,0,4000
a2ucuxhh,8900,12/3/2018,8900,,8900,equal to downpayment,,8900,0
a2ucuxhh,7600,1/4/2019,8900,a2ucuxhh,16500,more than downpayment,equal to downpayment,0,7600
a2ucuxhh,7800,2/11/2019,8900,a2ucuxhh,24300,more than downpayment,more than downpayment,0,7800
a2ucuxhh,3900,3/12/2019,8900,a2ucuxhh,28200,more than downpayment,more than downpayment,0,3900
a2ucuxhh,3900,4/10/2019,8900,a2ucuxhh,32100,more than downpayment,more than downpayment,0,3900
a2ucuxhh,3900,5/14/2019,8900,a2ucuxhh,36000,more than downpayment,more than downpayment,0,3900
a2ucuxhh,3900,6/13/2019,8900,a2ucuxhh,39900,more than downpayment,more than downpayment,0,3900
a2ucuxhh,3900,7/14/2019,8900,a2ucuxhh,43800,more than downpayment,more than downpayment,0,3900
a2ucuxhh,3900,8/15/2019,8900,a2ucuxhh,47700,more than downpayment,more than downpayment,0,3900
a2ucuxhh,3900,9/14/2019,8900,a2ucuxhh,51600,more than downpayment,more than downpayment,0,3900
a2ucuxhh,3900,10/13/2019,8900,a2ucuxhh,55500,more than downpayment,more than downpayment,0,3900
a2ucuxhh,3900,11/14/2019,8900,a2ucuxhh,59400,more than downpayment,more than downpayment,0,3900
a2ucuxhh,3900,12/15/2019,8900,a2ucuxhh,63300,more than downpayment,more than downpayment,0,3900
a2ucuxhh,3900,1/13/2020,8900,a2ucuxhh,67200,more than downpayment,more than downpayment,0,3900
A2yFUpwN,8900,7/22/2019,8900,,8900,equal to downpayment,,8900,0
A2yFUpwN,10000,9/18/2019,8900,A2yFUpwN,18900,more than downpayment,equal to downpayment,0,10000
A2yFUpwN,1700,11/29/2019,8900,A2yFUpwN,20600,more than downpayment,more than downpayment,0,1700
A2yFUpwN,3900,12/26/2019,8900,A2yFUpwN,24500,more than downpayment,more than downpayment,0,3900
A2yFUpwN,3900,1/27/2020,8900,A2yFUpwN,28400,more than downpayment,more than downpayment,0,3900
A3tdSeoe,10000,11/27/2018,10000,,10000,equal to downpayment,,10000,0
A3tdSeoe,4500,1/3/2019,10000,A3tdSeoe,14500,more than downpayment,equal to downpayment,0,4500
A3tdSeoe,4500,2/5/2019,10000,A3tdSeoe,19000,more than downpayment,more than downpayment,0,4500
A3tdSeoe,4500,3/4/2019,10000,A3tdSeoe,23500,more than downpayment,more than downpayment,0,4500
A3tdSeoe,4500,4/5/2019,10000,A3tdSeoe,28000,more than downpayment,more than downpayment,0,4500
A3tdSeoe,4500,5/7/2019,10000,A3tdSeoe,32500,more than downpayment,more than downpayment,0,4500
A3tdSeoe,4500,6/4/2019,10000,A3tdSeoe,37000,more than downpayment,more than downpayment,0,4500
A3tdSeoe,4500,7/8/2019,10000,A3tdSeoe,41500,more than downpayment,more than downpayment,0,4500
A3tdSeoe,4500,7/29/2019,10000,A3tdSeoe,46000,more than downpayment,more than downpayment,0,4500
A3tdSeoe,4500,9/9/2019,10000,A3tdSeoe,50500,more than downpayment,more than downpayment,0,4500
A3tdSeoe,4500,10/1/2019,10000,A3tdSeoe,55000,more than downpayment,more than downpayment,0,4500
A3tdSeoe,9000,10/11/2019,10000,A3tdSeoe,64000,more than downpayment,more than downpayment,0,9000
A4KOD5D2,9900,1/4/2020,9900,,9900,equal to downpayment,,9900,0
A54X6JS1,9900,11/25/2019,9900,,9900,equal to downpayment,,9900,0
a5f483cb,9900,9/30/2019,9900,,9900,equal to downpayment,,9900,0
a5f483cb,1800,10/28/2019,9900,a5f483cb,11700,more than downpayment,equal to downpayment,0,1800
a5f483cb,980,11/11/2019,9900,a5f483cb,12680,more than downpayment,more than downpayment,0,980
a5f483cb,1200,11/22/2019,9900,a5f483cb,13880,more than downpayment,more than downpayment,0,1200
a5f483cb,800,11/30/2019,9900,a5f483cb,14680,more than downpayment,more than downpayment,0,800
a5f483cb,1000,12/19/2019,9900,a5f483cb,15680,more than downpayment,more than downpayment,0,1000
a5f483cb,1250,12/28/2019,9900,a5f483cb,16930,more than downpayment,more than downpayment,0,1250
a5f483cb,145,1/9/2020,9900,a5f483cb,17075,more than downpayment,more than downpayment,0,145
a5f483cb,700,1/11/2020,9900,a5f483cb,17775,more than downpayment,more than downpayment,0,700
a5f483cb,2400,1/22/2020,9900,a5f483cb,20175,more than downpayment,more than downpayment,0,2400
a5f483cb,1000,1/23/2020,9900,a5f483cb,21175,more than downpayment,more than downpayment,0,1000
a5f483cb,1000,1/31/2020,9900,a5f483cb,22175,more than downpayment,more than downpayment,0,1000
A5HNXXQA,9900,6/29/2019,9900,,9900,equal to downpayment,,9900,0
A5HNXXQA,3900,10/6/2019,9900,A5HNXXQA,13800,more than downpayment,equal to downpayment,0,3900
A5HNXXQA,3000,11/14/2019,9900,A5HNXXQA,16800,more than downpayment,more than downpayment,0,3000
A5HNXXQA,900,11/19/2019,9900,A5HNXXQA,17700,more than downpayment,more than downpayment,0,900
A5HNXXQA,3900,12/17/2019,9900,A5HNXXQA,21600,more than downpayment,more than downpayment,0,3900
A5HNXXQA,3900,1/14/2020,9900,A5HNXXQA,25500,more than downpayment,more than downpayment,0,3900
A5MRUEGD,9900,11/20/2019,9900,,9900,equal to downpayment,,9900,0
A5MRUEGD,3900,1/18/2020,9900,A5MRUEGD,13800,more than downpayment,equal to downpayment,0,3900
A5MRUEGD,3900,1/20/2020,9900,A5MRUEGD,17700,more than downpayment,more than downpayment,0,3900
a60af60f,9900,2/5/2020,9900,,9900,equal to downpayment,,9900,0
a66945ce,1594,10/14/2019,1594,,1594,equal to downpayment,,1594,0
a66945ce,3100,11/25/2019,1594,a66945ce,4694,more than downpayment,equal to downpayment,0,3100
a66945ce,3100,12/26/2019,1594,a66945ce,7794,more than downpayment,more than downpayment,0,3100
a66945ce,3100,1/27/2020,1594,a66945ce,10894,more than downpayment,more than downpayment,0,3100
A6JCyFhg,9900,2/27/2019,9900,,9900,equal to downpayment,,9900,0
A6JCyFhg,3900,4/10/2019,9900,A6JCyFhg,13800,more than downpayment,equal to downpayment,0,3900
A6JCyFhg,4500,4/25/2019,9900,A6JCyFhg,18300,more than downpayment,more than downpayment,0,4500
A6JCyFhg,600,5/29/2019,9900,A6JCyFhg,18900,more than downpayment,more than downpayment,0,600
A6JCyFhg,4500,6/14/2019,9900,A6JCyFhg,23400,more than downpayment,more than downpayment,0,4500
A6JCyFhg,4500,7/24/2019,9900,A6JCyFhg,27900,more than downpayment,more than downpayment,0,4500
A6JCyFhg,4500,8/26/2019,9900,A6JCyFhg,32400,more than downpayment,more than downpayment,0,4500
A6JCyFhg,4500,9/22/2019,9900,A6JCyFhg,36900,more than downpayment,more than downpayment,0,4500
A6JCyFhg,4500,10/27/2019,9900,A6JCyFhg,41400,more than downpayment,more than downpayment,0,4500
A6JCyFhg,4500,11/29/2019,9900,A6JCyFhg,45900,more than downpayment,more than downpayment,0,4500
A6JCyFhg,4500,1/15/2020,9900,A6JCyFhg,50400,more than downpayment,more than downpayment,0,4500
A6JCyFhg,4500,2/7/2020,9900,A6JCyFhg,54900,more than downpayment,more than downpayment,0,4500
a73a8844,9900,10/15/2019,9900,,9900,equal to downpayment,,9900,0
a73a8844,3900,12/3/2019,9900,a73a8844,13800,more than downpayment,equal to downpayment,0,3900
a73a8844,3900,1/2/2020,9900,a73a8844,17700,more than downpayment,more than downpayment,0,3900
a73a8844,3900,2/4/2020,9900,a73a8844,21600,more than downpayment,more than downpayment,0,3900
A7T476H1,4000,10/16/2019,9900,,4000,less than downpayment,,4000,0
A7T476H1,5900,10/23/2019,9900,A7T476H1,9900,equal to downpayment,less than downpayment,5900,0
A7T476H1,3900,2/5/2020,9900,A7T476H1,13800,more than downpayment,equal to downpayment,0,3900
a7wiUnpH,8900,5/8/2019,9900,,8900,less than downpayment,,8900,0
a7wiUnpH,3900,6/20/2019,9900,a7wiUnpH,12800,more than downpayment,less than downpayment,1000,2900
a7wiUnpH,3900,7/3/2019,9900,a7wiUnpH,16700,more than downpayment,more than downpayment,0,3900
a7wiUnpH,3900,8/20/2019,9900,a7wiUnpH,20600,more than downpayment,more than downpayment,0,3900
a7wiUnpH,3900,9/21/2019,9900,a7wiUnpH,24500,more than downpayment,more than downpayment,0,3900
a7wiUnpH,3900,10/25/2019,9900,a7wiUnpH,28400,more than downpayment,more than downpayment,0,3900
a7wiUnpH,4900,11/22/2019,9900,a7wiUnpH,33300,more than downpayment,more than downpayment,0,4900
a7wiUnpH,4900,12/20/2019,9900,a7wiUnpH,38200,more than downpayment,more than downpayment,0,4900
a7wiUnpH,4900,1/25/2020,9900,a7wiUnpH,43100,more than downpayment,more than downpayment,0,4900
a8A9jL1b,9900,8/15/2019,9900,,9900,equal to downpayment,,9900,0
a8A9jL1b,3900,10/16/2019,9900,a8A9jL1b,13800,more than downpayment,equal to downpayment,0,3900
a8A9jL1b,3900,11/21/2019,9900,a8A9jL1b,17700,more than downpayment,more than downpayment,0,3900
a8A9jL1b,3900,12/18/2019,9900,a8A9jL1b,21600,more than downpayment,more than downpayment,0,3900
a8A9jL1b,3900,1/21/2020,9900,a8A9jL1b,25500,more than downpayment,more than downpayment,0,3900
A8JQCERD,1599,10/14/2019,1594,,1599,more than downpayment,,1594,5
a9aa2fc7,1000,10/30/2019,9900,,1000,less than downpayment,,1000,0
a9aa2fc7,1000,11/7/2019,9900,a9aa2fc7,2000,less than downpayment,less than downpayment,1000,0
a9aa2fc7,1000,11/26/2019,9900,a9aa2fc7,3000,less than downpayment,less than downpayment,1000,0
a9aa2fc7,3000,12/3/2019,9900,a9aa2fc7,6000,less than downpayment,less than downpayment,3000,0
a9aa2fc7,1300,12/4/2019,9900,a9aa2fc7,7300,less than downpayment,less than downpayment,1300,0
a9aa2fc7,5000,12/8/2019,9900,a9aa2fc7,12300,more than downpayment,less than downpayment,2600,2400
a9aa2fc7,800,1/17/2020,9900,a9aa2fc7,13100,more than downpayment,more than downpayment,0,800
a9aa2fc7,200,1/20/2020,9900,a9aa2fc7,13300,more than downpayment,more than downpayment,0,200
a9aa2fc7,200,1/21/2020,9900,a9aa2fc7,13500,more than downpayment,more than downpayment,0,200
a9aa2fc7,200,1/22/2020,9900,a9aa2fc7,13700,more than downpayment,more than downpayment,0,200
a9aa2fc7,200,1/23/2020,9900,a9aa2fc7,13900,more than downpayment,more than downpayment,0,200
a9aa2fc7,200,1/24/2020,9900,a9aa2fc7,14100,more than downpayment,more than downpayment,0,200
a9aa2fc7,200,1/25/2020,9900,a9aa2fc7,14300,more than downpayment,more than downpayment,0,200
a9aa2fc7,200,1/26/2020,9900,a9aa2fc7,14500,more than downpayment,more than downpayment,0,200
a9aa2fc7,200,1/27/2020,9900,a9aa2fc7,14700,more than downpayment,more than downpayment,0,200
a9aa2fc7,400,1/29/2020,9900,a9aa2fc7,15100,more than downpayment,more than downpayment,0,400
a9aa2fc7,200,1/30/2020,9900,a9aa2fc7,15300,more than downpayment,more than downpayment,0,200
a9aa2fc7,200,2/1/2020,9900,a9aa2fc7,15500,more than downpayment,more than downpayment,0,200
a9aa2fc7,200,2/2/2020,9900,a9aa2fc7,15700,more than downpayment,more than downpayment,0,200
a9aa2fc7,400,2/4/2020,9900,a9aa2fc7,16100,more than downpayment,more than downpayment,0,400
a9aa2fc7,200,2/5/2020,9900,a9aa2fc7,16300,more than downpayment,more than downpayment,0,200
a9aa2fc7,200,2/6/2020,9900,a9aa2fc7,16500,more than downpayment,more than downpayment,0,200
a9aa2fc7,200,2/7/2020,9900,a9aa2fc7,16700,more than downpayment,more than downpayment,0,200
a9aa2fc7,200,2/8/2020,9900,a9aa2fc7,16900,more than downpayment,more than downpayment,0,200
a9aa2fc7,200,2/9/2020,9900,a9aa2fc7,17100,more than downpayment,more than downpayment,0,200
a9e69b42,13800,11/25/2019,8900,,13800,more than downpayment,,8900,4900
A9JJDVU4,5000,8/29/2019,9900,,5000,less than downpayment,,5000,0
A9JJDVU4,4900,8/30/2019,9900,A9JJDVU4,9900,equal to downpayment,less than downpayment,4900,0
A9JJDVU4,4000,11/6/2019,9900,A9JJDVU4,13900,more than downpayment,equal to downpayment,0,4000
A9JJDVU4,4000,12/7/2019,9900,A9JJDVU4,17900,more than downpayment,more than downpayment,0,4000
A9JJDVU4,4000,1/6/2020,9900,A9JJDVU4,21900,more than downpayment,more than downpayment,0,4000
A9JJDVU4,3900,2/3/2020,9900,A9JJDVU4,25800,more than downpayment,more than downpayment,0,3900
A9YFZK7Z,10000,1/15/2020,9900,,10000,more than downpayment,,9900,100
AA21PHF4,1600,10/14/2019,1594,,1600,more than downpayment,,1594,6
AA21PHF4,3100,12/3/2019,1594,AA21PHF4,4700,more than downpayment,more than downpayment,0,3100
AA21PHF4,3100,1/6/2020,1594,AA21PHF4,7800,more than downpayment,more than downpayment,0,3100
AA21PHF4,3100,2/4/2020,1594,AA21PHF4,10900,more than downpayment,more than downpayment,0,3100
aa2643af,8900,1/15/2020,8900,,8900,equal to downpayment,,8900,0
aaa57cf9,9900,10/14/2019,9900,,9900,equal to downpayment,,9900,0
aaa57cf9,3900,12/4/2019,9900,aaa57cf9,13800,more than downpayment,equal to downpayment,0,3900
aaa57cf9,3900,12/23/2019,9900,aaa57cf9,17700,more than downpayment,more than downpayment,0,3900
aaa57cf9,3900,2/2/2020,9900,aaa57cf9,21600,more than downpayment,more than downpayment,0,3900
AAF8TEWO,9900,7/11/2019,9900,,9900,equal to downpayment,,9900,0
AAF8TEWO,7800,11/6/2019,9900,AAF8TEWO,17700,more than downpayment,equal to downpayment,0,7800
AAF8TEWO,7800,12/6/2019,9900,AAF8TEWO,25500,more than downpayment,more than downpayment,0,7800
AAF8TEWO,3900,1/30/2020,9900,AAF8TEWO,29400,more than downpayment,more than downpayment,0,3900
ab28a578,7900,9/28/2019,7900,,7900,equal to downpayment,,7900,0
ab28a578,3900,11/4/2019,7900,ab28a578,11800,more than downpayment,equal to downpayment,0,3900
ab28a578,3900,12/5/2019,7900,ab28a578,15700,more than downpayment,more than downpayment,0,3900
ab28a578,3900,1/3/2020,7900,ab28a578,19600,more than downpayment,more than downpayment,0,3900
ab28a578,3100,2/5/2020,7900,ab28a578,22700,more than downpayment,more than downpayment,0,3100
AB6HV5S6,4900,9/19/2019,8900,,4900,less than downpayment,,4900,0
AB6HV5S6,2500,9/26/2019,8900,AB6HV5S6,7400,less than downpayment,less than downpayment,2500,0
AB6HV5S6,2500,9/27/2019,8900,AB6HV5S6,9900,more than downpayment,less than downpayment,1500,1000
AB6HV5S6,3900,11/13/2019,8900,AB6HV5S6,13800,more than downpayment,more than downpayment,0,3900
AB6HV5S6,3900,12/13/2019,8900,AB6HV5S6,17700,more than downpayment,more than downpayment,0,3900
AB6HV5S6,3900,1/13/2020,8900,AB6HV5S6,21600,more than downpayment,more than downpayment,0,3900
AblP7GKh,8900,2/12/2019,8900,,8900,equal to downpayment,,8900,0
AblP7GKh,3900,3/25/2019,8900,AblP7GKh,12800,more than downpayment,equal to downpayment,0,3900
AblP7GKh,3900,4/24/2019,8900,AblP7GKh,16700,more than downpayment,more than downpayment,0,3900
AblP7GKh,3900,5/24/2019,8900,AblP7GKh,20600,more than downpayment,more than downpayment,0,3900
AblP7GKh,3900,6/24/2019,8900,AblP7GKh,24500,more than downpayment,more than downpayment,0,3900
AblP7GKh,3900,7/23/2019,8900,AblP7GKh,28400,more than downpayment,more than downpayment,0,3900
AblP7GKh,3900,8/21/2019,8900,AblP7GKh,32300,more than downpayment,more than downpayment,0,3900
AblP7GKh,3908,9/22/2019,8900,AblP7GKh,36208,more than downpayment,more than downpayment,0,3908
AblP7GKh,3900,10/21/2019,8900,AblP7GKh,40108,more than downpayment,more than downpayment,0,3900
AblP7GKh,3900,11/19/2019,8900,AblP7GKh,44008,more than downpayment,more than downpayment,0,3900
AblP7GKh,3900,12/23/2019,8900,AblP7GKh,47908,more than downpayment,more than downpayment,0,3900
AblP7GKh,3900,1/22/2020,8900,AblP7GKh,51808,more than downpayment,more than downpayment,0,3900
acb24156,7900,10/23/2019,7900,,7900,equal to downpayment,,7900,0
acb24156,3100,12/3/2019,7900,acb24156,11000,more than downpayment,equal to downpayment,0,3100
acb24156,3100,1/6/2020,7900,acb24156,14100,more than downpayment,more than downpayment,0,3100
acb24156,3100,2/4/2020,7900,acb24156,17200,more than downpayment,more than downpayment,0,3100
ACCTRPER,8900,11/29/2019,8900,,8900,equal to downpayment,,8900,0
ACCTRPER,3900,12/23/2019,8900,ACCTRPER,12800,more than downpayment,equal to downpayment,0,3900
ACCTRPER,3900,2/4/2020,8900,ACCTRPER,16700,more than downpayment,more than downpayment,0,3900
ACEXY6VN,9900,1/13/2020,9900,,9900,equal to downpayment,,9900,0
acf6ff58,1594,10/14/2019,1594,,1594,equal to downpayment,,1594,0
acf6ff58,3100,12/4/2019,1594,acf6ff58,4694,more than downpayment,equal to downpayment,0,3100
acf6ff58,3100,1/3/2020,1594,acf6ff58,7794,more than downpayment,more than downpayment,0,3100
acf6ff58,3100,2/3/2020,1594,acf6ff58,10894,more than downpayment,more than downpayment,0,3100
ada878ef,10000,10/29/2019,9900,,10000,more than downpayment,,9900,100
ada878ef,4000,1/8/2020,9900,ada878ef,14000,more than downpayment,more than downpayment,0,4000
ade00e7d,10000,12/2/2019,9900,,10000,more than downpayment,,9900,100
ADI66EOW,2000,6/28/2019,1999,,2000,more than downpayment,,1999,1
ADI66EOW,2000,8/5/2019,1999,ADI66EOW,4000,more than downpayment,more than downpayment,0,2000
ADI66EOW,2000,9/4/2019,1999,ADI66EOW,6000,more than downpayment,more than downpayment,0,2000
ADI66EOW,2000,10/4/2019,1999,ADI66EOW,8000,more than downpayment,more than downpayment,0,2000
ADI66EOW,2000,11/5/2019,1999,ADI66EOW,10000,more than downpayment,more than downpayment,0,2000
ADI66EOW,2000,12/5/2019,1999,ADI66EOW,12000,more than downpayment,more than downpayment,0,2000
ADI66EOW,2000,1/9/2020,1999,ADI66EOW,14000,more than downpayment,more than downpayment,0,2000
ADnSa2eE,10000,6/4/2017,10000,,10000,equal to downpayment,,10000,0
ADnSa2eE,2000,3/16/2018,10000,ADnSa2eE,12000,more than downpayment,equal to downpayment,0,2000
aecc9683,7900,9/23/2019,7900,,7900,equal to downpayment,,7900,0
aecc9683,3100,10/29/2019,7900,aecc9683,11000,more than downpayment,equal to downpayment,0,3100
aecc9683,3100,10/30/2019,7900,aecc9683,14100,more than downpayment,more than downpayment,0,3100
aecc9683,3100,1/22/2020,7900,aecc9683,17200,more than downpayment,more than downpayment,0,3100
AEgMzdW0,10000,7/26/2018,10000,,10000,equal to downpayment,,10000,0
AEgMzdW0,4500,9/5/2018,10000,AEgMzdW0,14500,more than downpayment,equal to downpayment,0,4500
AEgMzdW0,4500,11/2/2018,10000,AEgMzdW0,19000,more than downpayment,more than downpayment,0,4500
AEgMzdW0,4500,1/10/2019,10000,AEgMzdW0,23500,more than downpayment,more than downpayment,0,4500
AEgMzdW0,4500,2/13/2019,10000,AEgMzdW0,28000,more than downpayment,more than downpayment,0,4500
AEgMzdW0,8000,5/20/2019,10000,AEgMzdW0,36000,more than downpayment,more than downpayment,0,8000
AEQUZIBB,8900,11/11/2019,8900,,8900,equal to downpayment,,8900,0
AEQUZIBB,7800,1/24/2020,8900,AEQUZIBB,16700,more than downpayment,equal to downpayment,0,7800
AEQUZIBB,55000,1/31/2020,8900,AEQUZIBB,71700,more than downpayment,more than downpayment,0,55000
AETBU9L3,9900,11/8/2019,9900,,9900,equal to downpayment,,9900,0
AETBU9L3,3900,12/6/2019,9900,AETBU9L3,13800,more than downpayment,equal to downpayment,0,3900
AETBU9L3,3900,1/2/2020,9900,AETBU9L3,17700,more than downpayment,more than downpayment,0,3900
AETBU9L3,4000,1/30/2020,9900,AETBU9L3,21700,more than downpayment,more than downpayment,0,4000
aeZUZdfE,8900,5/3/2019,8900,,8900,equal to downpayment,,8900,0
aeZUZdfE,7800,7/4/2019,8900,aeZUZdfE,16700,more than downpayment,equal to downpayment,0,7800
aeZUZdfE,2000,8/9/2019,8900,aeZUZdfE,18700,more than downpayment,more than downpayment,0,2000
aeZUZdfE,2000,8/31/2019,8900,aeZUZdfE,20700,more than downpayment,more than downpayment,0,2000
aeZUZdfE,2000,9/10/2019,8900,aeZUZdfE,22700,more than downpayment,more than downpayment,0,2000
aeZUZdfE,1000,10/1/2019,8900,aeZUZdfE,23700,more than downpayment,more than downpayment,0,1000
aeZUZdfE,4800,10/14/2019,8900,aeZUZdfE,28500,more than downpayment,more than downpayment,0,4800
aeZUZdfE,24000,10/15/2019,8900,aeZUZdfE,52500,more than downpayment,more than downpayment,0,24000
AF2Gtxc5,23240,6/27/2017,10000,,23240,more than downpayment,,10000,13240
AF2Gtxc5,1250,7/21/2017,10000,AF2Gtxc5,24490,more than downpayment,more than downpayment,0,1250
AF2Gtxc5,2500,8/31/2017,10000,AF2Gtxc5,26990,more than downpayment,more than downpayment,0,2500
AF2Gtxc5,1500,8/7/2018,10000,AF2Gtxc5,28490,more than downpayment,more than downpayment,0,1500
af935315,8900,10/3/2019,8900,,8900,equal to downpayment,,8900,0
af935315,2800,12/3/2019,8900,af935315,11700,more than downpayment,equal to downpayment,0,2800
af935315,300,12/5/2019,8900,af935315,12000,more than downpayment,more than downpayment,0,300
af935315,4700,1/8/2020,8900,af935315,16700,more than downpayment,more than downpayment,0,4700
AFSUUDG9,10050,11/16/2019,9900,,10050,more than downpayment,,9900,150
AFSUUDG9,200,11/17/2019,9900,AFSUUDG9,10250,more than downpayment,more than downpayment,0,200
AFSUUDG9,150,11/18/2019,9900,AFSUUDG9,10400,more than downpayment,more than downpayment,0,150
AFSUUDG9,150,11/28/2019,9900,AFSUUDG9,10550,more than downpayment,more than downpayment,0,150
AFSUUDG9,3300,1/16/2020,9900,AFSUUDG9,13850,more than downpayment,more than downpayment,0,3300
afT9qMnj,33,7/3/2019,9900,,33,less than downpayment,,33,0
Agm57rnX,8900,5/2/2019,8900,,8900,equal to downpayment,,8900,0
Agm57rnX,7800,7/8/2019,8900,Agm57rnX,16700,more than downpayment,equal to downpayment,0,7800
Agm57rnX,2000,10/4/2019,8900,Agm57rnX,18700,more than downpayment,more than downpayment,0,2000
Agm57rnX,3580,10/10/2019,8900,Agm57rnX,22280,more than downpayment,more than downpayment,0,3580
Agm57rnX,2220,10/18/2019,8900,Agm57rnX,24500,more than downpayment,more than downpayment,0,2220
Agm57rnX,3000,11/1/2019,8900,Agm57rnX,27500,more than downpayment,more than downpayment,0,3000
Agm57rnX,900,11/22/2019,8900,Agm57rnX,28400,more than downpayment,more than downpayment,0,900
Agm57rnX,7800,12/24/2019,8900,Agm57rnX,36200,more than downpayment,more than downpayment,0,7800
Agm57rnX,3000,1/29/2020,8900,Agm57rnX,39200,more than downpayment,more than downpayment,0,3000
Agm57rnX,900,2/4/2020,8900,Agm57rnX,40100,more than downpayment,more than downpayment,0,900
Ahln6A6e,10000,9/6/2017,10000,,10000,equal to downpayment,,10000,0
Ahln6A6e,3500,10/14/2017,10000,Ahln6A6e,13500,more than downpayment,equal to downpayment,0,3500
Ahln6A6e,3500,11/14/2017,10000,Ahln6A6e,17000,more than downpayment,more than downpayment,0,3500
Ahln6A6e,3500,12/15/2017,10000,Ahln6A6e,20500,more than downpayment,more than downpayment,0,3500
Ahln6A6e,3500,1/15/2018,10000,Ahln6A6e,24000,more than downpayment,more than downpayment,0,3500
Ahln6A6e,3500,2/15/2018,10000,Ahln6A6e,27500,more than downpayment,more than downpayment,0,3500
Ahln6A6e,3500,3/14/2018,10000,Ahln6A6e,31000,more than downpayment,more than downpayment,0,3500
Ahln6A6e,3500,4/14/2018,10000,Ahln6A6e,34500,more than downpayment,more than downpayment,0,3500
Ahln6A6e,3500,5/14/2018,10000,Ahln6A6e,38000,more than downpayment,more than downpayment,0,3500
Ahln6A6e,7000,6/14/2018,10000,Ahln6A6e,45000,more than downpayment,more than downpayment,0,7000
aide73Kz,8900,3/29/2019,8900,,8900,equal to downpayment,,8900,0
aide73Kz,1400,5/3/2019,8900,aide73Kz,10300,more than downpayment,equal to downpayment,0,1400
aide73Kz,700,5/30/2019,8900,aide73Kz,11000,more than downpayment,more than downpayment,0,700
AiopzeBb,8900,12/19/2018,8900,,8900,equal to downpayment,,8900,0
AiopzeBb,3900,2/13/2019,8900,AiopzeBb,12800,more than downpayment,equal to downpayment,0,3900
AiopzeBb,4000,3/29/2019,8900,AiopzeBb,16800,more than downpayment,more than downpayment,0,4000
AiopzeBb,8000,5/3/2019,8900,AiopzeBb,24800,more than downpayment,more than downpayment,0,8000
AiopzeBb,12000,7/12/2019,8900,AiopzeBb,36800,more than downpayment,more than downpayment,0,12000
AiopzeBb,8000,10/10/2019,8900,AiopzeBb,44800,more than downpayment,more than downpayment,0,8000
AiopzeBb,4000,12/2/2019,8900,AiopzeBb,48800,more than downpayment,more than downpayment,0,4000
AiopzeBb,7000,1/28/2020,8900,AiopzeBb,55800,more than downpayment,more than downpayment,0,7000
AIVNSQOI,13800,12/17/2019,9900,,13800,more than downpayment,,9900,3900
AIZOKCZ4,8900,2/6/2019,8900,,8900,equal to downpayment,,8900,0
AIZOKCZ4,5000,4/4/2019,8900,AIZOKCZ4,13900,more than downpayment,equal to downpayment,0,5000
AIZOKCZ4,5000,5/8/2019,8900,AIZOKCZ4,18900,more than downpayment,more than downpayment,0,5000
AIZOKCZ4,5000,6/6/2019,8900,AIZOKCZ4,23900,more than downpayment,more than downpayment,0,5000
AIZOKCZ4,600,7/9/2019,8900,AIZOKCZ4,24500,more than downpayment,more than downpayment,0,600
AIZOKCZ4,500,8/20/2019,8900,AIZOKCZ4,25000,more than downpayment,more than downpayment,0,500
AIZOKCZ4,4000,9/2/2019,8900,AIZOKCZ4,29000,more than downpayment,more than downpayment,0,4000
AIZOKCZ4,800,10/5/2019,8900,AIZOKCZ4,29800,more than downpayment,more than downpayment,0,800
AIZOKCZ4,5000,10/7/2019,8900,AIZOKCZ4,34800,more than downpayment,more than downpayment,0,5000
AIZOKCZ4,2000,11/18/2019,8900,AIZOKCZ4,36800,more than downpayment,more than downpayment,0,2000
AIZOKCZ4,2700,12/4/2019,8900,AIZOKCZ4,39500,more than downpayment,more than downpayment,0,2700
AIZOKCZ4,500,1/3/2020,8900,AIZOKCZ4,40000,more than downpayment,more than downpayment,0,500
AIZOKCZ4,700,1/5/2020,8900,AIZOKCZ4,40700,more than downpayment,more than downpayment,0,700
AIZOKCZ4,1000,1/7/2020,8900,AIZOKCZ4,41700,more than downpayment,more than downpayment,0,1000
AIZOKCZ4,1450,1/15/2020,8900,AIZOKCZ4,43150,more than downpayment,more than downpayment,0,1450
AIZOKCZ4,850,1/23/2020,8900,AIZOKCZ4,44000,more than downpayment,more than downpayment,0,850
AIZOKCZ4,1000,1/28/2020,8900,AIZOKCZ4,45000,more than downpayment,more than downpayment,0,1000
aJ8h10P2,2000,6/27/2019,1999,,2000,more than downpayment,,1999,1
aJ8h10P2,2000,8/2/2019,1999,aJ8h10P2,4000,more than downpayment,more than downpayment,0,2000
aJ8h10P2,2000,8/29/2019,1999,aJ8h10P2,6000,more than downpayment,more than downpayment,0,2000
aJ8h10P2,2000,11/28/2019,1999,aJ8h10P2,8000,more than downpayment,more than downpayment,0,2000
aJ8h10P2,2000,1/3/2020,1999,aJ8h10P2,10000,more than downpayment,more than downpayment,0,2000
aJ8h10P2,2000,1/29/2020,1999,aJ8h10P2,12000,more than downpayment,more than downpayment,0,2000
AK8TUSXM,9900,6/4/2019,9900,,9900,equal to downpayment,,9900,0
AK8TUSXM,4000,8/5/2019,9900,AK8TUSXM,13900,more than downpayment,equal to downpayment,0,4000
AK8TUSXM,4800,10/7/2019,9900,AK8TUSXM,18700,more than downpayment,more than downpayment,0,4800
AK8TUSXM,8100,12/4/2019,9900,AK8TUSXM,26800,more than downpayment,more than downpayment,0,8100
AK8TUSXM,300,1/7/2020,9900,AK8TUSXM,27100,more than downpayment,more than downpayment,0,300
AK8TUSXM,700,1/12/2020,9900,AK8TUSXM,27800,more than downpayment,more than downpayment,0,700
AK8TUSXM,300,1/13/2020,9900,AK8TUSXM,28100,more than downpayment,more than downpayment,0,300
AK8TUSXM,700,1/15/2020,9900,AK8TUSXM,28800,more than downpayment,more than downpayment,0,700
AK8TUSXM,300,1/24/2020,9900,AK8TUSXM,29100,more than downpayment,more than downpayment,0,300
AK8TUSXM,2200,2/5/2020,9900,AK8TUSXM,31300,more than downpayment,more than downpayment,0,2200
AK8TUSXM,400,2/6/2020,9900,AK8TUSXM,31700,more than downpayment,more than downpayment,0,400
AK8TUSXM,355,2/7/2020,9900,AK8TUSXM,32055,more than downpayment,more than downpayment,0,355
AK8TUSXM,400,2/9/2020,9900,AK8TUSXM,32455,more than downpayment,more than downpayment,0,400
aKKW2HTw,10000,1/14/2019,9900,,10000,more than downpayment,,9900,100
aKKW2HTw,4500,3/5/2019,9900,aKKW2HTw,14500,more than downpayment,more than downpayment,0,4500
aKKW2HTw,4500,4/4/2019,9900,aKKW2HTw,19000,more than downpayment,more than downpayment,0,4500
aKKW2HTw,4500,5/3/2019,9900,aKKW2HTw,23500,more than downpayment,more than downpayment,0,4500
aKKW2HTw,3900,6/6/2019,9900,aKKW2HTw,27400,more than downpayment,more than downpayment,0,3900
aKKW2HTw,5100,7/2/2019,9900,aKKW2HTw,32500,more than downpayment,more than downpayment,0,5100
aKKW2HTw,4000,9/6/2019,9900,aKKW2HTw,36500,more than downpayment,more than downpayment,0,4000
aKKW2HTw,4500,12/19/2019,9900,aKKW2HTw,41000,more than downpayment,more than downpayment,0,4500
AkPudytF,8900,4/15/2019,8900,,8900,equal to downpayment,,8900,0
AkPudytF,3819,4/23/2019,8900,AkPudytF,12719,more than downpayment,equal to downpayment,0,3819
AkPudytF,3900,6/4/2019,8900,AkPudytF,16619,more than downpayment,more than downpayment,0,3900
AkPudytF,3900,7/6/2019,8900,AkPudytF,20519,more than downpayment,more than downpayment,0,3900
AkPudytF,31900,8/2/2019,8900,AkPudytF,52419,more than downpayment,more than downpayment,0,31900
AkPudytF,3900,9/5/2019,8900,AkPudytF,56319,more than downpayment,more than downpayment,0,3900
AkPudytF,3900,10/7/2019,8900,AkPudytF,60219,more than downpayment,more than downpayment,0,3900
AkPudytF,3900,11/10/2019,8900,AkPudytF,64119,more than downpayment,more than downpayment,0,3900
AkPudytF,3900,12/28/2019,8900,AkPudytF,68019,more than downpayment,more than downpayment,0,3900
AkPudytF,3900,1/12/2020,8900,AkPudytF,71919,more than downpayment,more than downpayment,0,3900
AKVUJWR4,9900,12/3/2019,9900,,9900,equal to downpayment,,9900,0
ALw5OxO3,10000,6/18/2019,9900,,10000,more than downpayment,,9900,100
ALw5OxO3,20000,8/5/2019,9900,ALw5OxO3,30000,more than downpayment,more than downpayment,0,20000
ALw5OxO3,2500,1/17/2020,9900,ALw5OxO3,32500,more than downpayment,more than downpayment,0,2500
ALw5OxO3,1000,2/6/2020,9900,ALw5OxO3,33500,more than downpayment,more than downpayment,0,1000
ALwmOEkn,10000,9/17/2018,10000,,10000,equal to downpayment,,10000,0
ALwmOEkn,42000,10/16/2018,10000,ALwmOEkn,52000,more than downpayment,equal to downpayment,0,42000
ALx4NfwF,2500,4/16/2019,8900,,2500,less than downpayment,,2500,0
ALx4NfwF,6400,4/17/2019,8900,ALx4NfwF,8900,equal to downpayment,less than downpayment,6400,0
ALx4NfwF,3900,5/24/2019,8900,ALx4NfwF,12800,more than downpayment,equal to downpayment,0,3900
ALx4NfwF,3900,7/6/2019,8900,ALx4NfwF,16700,more than downpayment,more than downpayment,0,3900
ALx4NfwF,7800,8/22/2019,8900,ALx4NfwF,24500,more than downpayment,more than downpayment,0,7800
ALx4NfwF,7800,11/12/2019,8900,ALx4NfwF,32300,more than downpayment,more than downpayment,0,7800
AMAOPVT3,8900,7/30/2019,8900,,8900,equal to downpayment,,8900,0
AMAOPVT3,3900,9/5/2019,8900,AMAOPVT3,12800,more than downpayment,equal to downpayment,0,3900
AMAOPVT3,3900,11/25/2019,8900,AMAOPVT3,16700,more than downpayment,more than downpayment,0,3900
AMAOPVT3,3900,1/26/2020,8900,AMAOPVT3,20600,more than downpayment,more than downpayment,0,3900
AMAOPVT3,3900,2/8/2020,8900,AMAOPVT3,24500,more than downpayment,more than downpayment,0,3900
amtYoFtj,8900,2/7/2019,8900,,8900,equal to downpayment,,8900,0
amtYoFtj,3900,3/15/2019,8900,amtYoFtj,12800,more than downpayment,equal to downpayment,0,3900
amtYoFtj,3900,4/15/2019,8900,amtYoFtj,16700,more than downpayment,more than downpayment,0,3900
amtYoFtj,3900,5/14/2019,8900,amtYoFtj,20600,more than downpayment,more than downpayment,0,3900
amtYoFtj,3900,6/17/2019,8900,amtYoFtj,24500,more than downpayment,more than downpayment,0,3900
amtYoFtj,3900,7/15/2019,8900,amtYoFtj,28400,more than downpayment,more than downpayment,0,3900
amtYoFtj,3900,8/18/2019,8900,amtYoFtj,32300,more than downpayment,more than downpayment,0,3900
amtYoFtj,3900,9/19/2019,8900,amtYoFtj,36200,more than downpayment,more than downpayment,0,3900
amtYoFtj,3900,10/28/2019,8900,amtYoFtj,40100,more than downpayment,more than downpayment,0,3900
anTCGuMA,10500,8/5/2019,9900,,10500,more than downpayment,,9900,600
anTCGuMA,2000,9/14/2019,9900,anTCGuMA,12500,more than downpayment,more than downpayment,0,2000
anTCGuMA,1500,9/23/2019,9900,anTCGuMA,14000,more than downpayment,more than downpayment,0,1500
anTCGuMA,995,9/26/2019,9900,anTCGuMA,14995,more than downpayment,more than downpayment,0,995
anTCGuMA,2100,10/27/2019,9900,anTCGuMA,17095,more than downpayment,more than downpayment,0,2100
anTCGuMA,1100,11/14/2019,9900,anTCGuMA,18195,more than downpayment,more than downpayment,0,1100
anTCGuMA,1400,11/15/2019,9900,anTCGuMA,19595,more than downpayment,more than downpayment,0,1400
anTCGuMA,2500,12/16/2019,9900,anTCGuMA,22095,more than downpayment,more than downpayment,0,2500
anTCGuMA,2000,12/18/2019,9900,anTCGuMA,24095,more than downpayment,more than downpayment,0,2000
anTCGuMA,2540,1/29/2020,9900,anTCGuMA,26635,more than downpayment,more than downpayment,0,2540
anTCGuMA,500,1/30/2020,9900,anTCGuMA,27135,more than downpayment,more than downpayment,0,500
ao4jyJQd,9900,6/4/2019,9900,,9900,equal to downpayment,,9900,0
ao4jyJQd,3900,8/1/2019,9900,ao4jyJQd,13800,more than downpayment,equal to downpayment,0,3900
ao4jyJQd,3900,8/28/2019,9900,ao4jyJQd,17700,more than downpayment,more than downpayment,0,3900
ao4jyJQd,3900,10/6/2019,9900,ao4jyJQd,21600,more than downpayment,more than downpayment,0,3900
ao4jyJQd,3900,11/21/2019,9900,ao4jyJQd,25500,more than downpayment,more than downpayment,0,3900
ao4jyJQd,3900,12/5/2019,9900,ao4jyJQd,29400,more than downpayment,more than downpayment,0,3900
ao4jyJQd,3900,1/15/2020,9900,ao4jyJQd,33300,more than downpayment,more than downpayment,0,3900
AOBhs5Ei,10500,12/20/2017,10000,,10500,more than downpayment,,10000,500
AOBhs5Ei,1500,3/23/2018,10000,AOBhs5Ei,12000,more than downpayment,more than downpayment,0,1500
AOBhs5Ei,2000,4/17/2018,10000,AOBhs5Ei,14000,more than downpayment,more than downpayment,0,2000
AOBhs5Ei,1500,4/25/2018,10000,AOBhs5Ei,15500,more than downpayment,more than downpayment,0,1500
AOBhs5Ei,1500,5/11/2018,10000,AOBhs5Ei,17000,more than downpayment,more than downpayment,0,1500
AOBhs5Ei,1000,6/13/2018,10000,AOBhs5Ei,18000,more than downpayment,more than downpayment,0,1000
AOBhs5Ei,1000,7/6/2018,10000,AOBhs5Ei,19000,more than downpayment,more than downpayment,0,1000
AOBhs5Ei,2000,8/24/2018,10000,AOBhs5Ei,21000,more than downpayment,more than downpayment,0,2000
AOBhs5Ei,800,9/27/2018,10000,AOBhs5Ei,21800,more than downpayment,more than downpayment,0,800
AOBhs5Ei,500,10/4/2018,10000,AOBhs5Ei,22300,more than downpayment,more than downpayment,0,500
AOBhs5Ei,200,10/7/2018,10000,AOBhs5Ei,22500,more than downpayment,more than downpayment,0,200
AOBhs5Ei,500,10/15/2018,10000,AOBhs5Ei,23000,more than downpayment,more than downpayment,0,500
AOBhs5Ei,200,10/17/2018,10000,AOBhs5Ei,23200,more than downpayment,more than downpayment,0,200
AOBhs5Ei,500,10/22/2018,10000,AOBhs5Ei,23700,more than downpayment,more than downpayment,0,500
AOBhs5Ei,5000,1/28/2019,10000,AOBhs5Ei,28700,more than downpayment,more than downpayment,0,5000
AOBhs5Ei,800,2/26/2019,10000,AOBhs5Ei,29500,more than downpayment,more than downpayment,0,800
AOBhs5Ei,1000,3/19/2019,10000,AOBhs5Ei,30500,more than downpayment,more than downpayment,0,1000
AOBhs5Ei,400,3/26/2019,10000,AOBhs5Ei,30900,more than downpayment,more than downpayment,0,400
AOBhs5Ei,400,3/28/2019,10000,AOBhs5Ei,31300,more than downpayment,more than downpayment,0,400
AOBhs5Ei,800,4/24/2019,10000,AOBhs5Ei,32100,more than downpayment,more than downpayment,0,800
AOBhs5Ei,1000,5/10/2019,10000,AOBhs5Ei,33100,more than downpayment,more than downpayment,0,1000
AOBhs5Ei,400,5/14/2019,10000,AOBhs5Ei,33500,more than downpayment,more than downpayment,0,400
AOBhs5Ei,1000,5/28/2019,10000,AOBhs5Ei,34500,more than downpayment,more than downpayment,0,1000
AOBhs5Ei,300,6/17/2019,10000,AOBhs5Ei,34800,more than downpayment,more than downpayment,0,300
AOBhs5Ei,400,6/27/2019,10000,AOBhs5Ei,35200,more than downpayment,more than downpayment,0,400
AOBhs5Ei,500,8/2/2019,10000,AOBhs5Ei,35700,more than downpayment,more than downpayment,0,500
AOBhs5Ei,500,8/23/2019,10000,AOBhs5Ei,36200,more than downpayment,more than downpayment,0,500
AOBhs5Ei,500,9/5/2019,10000,AOBhs5Ei,36700,more than downpayment,more than downpayment,0,500
AOBhs5Ei,2000,9/28/2019,10000,AOBhs5Ei,38700,more than downpayment,more than downpayment,0,2000
AoI7KqRk,8900,3/12/2019,8900,,8900,equal to downpayment,,8900,0
AoI7KqRk,3900,4/12/2019,8900,AoI7KqRk,12800,more than downpayment,equal to downpayment,0,3900
AoI7KqRk,3900,5/15/2019,8900,AoI7KqRk,16700,more than downpayment,more than downpayment,0,3900
AoI7KqRk,3900,6/17/2019,8900,AoI7KqRk,20600,more than downpayment,more than downpayment,0,3900
AoI7KqRk,3900,8/4/2019,8900,AoI7KqRk,24500,more than downpayment,more than downpayment,0,3900
AoI7KqRk,3900,9/3/2019,8900,AoI7KqRk,28400,more than downpayment,more than downpayment,0,3900
AoI7KqRk,3900,10/11/2019,8900,AoI7KqRk,32300,more than downpayment,more than downpayment,0,3900
AoI7KqRk,3900,11/21/2019,8900,AoI7KqRk,36200,more than downpayment,more than downpayment,0,3900
AoI7KqRk,3900,12/12/2019,8900,AoI7KqRk,40100,more than downpayment,more than downpayment,0,3900
AoI7KqRk,3900,1/13/2020,8900,AoI7KqRk,44000,more than downpayment,more than downpayment,0,3900
aOropZ8y,8900,4/24/2019,8900,,8900,equal to downpayment,,8900,0
aOropZ8y,3900,5/23/2019,8900,aOropZ8y,12800,more than downpayment,equal to downpayment,0,3900
aOropZ8y,3900,6/24/2019,8900,aOropZ8y,16700,more than downpayment,more than downpayment,0,3900
aOropZ8y,3900,7/24/2019,8900,aOropZ8y,20600,more than downpayment,more than downpayment,0,3900
aOropZ8y,3900,8/25/2019,8900,aOropZ8y,24500,more than downpayment,more than downpayment,0,3900
aOropZ8y,3900,9/25/2019,8900,aOropZ8y,28400,more than downpayment,more than downpayment,0,3900
aOropZ8y,3900,10/25/2019,8900,aOropZ8y,32300,more than downpayment,more than downpayment,0,3900
aOropZ8y,3900,11/25/2019,8900,aOropZ8y,36200,more than downpayment,more than downpayment,0,3900
aOropZ8y,3900,12/26/2019,8900,aOropZ8y,40100,more than downpayment,more than downpayment,0,3900
aOropZ8y,3900,1/25/2020,8900,aOropZ8y,44000,more than downpayment,more than downpayment,0,3900
AP25W577,9900,12/13/2019,9900,,9900,equal to downpayment,,9900,0
AP25W577,3900,2/3/2020,9900,AP25W577,13800,more than downpayment,equal to downpayment,0,3900
APX6xx3Z,10000,11/13/2018,10000,,10000,equal to downpayment,,10000,0
APX6xx3Z,2000,4/2/2019,10000,APX6xx3Z,12000,more than downpayment,equal to downpayment,0,2000
ARQBH79J,9900,11/19/2019,9900,,9900,equal to downpayment,,9900,0
ARQBH79J,3900,1/29/2020,9900,ARQBH79J,13800,more than downpayment,equal to downpayment,0,3900
AS11RFB5,9900,11/12/2019,9900,,9900,equal to downpayment,,9900,0
AS11RFB5,3900,1/11/2020,9900,AS11RFB5,13800,more than downpayment,equal to downpayment,0,3900
AS11RFB5,3900,1/28/2020,9900,AS11RFB5,17700,more than downpayment,more than downpayment,0,3900
ASpSPhcX,8900,3/14/2019,8900,,8900,equal to downpayment,,8900,0
ASpSPhcX,3900,4/15/2019,8900,ASpSPhcX,12800,more than downpayment,equal to downpayment,0,3900
ASpSPhcX,3900,5/15/2019,8900,ASpSPhcX,16700,more than downpayment,more than downpayment,0,3900
ASpSPhcX,3900,6/17/2019,8900,ASpSPhcX,20600,more than downpayment,more than downpayment,0,3900
ASpSPhcX,3900,7/16/2019,8900,ASpSPhcX,24500,more than downpayment,more than downpayment,0,3900
ASpSPhcX,3900,8/19/2019,8900,ASpSPhcX,28400,more than downpayment,more than downpayment,0,3900
ASpSPhcX,3900,9/16/2019,8900,ASpSPhcX,32300,more than downpayment,more than downpayment,0,3900
ASpSPhcX,3900,10/18/2019,8900,ASpSPhcX,36200,more than downpayment,more than downpayment,0,3900
ASpSPhcX,3900,12/30/2019,8900,ASpSPhcX,40100,more than downpayment,more than downpayment,0,3900
ASpSPhcX,3900,1/27/2020,8900,ASpSPhcX,44000,more than downpayment,more than downpayment,0,3900
ASQOJCP2,8900,5/29/2019,8900,,8900,equal to downpayment,,8900,0
ASQOJCP2,3900,7/20/2019,8900,ASQOJCP2,12800,more than downpayment,equal to downpayment,0,3900
ASQOJCP2,3900,8/26/2019,8900,ASQOJCP2,16700,more than downpayment,more than downpayment,0,3900
ASQOJCP2,3900,9/25/2019,8900,ASQOJCP2,20600,more than downpayment,more than downpayment,0,3900
ASQOJCP2,2000,12/6/2019,8900,ASQOJCP2,22600,more than downpayment,more than downpayment,0,2000
ASQOJCP2,4000,1/3/2020,8900,ASQOJCP2,26600,more than downpayment,more than downpayment,0,4000
ASQOJCP2,9600,1/30/2020,8900,ASQOJCP2,36200,more than downpayment,more than downpayment,0,9600
ASUPVB1G,10000,6/29/2019,9900,,10000,more than downpayment,,9900,100
ASUPVB1G,2000,9/26/2019,9900,ASUPVB1G,12000,more than downpayment,more than downpayment,0,2000
ASUPVB1G,7000,10/18/2019,9900,ASUPVB1G,19000,more than downpayment,more than downpayment,0,7000
ASUPVB1G,2600,11/15/2019,9900,ASUPVB1G,21600,more than downpayment,more than downpayment,0,2600
ASUPVB1G,3900,11/25/2019,9900,ASUPVB1G,25500,more than downpayment,more than downpayment,0,3900
ASUPVB1G,3900,12/23/2019,9900,ASUPVB1G,29400,more than downpayment,more than downpayment,0,3900
AT4MI67W,9900,12/1/2019,9900,,9900,equal to downpayment,,9900,0
AT9fs9wR,10000,8/25/2018,10000,,10000,equal to downpayment,,10000,0
AT9fs9wR,4500,10/4/2018,10000,AT9fs9wR,14500,more than downpayment,equal to downpayment,0,4500
AT9fs9wR,4500,11/5/2018,10000,AT9fs9wR,19000,more than downpayment,more than downpayment,0,4500
AT9fs9wR,4500,12/5/2018,10000,AT9fs9wR,23500,more than downpayment,more than downpayment,0,4500
AT9fs9wR,4500,1/2/2019,10000,AT9fs9wR,28000,more than downpayment,more than downpayment,0,4500
AT9fs9wR,4500,2/5/2019,10000,AT9fs9wR,32500,more than downpayment,more than downpayment,0,4500
AT9fs9wR,4500,3/5/2019,10000,AT9fs9wR,37000,more than downpayment,more than downpayment,0,4500
AT9fs9wR,4500,4/5/2019,10000,AT9fs9wR,41500,more than downpayment,more than downpayment,0,4500
AT9fs9wR,4500,5/23/2019,10000,AT9fs9wR,46000,more than downpayment,more than downpayment,0,4500
AT9fs9wR,4500,6/20/2019,10000,AT9fs9wR,50500,more than downpayment,more than downpayment,0,4500
AT9fs9wR,4500,7/15/2019,10000,AT9fs9wR,55000,more than downpayment,more than downpayment,0,4500
AT9fs9wR,4500,8/21/2019,10000,AT9fs9wR,59500,more than downpayment,more than downpayment,0,4500
AT9fs9wR,4500,9/13/2019,10000,AT9fs9wR,64000,more than downpayment,more than downpayment,0,4500
aTT8GGIZ,8900,3/21/2019,8900,,8900,equal to downpayment,,8900,0
aTT8GGIZ,2000,3/31/2019,8900,aTT8GGIZ,10900,more than downpayment,equal to downpayment,0,2000
aTT8GGIZ,1150,4/7/2019,8900,aTT8GGIZ,12050,more than downpayment,more than downpayment,0,1150
aTT8GGIZ,750,4/24/2019,8900,aTT8GGIZ,12800,more than downpayment,more than downpayment,0,750
aTT8GGIZ,1000,5/18/2019,8900,aTT8GGIZ,13800,more than downpayment,more than downpayment,0,1000
aTT8GGIZ,1000,5/21/2019,8900,aTT8GGIZ,14800,more than downpayment,more than downpayment,0,1000
aTT8GGIZ,1900,5/25/2019,8900,aTT8GGIZ,16700,more than downpayment,more than downpayment,0,1900
aTT8GGIZ,1350,6/20/2019,8900,aTT8GGIZ,18050,more than downpayment,more than downpayment,0,1350
aTT8GGIZ,700,6/23/2019,8900,aTT8GGIZ,18750,more than downpayment,more than downpayment,0,700
aTT8GGIZ,1150,6/24/2019,8900,aTT8GGIZ,19900,more than downpayment,more than downpayment,0,1150
aTT8GGIZ,700,6/25/2019,8900,aTT8GGIZ,20600,more than downpayment,more than downpayment,0,700
aTT8GGIZ,1600,7/13/2019,8900,aTT8GGIZ,22200,more than downpayment,more than downpayment,0,1600
aTT8GGIZ,700,7/23/2019,8900,aTT8GGIZ,22900,more than downpayment,more than downpayment,0,700
aTT8GGIZ,900,7/25/2019,8900,aTT8GGIZ,23800,more than downpayment,more than downpayment,0,900
aTT8GGIZ,700,7/27/2019,8900,aTT8GGIZ,24500,more than downpayment,more than downpayment,0,700
aTT8GGIZ,600,8/17/2019,8900,aTT8GGIZ,25100,more than downpayment,more than downpayment,0,600
aTT8GGIZ,2550,8/24/2019,8900,aTT8GGIZ,27650,more than downpayment,more than downpayment,0,2550
aTT8GGIZ,400,8/25/2019,8900,aTT8GGIZ,28050,more than downpayment,more than downpayment,0,400
aTT8GGIZ,350,8/26/2019,8900,aTT8GGIZ,28400,more than downpayment,more than downpayment,0,350
aTT8GGIZ,1350,9/25/2019,8900,aTT8GGIZ,29750,more than downpayment,more than downpayment,0,1350
aTT8GGIZ,2530,10/5/2019,8900,aTT8GGIZ,32280,more than downpayment,more than downpayment,0,2530
aTT8GGIZ,20,10/16/2019,8900,aTT8GGIZ,32300,more than downpayment,more than downpayment,0,20
aTT8GGIZ,1500,11/9/2019,8900,aTT8GGIZ,33800,more than downpayment,more than downpayment,0,1500
aTT8GGIZ,2600,11/25/2019,8900,aTT8GGIZ,36400,more than downpayment,more than downpayment,0,2600
aUm4hVLp,8900,1/30/2019,8900,,8900,equal to downpayment,,8900,0
aUm4hVLp,3900,2/24/2019,8900,aUm4hVLp,12800,more than downpayment,equal to downpayment,0,3900
aUm4hVLp,3900,4/4/2019,8900,aUm4hVLp,16700,more than downpayment,more than downpayment,0,3900
aUm4hVLp,3900,5/5/2019,8900,aUm4hVLp,20600,more than downpayment,more than downpayment,0,3900
aUm4hVLp,3900,6/3/2019,8900,aUm4hVLp,24500,more than downpayment,more than downpayment,0,3900
aUm4hVLp,3900,7/9/2019,8900,aUm4hVLp,28400,more than downpayment,more than downpayment,0,3900
aUm4hVLp,3900,8/7/2019,8900,aUm4hVLp,32300,more than downpayment,more than downpayment,0,3900
aUm4hVLp,1300,9/6/2019,8900,aUm4hVLp,33600,more than downpayment,more than downpayment,0,1300
aUm4hVLp,2600,9/10/2019,8900,aUm4hVLp,36200,more than downpayment,more than downpayment,0,2600
aUm4hVLp,3900,10/8/2019,8900,aUm4hVLp,40100,more than downpayment,more than downpayment,0,3900
aUm4hVLp,3900,11/12/2019,8900,aUm4hVLp,44000,more than downpayment,more than downpayment,0,3900
aUm4hVLp,3900,12/11/2019,8900,aUm4hVLp,47900,more than downpayment,more than downpayment,0,3900
aUm4hVLp,3000,1/11/2020,8900,aUm4hVLp,50900,more than downpayment,more than downpayment,0,3000
aUm4hVLp,900,1/16/2020,8900,aUm4hVLp,51800,more than downpayment,more than downpayment,0,900
aUm4hVLp,3900,2/5/2020,8900,aUm4hVLp,55700,more than downpayment,more than downpayment,0,3900
Aumvv1FU,25000,2/19/2019,8900,,25000,more than downpayment,,8900,16100
Aumvv1FU,25000,7/15/2019,8900,Aumvv1FU,50000,more than downpayment,more than downpayment,0,25000
AUPAIPTP,9900,1/21/2020,9900,,9900,equal to downpayment,,9900,0
aUU2Wt48,8900,2/8/2019,8900,,8900,equal to downpayment,,8900,0
AUVKFGHM,15000,1/23/2020,9900,,15000,more than downpayment,,9900,5100
AV7YQQ7Y,9900,7/31/2019,9900,,9900,equal to downpayment,,9900,0
AV7YQQ7Y,3900,10/5/2019,9900,AV7YQQ7Y,13800,more than downpayment,equal to downpayment,0,3900
AV7YQQ7Y,3900,11/6/2019,9900,AV7YQQ7Y,17700,more than downpayment,more than downpayment,0,3900
AV7YQQ7Y,3900,12/5/2019,9900,AV7YQQ7Y,21600,more than downpayment,more than downpayment,0,3900
AV7YQQ7Y,3900,1/9/2020,9900,AV7YQQ7Y,25500,more than downpayment,more than downpayment,0,3900
AV7YQQ7Y,3900,2/4/2020,9900,AV7YQQ7Y,29400,more than downpayment,more than downpayment,0,3900
Avq0RzZR,9900,6/12/2019,9900,,9900,equal to downpayment,,9900,0
AvUoARHO,8900,9/24/2019,8900,,8900,equal to downpayment,,8900,0
AvUoARHO,3900,11/11/2019,8900,AvUoARHO,12800,more than downpayment,equal to downpayment,0,3900
AvUoARHO,3900,12/7/2019,8900,AvUoARHO,16700,more than downpayment,more than downpayment,0,3900
AvUoARHO,3900,1/28/2020,8900,AvUoARHO,20600,more than downpayment,more than downpayment,0,3900
AWGFZS3W,9900,11/7/2019,9900,,9900,equal to downpayment,,9900,0
AWGFZS3W,4000,12/24/2019,9900,AWGFZS3W,13900,more than downpayment,equal to downpayment,0,4000
AWGFZS3W,2000,1/24/2020,9900,AWGFZS3W,15900,more than downpayment,more than downpayment,0,2000
AWGFZS3W,600,1/27/2020,9900,AWGFZS3W,16500,more than downpayment,more than downpayment,0,600
AWGFZS3W,1400,1/28/2020,9900,AWGFZS3W,17900,more than downpayment,more than downpayment,0,1400
AWPFCUZP,8900,11/19/2019,8900,,8900,equal to downpayment,,8900,0
AWPFCUZP,2200,12/18/2019,8900,AWPFCUZP,11100,more than downpayment,equal to downpayment,0,2200
AWPFCUZP,1700,12/27/2019,8900,AWPFCUZP,12800,more than downpayment,more than downpayment,0,1700
AWPFCUZP,3900,2/4/2020,8900,AWPFCUZP,16700,more than downpayment,more than downpayment,0,3900
ax5FqXSe,8900,5/9/2019,8900,,8900,equal to downpayment,,8900,0
ax5FqXSe,10000,11/22/2019,8900,ax5FqXSe,18900,more than downpayment,equal to downpayment,0,10000
ax5FqXSe,5000,11/26/2019,8900,ax5FqXSe,23900,more than downpayment,more than downpayment,0,5000
AXgLPaS6,10000,8/21/2018,10000,,10000,equal to downpayment,,10000,0
AXgLPaS6,4500,9/25/2018,10000,AXgLPaS6,14500,more than downpayment,equal to downpayment,0,4500
AXgLPaS6,4500,10/25/2018,10000,AXgLPaS6,19000,more than downpayment,more than downpayment,0,4500
AXgLPaS6,5000,11/22/2018,10000,AXgLPaS6,24000,more than downpayment,more than downpayment,0,5000
AXgLPaS6,4500,12/26/2018,10000,AXgLPaS6,28500,more than downpayment,more than downpayment,0,4500
AXgLPaS6,4500,1/24/2019,10000,AXgLPaS6,33000,more than downpayment,more than downpayment,0,4500
AXgLPaS6,4500,2/25/2019,10000,AXgLPaS6,37500,more than downpayment,more than downpayment,0,4500
AXgLPaS6,4500,3/25/2019,10000,AXgLPaS6,42000,more than downpayment,more than downpayment,0,4500
AXgLPaS6,4500,4/24/2019,10000,AXgLPaS6,46500,more than downpayment,more than downpayment,0,4500
AXgLPaS6,5000,5/24/2019,10000,AXgLPaS6,51500,more than downpayment,more than downpayment,0,5000
AXgLPaS6,5000,6/26/2019,10000,AXgLPaS6,56500,more than downpayment,more than downpayment,0,5000
AXgLPaS6,4500,7/24/2019,10000,AXgLPaS6,61000,more than downpayment,more than downpayment,0,4500
AXgLPaS6,3000,8/23/2019,10000,AXgLPaS6,64000,more than downpayment,more than downpayment,0,3000
AXW5REIB,9900,6/22/2019,9900,,9900,equal to downpayment,,9900,0
aYpAWI1m,10000,9/15/2017,10000,,10000,equal to downpayment,,10000,0
aYpAWI1m,3500,10/23/2017,10000,aYpAWI1m,13500,more than downpayment,equal to downpayment,0,3500
aYpAWI1m,3500,11/23/2017,10000,aYpAWI1m,17000,more than downpayment,more than downpayment,0,3500
aYpAWI1m,3500,12/23/2017,10000,aYpAWI1m,20500,more than downpayment,more than downpayment,0,3500
aYpAWI1m,3500,1/23/2018,10000,aYpAWI1m,24000,more than downpayment,more than downpayment,0,3500
aYpAWI1m,3500,2/23/2018,10000,aYpAWI1m,27500,more than downpayment,more than downpayment,0,3500
aYpAWI1m,3000,3/23/2018,10000,aYpAWI1m,30500,more than downpayment,more than downpayment,0,3000
aYpAWI1m,3500,4/23/2018,10000,aYpAWI1m,34000,more than downpayment,more than downpayment,0,3500
aYpAWI1m,3500,5/23/2018,10000,aYpAWI1m,37500,more than downpayment,more than downpayment,0,3500
aYpAWI1m,3500,6/25/2018,10000,aYpAWI1m,41000,more than downpayment,more than downpayment,0,3500
aYpAWI1m,3500,7/23/2018,10000,aYpAWI1m,44500,more than downpayment,more than downpayment,0,3500
aYpAWI1m,3500,8/24/2018,10000,aYpAWI1m,48000,more than downpayment,more than downpayment,0,3500
aYpAWI1m,4000,9/25/2018,10000,aYpAWI1m,52000,more than downpayment,more than downpayment,0,4000
AYPOFG63,9900,10/28/2019,9900,,9900,equal to downpayment,,9900,0
AYPOFG63,3900,12/12/2019,9900,AYPOFG63,13800,more than downpayment,equal to downpayment,0,3900
AYPOFG63,3900,1/15/2020,9900,AYPOFG63,17700,more than downpayment,more than downpayment,0,3900
aywT6P5I,8900,1/28/2019,8900,,8900,equal to downpayment,,8900,0
aywT6P5I,3900,3/5/2019,8900,aywT6P5I,12800,more than downpayment,equal to downpayment,0,3900
aywT6P5I,3900,4/6/2019,8900,aywT6P5I,16700,more than downpayment,more than downpayment,0,3900
aywT6P5I,3900,5/4/2019,8900,aywT6P5I,20600,more than downpayment,more than downpayment,0,3900
aywT6P5I,3900,6/6/2019,8900,aywT6P5I,24500,more than downpayment,more than downpayment,0,3900
aywT6P5I,3900,7/9/2019,8900,aywT6P5I,28400,more than downpayment,more than downpayment,0,3900
aywT6P5I,3900,8/4/2019,8900,aywT6P5I,32300,more than downpayment,more than downpayment,0,3900
aywT6P5I,3900,9/6/2019,8900,aywT6P5I,36200,more than downpayment,more than downpayment,0,3900
aywT6P5I,3900,10/3/2019,8900,aywT6P5I,40100,more than downpayment,more than downpayment,0,3900
aywT6P5I,3900,11/6/2019,8900,aywT6P5I,44000,more than downpayment,more than downpayment,0,3900
aywT6P5I,3900,12/5/2019,8900,aywT6P5I,47900,more than downpayment,more than downpayment,0,3900
aywT6P5I,3900,2/5/2020,8900,aywT6P5I,51800,more than downpayment,more than downpayment,0,3900
az7i1UQf,8900,3/11/2019,8900,,8900,equal to downpayment,,8900,0
az7i1UQf,3900,4/10/2019,8900,az7i1UQf,12800,more than downpayment,equal to downpayment,0,3900
az7i1UQf,3900,5/9/2019,8900,az7i1UQf,16700,more than downpayment,more than downpayment,0,3900
az7i1UQf,3900,6/7/2019,8900,az7i1UQf,20600,more than downpayment,more than downpayment,0,3900
az7i1UQf,3900,7/8/2019,8900,az7i1UQf,24500,more than downpayment,more than downpayment,0,3900
az7i1UQf,3900,8/13/2019,8900,az7i1UQf,28400,more than downpayment,more than downpayment,0,3900
az7i1UQf,3900,9/10/2019,8900,az7i1UQf,32300,more than downpayment,more than downpayment,0,3900
az7i1UQf,3900,10/14/2019,8900,az7i1UQf,36200,more than downpayment,more than downpayment,0,3900
az7i1UQf,3900,11/12/2019,8900,az7i1UQf,40100,more than downpayment,more than downpayment,0,3900
az7i1UQf,3900,12/12/2019,8900,az7i1UQf,44000,more than downpayment,more than downpayment,0,3900
az7i1UQf,3900,1/15/2020,8900,az7i1UQf,47900,more than downpayment,more than downpayment,0,3900
b010bb8a,9900,11/21/2019,9900,,9900,equal to downpayment,,9900,0
b010bb8a,3900,2/4/2020,9900,b010bb8a,13800,more than downpayment,equal to downpayment,0,3900
b0534f6a,4999,12/20/2019,4999,,4999,equal to downpayment,,4999,0
b06071e5,200,11/20/2019,9900,,200,less than downpayment,,200,0
b06071e5,1000,12/8/2019,9900,b06071e5,1200,less than downpayment,less than downpayment,1000,0
b06071e5,5000,12/29/2019,9900,b06071e5,6200,less than downpayment,less than downpayment,5000,0
b06071e5,1500,12/30/2019,9900,b06071e5,7700,less than downpayment,less than downpayment,1500,0
b06071e5,198,12/31/2019,9900,b06071e5,7898,less than downpayment,less than downpayment,198,0
b06071e5,2010,1/3/2020,9900,b06071e5,9908,more than downpayment,less than downpayment,2002,8
b06071e5,1000,1/21/2020,9900,b06071e5,10908,more than downpayment,more than downpayment,0,1000
b06071e5,1000,2/2/2020,9900,b06071e5,11908,more than downpayment,more than downpayment,0,1000
b06071e5,1000,2/6/2020,9900,b06071e5,12908,more than downpayment,more than downpayment,0,1000
b064e89c,9900,11/14/2019,9900,,9900,equal to downpayment,,9900,0
b064e89c,3900,1/20/2020,9900,b064e89c,13800,more than downpayment,equal to downpayment,0,3900
b0855329,9900,11/28/2019,9900,,9900,equal to downpayment,,9900,0
b0855329,5000,1/2/2020,9900,b0855329,14900,more than downpayment,equal to downpayment,0,5000
b0855329,3900,2/5/2020,9900,b0855329,18800,more than downpayment,more than downpayment,0,3900
b0c67169,9900,1/24/2020,9900,,9900,equal to downpayment,,9900,0
b0EnQuyQ,12800,1/7/2019,8900,,12800,more than downpayment,,8900,3900
b0EnQuyQ,3900,2/14/2019,8900,b0EnQuyQ,16700,more than downpayment,more than downpayment,0,3900
b0EnQuyQ,3900,3/18/2019,8900,b0EnQuyQ,20600,more than downpayment,more than downpayment,0,3900
b0EnQuyQ,3900,4/19/2019,8900,b0EnQuyQ,24500,more than downpayment,more than downpayment,0,3900
b0EnQuyQ,3900,5/20/2019,8900,b0EnQuyQ,28400,more than downpayment,more than downpayment,0,3900
b0EnQuyQ,3900,6/24/2019,8900,b0EnQuyQ,32300,more than downpayment,more than downpayment,0,3900
b0EnQuyQ,3900,7/24/2019,8900,b0EnQuyQ,36200,more than downpayment,more than downpayment,0,3900
b0EnQuyQ,3900,8/25/2019,8900,b0EnQuyQ,40100,more than downpayment,more than downpayment,0,3900
b0EnQuyQ,3900,9/25/2019,8900,b0EnQuyQ,44000,more than downpayment,more than downpayment,0,3900
b0EnQuyQ,3900,10/24/2019,8900,b0EnQuyQ,47900,more than downpayment,more than downpayment,0,3900
b0EnQuyQ,3900,11/22/2019,8900,b0EnQuyQ,51800,more than downpayment,more than downpayment,0,3900
b0EnQuyQ,3900,12/21/2019,8900,b0EnQuyQ,55700,more than downpayment,more than downpayment,0,3900
b0EnQuyQ,3900,1/28/2020,8900,b0EnQuyQ,59600,more than downpayment,more than downpayment,0,3900
B0SChLn7,8900,2/20/2019,8900,,8900,equal to downpayment,,8900,0
B0SChLn7,10700,5/6/2019,8900,B0SChLn7,19600,more than downpayment,equal to downpayment,0,10700
B0SChLn7,1000,6/5/2019,8900,B0SChLn7,20600,more than downpayment,more than downpayment,0,1000
B0SChLn7,7800,11/6/2019,8900,B0SChLn7,28400,more than downpayment,more than downpayment,0,7800
b1349063,49000,11/11/2019,9900,,49000,more than downpayment,,9900,39100
b2070540,26250,12/19/2019,23400,,26250,more than downpayment,,23400,2850
b2187e36,1594,10/14/2019,1594,,1594,equal to downpayment,,1594,0
b2187e36,1100,1/14/2020,1594,b2187e36,2694,more than downpayment,equal to downpayment,0,1100
b2187e36,1000,1/15/2020,1594,b2187e36,3694,more than downpayment,more than downpayment,0,1000
b2187e36,1000,1/17/2020,1594,b2187e36,4694,more than downpayment,more than downpayment,0,1000
b2ec8f5d,9900,10/7/2019,8900,,9900,more than downpayment,,8900,1000
b2ec8f5d,3900,11/22/2019,8900,b2ec8f5d,13800,more than downpayment,more than downpayment,0,3900
b2ec8f5d,3900,12/20/2019,8900,b2ec8f5d,17700,more than downpayment,more than downpayment,0,3900
b2ec8f5d,3900,1/23/2020,8900,b2ec8f5d,21600,more than downpayment,more than downpayment,0,3900
b39bea3d,8900,10/9/2019,8900,,8900,equal to downpayment,,8900,0
b39bea3d,4000,12/14/2019,8900,b39bea3d,12900,more than downpayment,equal to downpayment,0,4000
b39bea3d,4000,1/16/2020,8900,b39bea3d,16900,more than downpayment,more than downpayment,0,4000
b39de84b,1594,10/14/2019,1594,,1594,equal to downpayment,,1594,0
b39de84b,3100,11/5/2019,1594,b39de84b,4694,more than downpayment,equal to downpayment,0,3100
b39de84b,3100,12/9/2019,1594,b39de84b,7794,more than downpayment,more than downpayment,0,3100
b39de84b,3100,1/6/2020,1594,b39de84b,10894,more than downpayment,more than downpayment,0,3100
b3e5efc4,9900,12/23/2019,9900,,9900,equal to downpayment,,9900,0
b3ff4ec8,9900,10/28/2019,9900,,9900,equal to downpayment,,9900,0
b3ff4ec8,3900,1/5/2020,9900,b3ff4ec8,13800,more than downpayment,equal to downpayment,0,3900
b3ff4ec8,3900,2/5/2020,9900,b3ff4ec8,17700,more than downpayment,more than downpayment,0,3900
B3FI1Z2X,9900,8/7/2019,9900,,9900,equal to downpayment,,9900,0
B3FI1Z2X,3900,10/16/2019,9900,B3FI1Z2X,13800,more than downpayment,equal to downpayment,0,3900
B3FI1Z2X,3900,11/25/2019,9900,B3FI1Z2X,17700,more than downpayment,more than downpayment,0,3900
B3FI1Z2X,3900,1/2/2020,9900,B3FI1Z2X,21600,more than downpayment,more than downpayment,0,3900
B3FI1Z2X,3900,1/28/2020,9900,B3FI1Z2X,25500,more than downpayment,more than downpayment,0,3900
b3GPTtQj,9900,7/8/2019,8900,,9900,more than downpayment,,8900,1000
b3GPTtQj,1000,7/19/2019,8900,b3GPTtQj,10900,more than downpayment,more than downpayment,0,1000
b3GPTtQj,3900,8/25/2019,8900,b3GPTtQj,14800,more than downpayment,more than downpayment,0,3900
b3GPTtQj,7300,9/25/2019,8900,b3GPTtQj,22100,more than downpayment,more than downpayment,0,7300
b3GPTtQj,4000,11/25/2019,8900,b3GPTtQj,26100,more than downpayment,more than downpayment,0,4000
b3GPTtQj,4000,12/26/2019,8900,b3GPTtQj,30100,more than downpayment,more than downpayment,0,4000
b3GPTtQj,4000,1/29/2020,8900,b3GPTtQj,34100,more than downpayment,more than downpayment,0,4000
B3mMEUbv,9900,6/25/2019,9900,,9900,equal to downpayment,,9900,0
B3mMEUbv,14000,6/28/2019,9900,B3mMEUbv,23900,more than downpayment,equal to downpayment,0,14000
B3mMEUbv,15000,8/5/2019,9900,B3mMEUbv,38900,more than downpayment,more than downpayment,0,15000
B3mMEUbv,7500,10/7/2019,9900,B3mMEUbv,46400,more than downpayment,more than downpayment,0,7500
B3mMEUbv,7500,11/1/2019,9900,B3mMEUbv,53900,more than downpayment,more than downpayment,0,7500
B3mMEUbv,7300,12/5/2019,9900,B3mMEUbv,61200,more than downpayment,more than downpayment,0,7300
B3mMEUbv,7300,1/6/2020,9900,B3mMEUbv,68500,more than downpayment,more than downpayment,0,7300
B3URJ6E8,7900,11/13/2019,7900,,7900,equal to downpayment,,7900,0
b4cb9372,10000,12/31/2019,9900,,10000,more than downpayment,,9900,100
B4FA152Q,10000,1/9/2020,9900,,10000,more than downpayment,,9900,100
b581093b,8900,1/9/2020,8900,,8900,equal to downpayment,,8900,0
b59LFgnK,9000,5/9/2019,8900,,9000,more than downpayment,,8900,100
b59LFgnK,3900,6/14/2019,8900,b59LFgnK,12900,more than downpayment,more than downpayment,0,3900
b59LFgnK,3900,7/13/2019,8900,b59LFgnK,16800,more than downpayment,more than downpayment,0,3900
b59LFgnK,3900,8/12/2019,8900,b59LFgnK,20700,more than downpayment,more than downpayment,0,3900
b59LFgnK,3900,9/10/2019,8900,b59LFgnK,24600,more than downpayment,more than downpayment,0,3900
b59LFgnK,3900,10/12/2019,8900,b59LFgnK,28500,more than downpayment,more than downpayment,0,3900
b59LFgnK,3900,11/13/2019,8900,b59LFgnK,32400,more than downpayment,more than downpayment,0,3900
b59LFgnK,3900,12/14/2019,8900,b59LFgnK,36300,more than downpayment,more than downpayment,0,3900
b59LFgnK,3900,1/15/2020,8900,b59LFgnK,40200,more than downpayment,more than downpayment,0,3900
b5ec54b9,9900,10/29/2019,9900,,9900,equal to downpayment,,9900,0
b6c8bb39,9900,12/31/2019,9900,,9900,equal to downpayment,,9900,0
b6d03a61,23400,1/23/2020,23400,,23400,equal to downpayment,,23400,0
B6J5Xyz4,8900,1/31/2019,8900,,8900,equal to downpayment,,8900,0
B6J5Xyz4,4000,3/12/2019,8900,B6J5Xyz4,12900,more than downpayment,equal to downpayment,0,4000
B6J5Xyz4,3000,4/24/2019,8900,B6J5Xyz4,15900,more than downpayment,more than downpayment,0,3000
B6J5Xyz4,2000,6/24/2019,8900,B6J5Xyz4,17900,more than downpayment,more than downpayment,0,2000
B6J5Xyz4,10000,8/27/2019,8900,B6J5Xyz4,27900,more than downpayment,more than downpayment,0,10000
B6J5Xyz4,6000,10/26/2019,8900,B6J5Xyz4,33900,more than downpayment,more than downpayment,0,6000
B6J5Xyz4,10000,12/16/2019,8900,B6J5Xyz4,43900,more than downpayment,more than downpayment,0,10000
B6UIXHDI,9900,2/4/2020,9900,,9900,equal to downpayment,,9900,0
B6vQ8eND,10000,12/3/2018,10000,,10000,equal to downpayment,,10000,0
B6vQ8eND,4500,2/11/2019,10000,B6vQ8eND,14500,more than downpayment,equal to downpayment,0,4500
B6vQ8eND,4500,3/9/2019,10000,B6vQ8eND,19000,more than downpayment,more than downpayment,0,4500
B6vQ8eND,4500,3/26/2019,10000,B6vQ8eND,23500,more than downpayment,more than downpayment,0,4500
B6vQ8eND,4500,4/25/2019,10000,B6vQ8eND,28000,more than downpayment,more than downpayment,0,4500
B6vQ8eND,4500,5/24/2019,10000,B6vQ8eND,32500,more than downpayment,more than downpayment,0,4500
B6vQ8eND,4500,6/21/2019,10000,B6vQ8eND,37000,more than downpayment,more than downpayment,0,4500
B6vQ8eND,4500,7/25/2019,10000,B6vQ8eND,41500,more than downpayment,more than downpayment,0,4500
B6vQ8eND,9000,9/26/2019,10000,B6vQ8eND,50500,more than downpayment,more than downpayment,0,9000
B6vQ8eND,4500,10/30/2019,10000,B6vQ8eND,55000,more than downpayment,more than downpayment,0,4500
B6vQ8eND,4500,12/11/2019,10000,B6vQ8eND,59500,more than downpayment,more than downpayment,0,4500
B6vQ8eND,4500,1/9/2020,10000,B6vQ8eND,64000,more than downpayment,more than downpayment,0,4500
B777LGcX,8900,5/28/2019,8900,,8900,equal to downpayment,,8900,0
B777LGcX,3900,7/8/2019,8900,B777LGcX,12800,more than downpayment,equal to downpayment,0,3900
B777LGcX,3900,8/7/2019,8900,B777LGcX,16700,more than downpayment,more than downpayment,0,3900
B777LGcX,3900,9/11/2019,8900,B777LGcX,20600,more than downpayment,more than downpayment,0,3900
B777LGcX,3900,10/16/2019,8900,B777LGcX,24500,more than downpayment,more than downpayment,0,3900
B777LGcX,2000,1/6/2020,8900,B777LGcX,26500,more than downpayment,more than downpayment,0,2000
B777LGcX,2000,1/15/2020,8900,B777LGcX,28500,more than downpayment,more than downpayment,0,2000
B777LGcX,2000,2/3/2020,8900,B777LGcX,30500,more than downpayment,more than downpayment,0,2000
b7e224f1,9900,10/25/2019,9900,,9900,equal to downpayment,,9900,0
b7e224f1,3900,12/2/2019,9900,b7e224f1,13800,more than downpayment,equal to downpayment,0,3900
b7e224f1,3900,12/20/2019,9900,b7e224f1,17700,more than downpayment,more than downpayment,0,3900
b7e224f1,3900,2/5/2020,9900,b7e224f1,21600,more than downpayment,more than downpayment,0,3900
b826a9a7,8900,12/17/2019,8900,,8900,equal to downpayment,,8900,0
b826a9a7,3900,2/4/2020,8900,b826a9a7,12800,more than downpayment,equal to downpayment,0,3900
B8IP5ZSA,8900,11/14/2019,9900,,8900,less than downpayment,,8900,0
B8IP5ZSA,1000,11/15/2019,9900,B8IP5ZSA,9900,equal to downpayment,less than downpayment,1000,0
B8IP5ZSA,4000,1/15/2020,9900,B8IP5ZSA,13900,more than downpayment,equal to downpayment,0,4000
B8O8Xa4G,20000,12/3/2018,23400,,20000,less than downpayment,,20000,0
B8O8Xa4G,8850,1/9/2019,23400,B8O8Xa4G,28850,more than downpayment,less than downpayment,3400,5450
B8O8Xa4G,8850,2/7/2019,23400,B8O8Xa4G,37700,more than downpayment,more than downpayment,0,8850
B8O8Xa4G,8825,3/15/2019,23400,B8O8Xa4G,46525,more than downpayment,more than downpayment,0,8825
B8O8Xa4G,8825,4/9/2019,23400,B8O8Xa4G,55350,more than downpayment,more than downpayment,0,8825
B8O8Xa4G,8825,5/11/2019,23400,B8O8Xa4G,64175,more than downpayment,more than downpayment,0,8825
B8O8Xa4G,8825,6/9/2019,23400,B8O8Xa4G,73000,more than downpayment,more than downpayment,0,8825
B8O8Xa4G,8825,7/8/2019,23400,B8O8Xa4G,81825,more than downpayment,more than downpayment,0,8825
B8O8Xa4G,8825,8/9/2019,23400,B8O8Xa4G,90650,more than downpayment,more than downpayment,0,8825
B8O8Xa4G,8825,9/10/2019,23400,B8O8Xa4G,99475,more than downpayment,more than downpayment,0,8825
B8O8Xa4G,8825,10/8/2019,23400,B8O8Xa4G,108300,more than downpayment,more than downpayment,0,8825
B8O8Xa4G,2700,10/25/2019,23400,B8O8Xa4G,111000,more than downpayment,more than downpayment,0,2700
b945a2ab,9900,10/8/2019,9900,,9900,equal to downpayment,,9900,0
b945a2ab,3900,11/26/2019,9900,b945a2ab,13800,more than downpayment,equal to downpayment,0,3900
b945a2ab,3900,12/31/2019,9900,b945a2ab,17700,more than downpayment,more than downpayment,0,3900
b945a2ab,3900,2/1/2020,9900,b945a2ab,21600,more than downpayment,more than downpayment,0,3900
B94RTT4U,9900,11/22/2019,9900,,9900,equal to downpayment,,9900,0
B94RTT4U,3800,1/22/2020,9900,B94RTT4U,13700,more than downpayment,equal to downpayment,0,3800
B94RTT4U,100,1/29/2020,9900,B94RTT4U,13800,more than downpayment,more than downpayment,0,100
b9bd9890,8900,11/29/2019,8900,,8900,equal to downpayment,,8900,0
b9bd9890,3900,1/25/2020,8900,b9bd9890,12800,more than downpayment,equal to downpayment,0,3900
b9c5dffb,9900,1/8/2020,9900,,9900,equal to downpayment,,9900,0
b9ioqtIV,10000,10/30/2018,10000,,10000,equal to downpayment,,10000,0
b9ioqtIV,4500,11/25/2018,10000,b9ioqtIV,14500,more than downpayment,equal to downpayment,0,4500
b9ioqtIV,3500,12/25/2018,10000,b9ioqtIV,18000,more than downpayment,more than downpayment,0,3500
b9ioqtIV,1000,12/29/2018,10000,b9ioqtIV,19000,more than downpayment,more than downpayment,0,1000
b9ioqtIV,4500,1/25/2019,10000,b9ioqtIV,23500,more than downpayment,more than downpayment,0,4500
b9ioqtIV,2000,3/5/2019,10000,b9ioqtIV,25500,more than downpayment,more than downpayment,0,2000
b9ioqtIV,1000,3/6/2019,10000,b9ioqtIV,26500,more than downpayment,more than downpayment,0,1000
b9ioqtIV,500,3/18/2019,10000,b9ioqtIV,27000,more than downpayment,more than downpayment,0,500
b9ioqtIV,1000,3/19/2019,10000,b9ioqtIV,28000,more than downpayment,more than downpayment,0,1000
B9PPTZH2,9900,12/16/2019,9900,,9900,equal to downpayment,,9900,0
ba1LKfZj,8000,5/27/2017,15000,,8000,less than downpayment,,8000,0
ba1LKfZj,7000,6/8/2017,15000,ba1LKfZj,15000,equal to downpayment,less than downpayment,7000,0
ba1LKfZj,5700,7/21/2017,15000,ba1LKfZj,20700,more than downpayment,equal to downpayment,0,5700
ba1LKfZj,5700,8/17/2017,15000,ba1LKfZj,26400,more than downpayment,more than downpayment,0,5700
ba1LKfZj,5800,10/5/2017,15000,ba1LKfZj,32200,more than downpayment,more than downpayment,0,5800
ba1LKfZj,5300,10/22/2017,15000,ba1LKfZj,37500,more than downpayment,more than downpayment,0,5300
ba1LKfZj,5500,11/17/2017,15000,ba1LKfZj,43000,more than downpayment,more than downpayment,0,5500
ba1LKfZj,5500,12/16/2017,15000,ba1LKfZj,48500,more than downpayment,more than downpayment,0,5500
ba1LKfZj,3500,1/25/2018,15000,ba1LKfZj,52000,more than downpayment,more than downpayment,0,3500
ba1LKfZj,6300,2/20/2018,15000,ba1LKfZj,58300,more than downpayment,more than downpayment,0,6300
ba1LKfZj,6500,3/22/2018,15000,ba1LKfZj,64800,more than downpayment,more than downpayment,0,6500
ba1LKfZj,8000,5/22/2018,15000,ba1LKfZj,72800,more than downpayment,more than downpayment,0,8000
ba1LKfZj,10200,6/23/2018,15000,ba1LKfZj,83000,more than downpayment,more than downpayment,0,10200
ba4aa32e,9900,10/10/2019,9900,,9900,equal to downpayment,,9900,0
ba4aa32e,3900,11/26/2019,9900,ba4aa32e,13800,more than downpayment,equal to downpayment,0,3900
baae2892,8900,1/2/2020,8900,,8900,equal to downpayment,,8900,0
baae2892,3900,2/3/2020,8900,baae2892,12800,more than downpayment,equal to downpayment,0,3900
bb21e141,8900,1/30/2020,8900,,8900,equal to downpayment,,8900,0
bb49093c,8900,11/22/2019,8900,,8900,equal to downpayment,,8900,0
BB6Z34K7,9900,7/30/2019,9900,,9900,equal to downpayment,,9900,0
BB6Z34K7,3900,9/6/2019,9900,BB6Z34K7,13800,more than downpayment,equal to downpayment,0,3900
BB6Z34K7,3900,10/6/2019,9900,BB6Z34K7,17700,more than downpayment,more than downpayment,0,3900
BB6Z34K7,3900,11/7/2019,9900,BB6Z34K7,21600,more than downpayment,more than downpayment,0,3900
BB6Z34K7,3900,12/10/2019,9900,BB6Z34K7,25500,more than downpayment,more than downpayment,0,3900
BB6Z34K7,3900,1/8/2020,9900,BB6Z34K7,29400,more than downpayment,more than downpayment,0,3900
BB6Z34K7,3900,2/9/2020,9900,BB6Z34K7,33300,more than downpayment,more than downpayment,0,3900
BBN4D4HT,9900,1/30/2020,9900,,9900,equal to downpayment,,9900,0
bc2a64c1,1594,10/14/2019,1594,,1594,equal to downpayment,,1594,0
bc2a64c1,3100,12/9/2019,1594,bc2a64c1,4694,more than downpayment,equal to downpayment,0,3100
bc2a64c1,3100,1/8/2020,1594,bc2a64c1,7794,more than downpayment,more than downpayment,0,3100
bc2a64c1,3100,2/7/2020,1594,bc2a64c1,10894,more than downpayment,more than downpayment,0,3100
bc4cc315,9900,10/15/2019,9900,,9900,equal to downpayment,,9900,0
bc4cc315,3900,12/5/2019,9900,bc4cc315,13800,more than downpayment,equal to downpayment,0,3900
bc4cc315,3900,1/6/2020,9900,bc4cc315,17700,more than downpayment,more than downpayment,0,3900
bc4cc315,3900,2/4/2020,9900,bc4cc315,21600,more than downpayment,more than downpayment,0,3900
bc7de720,9900,1/31/2020,9900,,9900,equal to downpayment,,9900,0
BC9PPAL6,9900,7/11/2019,9900,,9900,equal to downpayment,,9900,0
BC9PPAL6,3900,10/5/2019,9900,BC9PPAL6,13800,more than downpayment,equal to downpayment,0,3900
BC9PPAL6,3900,11/6/2019,9900,BC9PPAL6,17700,more than downpayment,more than downpayment,0,3900
BC9PPAL6,3900,12/8/2019,9900,BC9PPAL6,21600,more than downpayment,more than downpayment,0,3900
BC9PPAL6,3900,1/8/2020,9900,BC9PPAL6,25500,more than downpayment,more than downpayment,0,3900
bcb2b11f,8900,11/18/2019,8900,,8900,equal to downpayment,,8900,0
bcb2b11f,3900,1/23/2020,8900,bcb2b11f,12800,more than downpayment,equal to downpayment,0,3900
BCDMYYQQ,8900,7/25/2019,8900,,8900,equal to downpayment,,8900,0
BCDMYYQQ,3900,8/26/2019,8900,BCDMYYQQ,12800,more than downpayment,equal to downpayment,0,3900
BCDMYYQQ,3900,10/4/2019,8900,BCDMYYQQ,16700,more than downpayment,more than downpayment,0,3900
BCDMYYQQ,3900,11/4/2019,8900,BCDMYYQQ,20600,more than downpayment,more than downpayment,0,3900
BCDMYYQQ,3900,11/30/2019,8900,BCDMYYQQ,24500,more than downpayment,more than downpayment,0,3900
BCDMYYQQ,3900,12/24/2019,8900,BCDMYYQQ,28400,more than downpayment,more than downpayment,0,3900
BCDMYYQQ,3900,1/29/2020,8900,BCDMYYQQ,32300,more than downpayment,more than downpayment,0,3900
bCsTxWPT,9900,7/29/2019,9900,,9900,equal to downpayment,,9900,0
bCsTxWPT,5000,8/15/2019,9900,bCsTxWPT,14900,more than downpayment,equal to downpayment,0,5000
bCsTxWPT,5000,9/14/2019,9900,bCsTxWPT,19900,more than downpayment,more than downpayment,0,5000
bCsTxWPT,5000,10/14/2019,9900,bCsTxWPT,24900,more than downpayment,more than downpayment,0,5000
bCsTxWPT,5000,11/13/2019,9900,bCsTxWPT,29900,more than downpayment,more than downpayment,0,5000
bCsTxWPT,5000,12/13/2019,9900,bCsTxWPT,34900,more than downpayment,more than downpayment,0,5000
bCsTxWPT,5000,12/20/2019,9900,bCsTxWPT,39900,more than downpayment,more than downpayment,0,5000
bCsTxWPT,5000,1/14/2020,9900,bCsTxWPT,44900,more than downpayment,more than downpayment,0,5000
Bd8CRp9D,15000,12/13/2018,9900,,15000,more than downpayment,,9900,5100
Bd8CRp9D,9000,2/18/2019,9900,Bd8CRp9D,24000,more than downpayment,more than downpayment,0,9000
Bd8CRp9D,9000,3/12/2019,9900,Bd8CRp9D,33000,more than downpayment,more than downpayment,0,9000
Bd8CRp9D,8000,4/27/2019,9900,Bd8CRp9D,41000,more than downpayment,more than downpayment,0,8000
Bd8CRp9D,4500,5/24/2019,9900,Bd8CRp9D,45500,more than downpayment,more than downpayment,0,4500
Bd8CRp9D,4500,6/23/2019,9900,Bd8CRp9D,50000,more than downpayment,more than downpayment,0,4500
Bd8CRp9D,9000,7/13/2019,9900,Bd8CRp9D,59000,more than downpayment,more than downpayment,0,9000
Bd8CRp9D,9000,8/22/2019,9900,Bd8CRp9D,68000,more than downpayment,more than downpayment,0,9000
bDjDF8Ic,8900,5/9/2019,8900,,8900,equal to downpayment,,8900,0
be5f8735,9900,11/4/2019,9900,,9900,equal to downpayment,,9900,0
be5f8735,2300,12/5/2019,9900,be5f8735,12200,more than downpayment,equal to downpayment,0,2300
be5f8735,2000,1/1/2020,9900,be5f8735,14200,more than downpayment,more than downpayment,0,2000
be5f8735,3900,2/6/2020,9900,be5f8735,18100,more than downpayment,more than downpayment,0,3900
be5f8a9f,5000,9/19/2019,8900,,5000,less than downpayment,,5000,0
be5f8a9f,3900,9/23/2019,8900,be5f8a9f,8900,equal to downpayment,less than downpayment,3900,0
be5f8a9f,4000,12/1/2019,8900,be5f8a9f,12900,more than downpayment,equal to downpayment,0,4000
be5f8a9f,4000,1/6/2020,8900,be5f8a9f,16900,more than downpayment,more than downpayment,0,4000
be5f8a9f,5000,2/5/2020,8900,be5f8a9f,21900,more than downpayment,more than downpayment,0,5000
BehIzx0E,9900,6/8/2019,8900,,9900,more than downpayment,,8900,1000
BehIzx0E,3900,7/23/2019,8900,BehIzx0E,13800,more than downpayment,more than downpayment,0,3900
BehIzx0E,3900,8/22/2019,8900,BehIzx0E,17700,more than downpayment,more than downpayment,0,3900
BehIzx0E,3900,9/23/2019,8900,BehIzx0E,21600,more than downpayment,more than downpayment,0,3900
BehIzx0E,3900,10/23/2019,8900,BehIzx0E,25500,more than downpayment,more than downpayment,0,3900
BehIzx0E,3900,11/25/2019,8900,BehIzx0E,29400,more than downpayment,more than downpayment,0,3900
BehIzx0E,3900,12/23/2019,8900,BehIzx0E,33300,more than downpayment,more than downpayment,0,3900
BehIzx0E,3900,1/24/2020,8900,BehIzx0E,37200,more than downpayment,more than downpayment,0,3900
BEX9X6OQ,9000,12/5/2019,9900,,9000,less than downpayment,,9000,0
BEX9X6OQ,900,12/10/2019,9900,BEX9X6OQ,9900,equal to downpayment,less than downpayment,900,0
BEX9X6OQ,4900,2/8/2020,9900,BEX9X6OQ,14800,more than downpayment,equal to downpayment,0,4900
bf3fb685,9900,12/16/2019,9900,,9900,equal to downpayment,,9900,0
bf5da246,9900,11/9/2019,9900,,9900,equal to downpayment,,9900,0
bf78bb0e,5000,12/13/2019,8900,,5000,less than downpayment,,5000,0
bf78bb0e,3900,1/6/2020,8900,bf78bb0e,8900,equal to downpayment,less than downpayment,3900,0
BFIFAPVC,9900,11/4/2019,9900,,9900,equal to downpayment,,9900,0
BFIFAPVC,3900,12/4/2019,9900,BFIFAPVC,13800,more than downpayment,equal to downpayment,0,3900
BFIFAPVC,3900,1/4/2020,9900,BFIFAPVC,17700,more than downpayment,more than downpayment,0,3900
BFIFAPVC,3900,2/4/2020,9900,BFIFAPVC,21600,more than downpayment,more than downpayment,0,3900
bFP285nT,8900,1/17/2019,8900,,8900,equal to downpayment,,8900,0
BGUCECQF,9900,1/25/2020,9900,,9900,equal to downpayment,,9900,0
bH3IXXES,8900,3/11/2019,8900,,8900,equal to downpayment,,8900,0
bH3IXXES,3900,4/20/2019,8900,bH3IXXES,12800,more than downpayment,equal to downpayment,0,3900
bH3IXXES,3900,5/20/2019,8900,bH3IXXES,16700,more than downpayment,more than downpayment,0,3900
bH3IXXES,3900,6/20/2019,8900,bH3IXXES,20600,more than downpayment,more than downpayment,0,3900
bH3IXXES,3900,7/20/2019,8900,bH3IXXES,24500,more than downpayment,more than downpayment,0,3900
bH3IXXES,3900,8/20/2019,8900,bH3IXXES,28400,more than downpayment,more than downpayment,0,3900
bH3IXXES,3900,9/20/2019,8900,bH3IXXES,32300,more than downpayment,more than downpayment,0,3900
bH3IXXES,3900,10/20/2019,8900,bH3IXXES,36200,more than downpayment,more than downpayment,0,3900
bH3IXXES,3900,11/18/2019,8900,bH3IXXES,40100,more than downpayment,more than downpayment,0,3900
bH3IXXES,3900,12/20/2019,8900,bH3IXXES,44000,more than downpayment,more than downpayment,0,3900
bH3IXXES,3900,1/20/2020,8900,bH3IXXES,47900,more than downpayment,more than downpayment,0,3900
bhBOHzNy,8900,5/1/2019,8900,,8900,equal to downpayment,,8900,0
bhBOHzNy,3900,6/3/2019,8900,bhBOHzNy,12800,more than downpayment,equal to downpayment,0,3900
bhBOHzNy,3900,7/4/2019,8900,bhBOHzNy,16700,more than downpayment,more than downpayment,0,3900
bhBOHzNy,3900,9/6/2019,8900,bhBOHzNy,20600,more than downpayment,more than downpayment,0,3900
bhBOHzNy,7800,11/23/2019,8900,bhBOHzNy,28400,more than downpayment,more than downpayment,0,7800
bhBOHzNy,3900,1/27/2020,8900,bhBOHzNy,32300,more than downpayment,more than downpayment,0,3900
bhBOHzNy,3900,2/4/2020,8900,bhBOHzNy,36200,more than downpayment,more than downpayment,0,3900
bhOKdUIX,8900,1/30/2019,8900,,8900,equal to downpayment,,8900,0
bhOKdUIX,3900,3/5/2019,8900,bhOKdUIX,12800,more than downpayment,equal to downpayment,0,3900
bhOKdUIX,3900,4/9/2019,8900,bhOKdUIX,16700,more than downpayment,more than downpayment,0,3900
bhOKdUIX,3900,5/7/2019,8900,bhOKdUIX,20600,more than downpayment,more than downpayment,0,3900
bhOKdUIX,3900,6/10/2019,8900,bhOKdUIX,24500,more than downpayment,more than downpayment,0,3900
bhOKdUIX,3900,10/4/2019,8900,bhOKdUIX,28400,more than downpayment,more than downpayment,0,3900
bhOKdUIX,1000,10/16/2019,8900,bhOKdUIX,29400,more than downpayment,more than downpayment,0,1000
bhOKdUIX,1000,10/18/2019,8900,bhOKdUIX,30400,more than downpayment,more than downpayment,0,1000
bhOKdUIX,4500,10/29/2019,8900,bhOKdUIX,34900,more than downpayment,more than downpayment,0,4500
bhOKdUIX,1300,11/10/2019,8900,bhOKdUIX,36200,more than downpayment,more than downpayment,0,1300
bhOKdUIX,1000,11/18/2019,8900,bhOKdUIX,37200,more than downpayment,more than downpayment,0,1000
bhOKdUIX,1000,11/21/2019,8900,bhOKdUIX,38200,more than downpayment,more than downpayment,0,1000
bhOKdUIX,1000,11/23/2019,8900,bhOKdUIX,39200,more than downpayment,more than downpayment,0,1000
bhOKdUIX,1000,11/26/2019,8900,bhOKdUIX,40200,more than downpayment,more than downpayment,0,1000
bhOKdUIX,7800,1/9/2020,8900,bhOKdUIX,48000,more than downpayment,more than downpayment,0,7800
bhOKdUIX,2000,1/30/2020,8900,bhOKdUIX,50000,more than downpayment,more than downpayment,0,2000
bhOKdUIX,1900,2/3/2020,8900,bhOKdUIX,51900,more than downpayment,more than downpayment,0,1900
BHxGYdmO,4000,8/30/2019,9900,,4000,less than downpayment,,4000,0
BHxGYdmO,3100,9/1/2019,9900,BHxGYdmO,7100,less than downpayment,less than downpayment,3100,0
BHxGYdmO,2800,9/3/2019,9900,BHxGYdmO,9900,equal to downpayment,less than downpayment,2800,0
BHxGYdmO,3900,11/3/2019,9900,BHxGYdmO,13800,more than downpayment,equal to downpayment,0,3900
BHxGYdmO,3900,12/5/2019,9900,BHxGYdmO,17700,more than downpayment,more than downpayment,0,3900
BHxGYdmO,1500,1/7/2020,9900,BHxGYdmO,19200,more than downpayment,more than downpayment,0,1500
BHxGYdmO,2400,1/10/2020,9900,BHxGYdmO,21600,more than downpayment,more than downpayment,0,2400
BHxGYdmO,3900,2/5/2020,9900,BHxGYdmO,25500,more than downpayment,more than downpayment,0,3900
BI4Z8GLj,10000,9/26/2017,10000,,10000,equal to downpayment,,10000,0
BI4Z8GLj,5000,11/6/2017,10000,BI4Z8GLj,15000,more than downpayment,equal to downpayment,0,5000
BI4Z8GLj,5000,12/20/2017,10000,BI4Z8GLj,20000,more than downpayment,more than downpayment,0,5000
BI4Z8GLj,5000,1/20/2018,10000,BI4Z8GLj,25000,more than downpayment,more than downpayment,0,5000
BI4Z8GLj,5000,2/27/2018,10000,BI4Z8GLj,30000,more than downpayment,more than downpayment,0,5000
BI4Z8GLj,3000,3/30/2018,10000,BI4Z8GLj,33000,more than downpayment,more than downpayment,0,3000
BI4Z8GLj,5000,5/27/2018,10000,BI4Z8GLj,38000,more than downpayment,more than downpayment,0,5000
BI4Z8GLj,5000,7/18/2018,10000,BI4Z8GLj,43000,more than downpayment,more than downpayment,0,5000
BI4Z8GLj,2000,9/22/2018,10000,BI4Z8GLj,45000,more than downpayment,more than downpayment,0,2000
BIFJXCOL,9900,10/24/2019,9900,,9900,equal to downpayment,,9900,0
BIFJXCOL,7800,12/4/2019,9900,BIFJXCOL,17700,more than downpayment,equal to downpayment,0,7800
BIFJXCOL,3900,1/13/2020,9900,BIFJXCOL,21600,more than downpayment,more than downpayment,0,3900
BIGJC4IF,9900,10/23/2019,9900,,9900,equal to downpayment,,9900,0
BIGJC4IF,3900,12/10/2019,9900,BIGJC4IF,13800,more than downpayment,equal to downpayment,0,3900
BIGJC4IF,3900,1/10/2020,9900,BIGJC4IF,17700,more than downpayment,more than downpayment,0,3900
BIUVMIqG,9900,7/1/2019,9900,,9900,equal to downpayment,,9900,0
BIyO85YP,9900,1/31/2019,9900,,9900,equal to downpayment,,9900,0
BIyO85YP,4500,4/24/2019,9900,BIyO85YP,14400,more than downpayment,equal to downpayment,0,4500
BIyO85YP,4500,5/24/2019,9900,BIyO85YP,18900,more than downpayment,more than downpayment,0,4500
BIyO85YP,4500,6/24/2019,9900,BIyO85YP,23400,more than downpayment,more than downpayment,0,4500
BIyO85YP,4500,7/24/2019,9900,BIyO85YP,27900,more than downpayment,more than downpayment,0,4500
BIyO85YP,4500,8/24/2019,9900,BIyO85YP,32400,more than downpayment,more than downpayment,0,4500
BIyO85YP,4500,9/25/2019,9900,BIyO85YP,36900,more than downpayment,more than downpayment,0,4500
BIyO85YP,500,10/26/2019,9900,BIyO85YP,37400,more than downpayment,more than downpayment,0,500
BIyO85YP,4000,11/1/2019,9900,BIyO85YP,41400,more than downpayment,more than downpayment,0,4000
BIyO85YP,4500,11/25/2019,9900,BIyO85YP,45900,more than downpayment,more than downpayment,0,4500
BIyO85YP,4500,1/24/2020,9900,BIyO85YP,50400,more than downpayment,more than downpayment,0,4500
BIyO85YP,1500,1/26/2020,9900,BIyO85YP,51900,more than downpayment,more than downpayment,0,1500
BJ5CRSQU,9900,11/6/2019,9900,,9900,equal to downpayment,,9900,0
BJ5CRSQU,3900,12/20/2019,9900,BJ5CRSQU,13800,more than downpayment,equal to downpayment,0,3900
BJ5CRSQU,2000,1/27/2020,9900,BJ5CRSQU,15800,more than downpayment,more than downpayment,0,2000
BJ5CRSQU,1900,1/28/2020,9900,BJ5CRSQU,17700,more than downpayment,more than downpayment,0,1900
BJN6914T,9900,6/30/2019,8900,,9900,more than downpayment,,8900,1000
BJN6914T,6000,9/5/2019,8900,BJN6914T,15900,more than downpayment,more than downpayment,0,6000
BJN6914T,1000,10/4/2019,8900,BJN6914T,16900,more than downpayment,more than downpayment,0,1000
BJN6914T,900,10/6/2019,8900,BJN6914T,17800,more than downpayment,more than downpayment,0,900
BJN6914T,3900,11/4/2019,8900,BJN6914T,21700,more than downpayment,more than downpayment,0,3900
BJN6914T,3900,12/4/2019,8900,BJN6914T,25600,more than downpayment,more than downpayment,0,3900
BJN6914T,3900,1/4/2020,8900,BJN6914T,29500,more than downpayment,more than downpayment,0,3900
BJN6914T,3900,2/4/2020,8900,BJN6914T,33400,more than downpayment,more than downpayment,0,3900
BJTGHOZK,9900,11/13/2019,9900,,9900,equal to downpayment,,9900,0
BJTGHOZK,3900,1/30/2020,9900,BJTGHOZK,13800,more than downpayment,equal to downpayment,0,3900
Bk3swZqu,9900,8/1/2019,9900,,9900,equal to downpayment,,9900,0
Bk3swZqu,3900,9/14/2019,9900,Bk3swZqu,13800,more than downpayment,equal to downpayment,0,3900
Bk3swZqu,3900,10/26/2019,9900,Bk3swZqu,17700,more than downpayment,more than downpayment,0,3900
Bk3swZqu,3900,11/23/2019,9900,Bk3swZqu,21600,more than downpayment,more than downpayment,0,3900
Bk3swZqu,3900,12/14/2019,9900,Bk3swZqu,25500,more than downpayment,more than downpayment,0,3900
Bk3swZqu,3900,1/15/2020,9900,Bk3swZqu,29400,more than downpayment,more than downpayment,0,3900
BKFKTRPI,50000,12/4/2019,9900,,50000,more than downpayment,,9900,40100
BKFKTRPI,2900,1/4/2020,9900,BKFKTRPI,52900,more than downpayment,more than downpayment,0,2900
BKFKTRPI,2900,2/3/2020,9900,BKFKTRPI,55800,more than downpayment,more than downpayment,0,2900
BLA6KWUC,9900,8/21/2019,9900,,9900,equal to downpayment,,9900,0
BLA6KWUC,3900,10/22/2019,9900,BLA6KWUC,13800,more than downpayment,equal to downpayment,0,3900
BLA6KWUC,3900,11/30/2019,9900,BLA6KWUC,17700,more than downpayment,more than downpayment,0,3900
BLA6KWUC,2000,12/30/2019,9900,BLA6KWUC,19700,more than downpayment,more than downpayment,0,2000
BLA6KWUC,1500,1/16/2020,9900,BLA6KWUC,21200,more than downpayment,more than downpayment,0,1500
BLA6KWUC,400,1/20/2020,9900,BLA6KWUC,21600,more than downpayment,more than downpayment,0,400
BLA6KWUC,3900,2/6/2020,9900,BLA6KWUC,25500,more than downpayment,more than downpayment,0,3900
BLO2I5I9,8900,5/15/2019,8900,,8900,equal to downpayment,,8900,0
BLO2I5I9,4000,6/17/2019,8900,BLO2I5I9,12900,more than downpayment,equal to downpayment,0,4000
BLO2I5I9,4000,7/13/2019,8900,BLO2I5I9,16900,more than downpayment,more than downpayment,0,4000
BLO2I5I9,4000,8/20/2019,8900,BLO2I5I9,20900,more than downpayment,more than downpayment,0,4000
BLO2I5I9,4000,9/25/2019,8900,BLO2I5I9,24900,more than downpayment,more than downpayment,0,4000
BLO2I5I9,4000,10/26/2019,8900,BLO2I5I9,28900,more than downpayment,more than downpayment,0,4000
BLO2I5I9,3900,12/1/2019,8900,BLO2I5I9,32800,more than downpayment,more than downpayment,0,3900
BLO2I5I9,4000,12/31/2019,8900,BLO2I5I9,36800,more than downpayment,more than downpayment,0,4000
BLO2I5I9,3900,1/27/2020,8900,BLO2I5I9,40700,more than downpayment,more than downpayment,0,3900
BLO2I5I9,1000,2/8/2020,8900,BLO2I5I9,41700,more than downpayment,more than downpayment,0,1000
bmtQAFae,8900,12/9/2018,8900,,8900,equal to downpayment,,8900,0
bmtQAFae,3900,2/1/2019,8900,bmtQAFae,12800,more than downpayment,equal to downpayment,0,3900
bmtQAFae,3900,3/1/2019,8900,bmtQAFae,16700,more than downpayment,more than downpayment,0,3900
bmtQAFae,3900,4/1/2019,8900,bmtQAFae,20600,more than downpayment,more than downpayment,0,3900
bmtQAFae,3900,5/2/2019,8900,bmtQAFae,24500,more than downpayment,more than downpayment,0,3900
bmtQAFae,3900,6/1/2019,8900,bmtQAFae,28400,more than downpayment,more than downpayment,0,3900
bmtQAFae,3900,7/4/2019,8900,bmtQAFae,32300,more than downpayment,more than downpayment,0,3900
bmtQAFae,3900,8/5/2019,8900,bmtQAFae,36200,more than downpayment,more than downpayment,0,3900
bmtQAFae,3900,9/9/2019,8900,bmtQAFae,40100,more than downpayment,more than downpayment,0,3900
bmtQAFae,3900,10/5/2019,8900,bmtQAFae,44000,more than downpayment,more than downpayment,0,3900
bmtQAFae,3900,11/6/2019,8900,bmtQAFae,47900,more than downpayment,more than downpayment,0,3900
bmtQAFae,3900,12/5/2019,8900,bmtQAFae,51800,more than downpayment,more than downpayment,0,3900
bmtQAFae,3900,1/4/2020,8900,bmtQAFae,55700,more than downpayment,more than downpayment,0,3900
bmtQAFae,4900,1/14/2020,8900,bmtQAFae,60600,more than downpayment,more than downpayment,0,4900
bmtQAFae,99,1/15/2020,8900,bmtQAFae,60699,more than downpayment,more than downpayment,0,99
bmtQAFae,2000,2/7/2020,8900,bmtQAFae,62699,more than downpayment,more than downpayment,0,2000
bmVe31Db,9900,6/21/2019,9900,,9900,equal to downpayment,,9900,0
BNC9R1HN,9900,9/12/2019,9900,,9900,equal to downpayment,,9900,0
BNC9R1HN,3900,11/28/2019,9900,BNC9R1HN,13800,more than downpayment,equal to downpayment,0,3900
BNC9R1HN,1250,12/30/2019,9900,BNC9R1HN,15050,more than downpayment,more than downpayment,0,1250
BNC9R1HN,700,1/7/2020,9900,BNC9R1HN,15750,more than downpayment,more than downpayment,0,700
BNC9R1HN,1950,1/16/2020,9900,BNC9R1HN,17700,more than downpayment,more than downpayment,0,1950
BNC9R1HN,3900,1/31/2020,9900,BNC9R1HN,21600,more than downpayment,more than downpayment,0,3900
BNcI7C5m,9900,1/4/2019,8900,,9900,more than downpayment,,8900,1000
BNcI7C5m,2900,2/25/2019,8900,BNcI7C5m,12800,more than downpayment,more than downpayment,0,2900
BNcI7C5m,3900,3/25/2019,8900,BNcI7C5m,16700,more than downpayment,more than downpayment,0,3900
BNcI7C5m,3900,4/25/2019,8900,BNcI7C5m,20600,more than downpayment,more than downpayment,0,3900
BNcI7C5m,3900,5/25/2019,8900,BNcI7C5m,24500,more than downpayment,more than downpayment,0,3900
BNcI7C5m,3900,6/25/2019,8900,BNcI7C5m,28400,more than downpayment,more than downpayment,0,3900
BNcI7C5m,3900,7/25/2019,8900,BNcI7C5m,32300,more than downpayment,more than downpayment,0,3900
BNcI7C5m,3900,8/25/2019,8900,BNcI7C5m,36200,more than downpayment,more than downpayment,0,3900
BNcI7C5m,3900,9/30/2019,8900,BNcI7C5m,40100,more than downpayment,more than downpayment,0,3900
BNcI7C5m,3900,10/31/2019,8900,BNcI7C5m,44000,more than downpayment,more than downpayment,0,3900
BNcI7C5m,3900,11/29/2019,8900,BNcI7C5m,47900,more than downpayment,more than downpayment,0,3900
BNcI7C5m,3900,1/4/2020,8900,BNcI7C5m,51800,more than downpayment,more than downpayment,0,3900
BNcI7C5m,3900,2/4/2020,8900,BNcI7C5m,55700,more than downpayment,more than downpayment,0,3900
BOGBKFAS,9900,12/14/2019,9900,,9900,equal to downpayment,,9900,0
bp7WxlkQ,9900,7/5/2019,9900,,9900,equal to downpayment,,9900,0
bp7WxlkQ,3900,8/5/2019,9900,bp7WxlkQ,13800,more than downpayment,equal to downpayment,0,3900
bp7WxlkQ,3900,9/10/2019,9900,bp7WxlkQ,17700,more than downpayment,more than downpayment,0,3900
bp7WxlkQ,3900,10/8/2019,9900,bp7WxlkQ,21600,more than downpayment,more than downpayment,0,3900
bp7WxlkQ,3900,11/13/2019,9900,bp7WxlkQ,25500,more than downpayment,more than downpayment,0,3900
bp7WxlkQ,3900,12/15/2019,9900,bp7WxlkQ,29400,more than downpayment,more than downpayment,0,3900
bp7WxlkQ,3900,1/23/2020,9900,bp7WxlkQ,33300,more than downpayment,more than downpayment,0,3900
BR4FIT8X,9900,11/28/2019,9900,,9900,equal to downpayment,,9900,0
BR4FIT8X,3900,2/4/2020,9900,BR4FIT8X,13800,more than downpayment,equal to downpayment,0,3900
BS6OIIO4,100,11/19/2019,9900,,100,less than downpayment,,100,0
BS6OIIO4,9900,11/21/2019,9900,BS6OIIO4,10000,more than downpayment,less than downpayment,9800,100
BS6OIIO4,200,12/4/2019,9900,BS6OIIO4,10200,more than downpayment,more than downpayment,0,200
BS6OIIO4,3500,2/3/2020,9900,BS6OIIO4,13700,more than downpayment,more than downpayment,0,3500
BS6OIIO4,100,2/7/2020,9900,BS6OIIO4,13800,more than downpayment,more than downpayment,0,100
BS7OUW9J,8900,11/7/2019,8900,,8900,equal to downpayment,,8900,0
BS7OUW9J,3900,12/14/2019,8900,BS7OUW9J,12800,more than downpayment,equal to downpayment,0,3900
BS7OUW9J,2000,1/21/2020,8900,BS7OUW9J,14800,more than downpayment,more than downpayment,0,2000
BS7OUW9J,1000,1/23/2020,8900,BS7OUW9J,15800,more than downpayment,more than downpayment,0,1000
BS7OUW9J,900,1/24/2020,8900,BS7OUW9J,16700,more than downpayment,more than downpayment,0,900
bSCyr9Ie,10000,8/7/2018,10000,,10000,equal to downpayment,,10000,0
bSCyr9Ie,4500,9/21/2018,10000,bSCyr9Ie,14500,more than downpayment,equal to downpayment,0,4500
bSCyr9Ie,4500,10/29/2018,10000,bSCyr9Ie,19000,more than downpayment,more than downpayment,0,4500
bSCyr9Ie,4500,11/27/2018,10000,bSCyr9Ie,23500,more than downpayment,more than downpayment,0,4500
bSCyr9Ie,4500,1/5/2019,10000,bSCyr9Ie,28000,more than downpayment,more than downpayment,0,4500
bSCyr9Ie,4500,2/9/2019,10000,bSCyr9Ie,32500,more than downpayment,more than downpayment,0,4500
bSCyr9Ie,4500,3/12/2019,10000,bSCyr9Ie,37000,more than downpayment,more than downpayment,0,4500
bSCyr9Ie,6000,4/18/2019,10000,bSCyr9Ie,43000,more than downpayment,more than downpayment,0,6000
bSCyr9Ie,3000,5/7/2019,10000,bSCyr9Ie,46000,more than downpayment,more than downpayment,0,3000
bSCyr9Ie,4500,6/8/2019,10000,bSCyr9Ie,50500,more than downpayment,more than downpayment,0,4500
bSCyr9Ie,4500,7/9/2019,10000,bSCyr9Ie,55000,more than downpayment,more than downpayment,0,4500
bSCyr9Ie,4500,8/8/2019,10000,bSCyr9Ie,59500,more than downpayment,more than downpayment,0,4500
bSCyr9Ie,1000,10/8/2019,10000,bSCyr9Ie,60500,more than downpayment,more than downpayment,0,1000
bSCyr9Ie,500,10/17/2019,10000,bSCyr9Ie,61000,more than downpayment,more than downpayment,0,500
bSCyr9Ie,3000,10/25/2019,10000,bSCyr9Ie,64000,more than downpayment,more than downpayment,0,3000
BSGV26MF,9900,1/26/2020,9900,,9900,equal to downpayment,,9900,0
BsMkdyV6,9900,6/14/2019,9900,,9900,equal to downpayment,,9900,0
BsMkdyV6,2000,9/9/2019,9900,BsMkdyV6,11900,more than downpayment,equal to downpayment,0,2000
BsMkdyV6,1900,9/28/2019,9900,BsMkdyV6,13800,more than downpayment,more than downpayment,0,1900
BsMkdyV6,3900,11/2/2019,9900,BsMkdyV6,17700,more than downpayment,more than downpayment,0,3900
BsMkdyV6,3900,11/29/2019,9900,BsMkdyV6,21600,more than downpayment,more than downpayment,0,3900
BsMkdyV6,3900,1/10/2020,9900,BsMkdyV6,25500,more than downpayment,more than downpayment,0,3900
BsMkdyV6,3900,1/27/2020,9900,BsMkdyV6,29400,more than downpayment,more than downpayment,0,3900
btcUtnqd,8900,5/7/2019,8900,,8900,equal to downpayment,,8900,0
btcUtnqd,3899.96,6/14/2019,8900,btcUtnqd,12799.96,more than downpayment,equal to downpayment,0,3899.96
btcUtnqd,18700,6/20/2019,8900,btcUtnqd,31499.96,more than downpayment,more than downpayment,0,18700
btcUtnqd,820,12/5/2019,8900,btcUtnqd,32319.96,more than downpayment,more than downpayment,0,820
btcUtnqd,3900,1/9/2020,8900,btcUtnqd,36219.96,more than downpayment,more than downpayment,0,3900
btcUtnqd,4000,2/2/2020,8900,btcUtnqd,40219.96,more than downpayment,more than downpayment,0,4000
BTR83MUY,8900,11/22/2019,8900,,8900,equal to downpayment,,8900,0
bUiV8cO1,10000,12/3/2018,10000,,10000,equal to downpayment,,10000,0
bUiV8cO1,4500,12/24/2018,10000,bUiV8cO1,14500,more than downpayment,equal to downpayment,0,4500
bUiV8cO1,4500,2/21/2019,10000,bUiV8cO1,19000,more than downpayment,more than downpayment,0,4500
bUiV8cO1,4000,3/25/2019,10000,bUiV8cO1,23000,more than downpayment,more than downpayment,0,4000
bUiV8cO1,5000,5/3/2019,10000,bUiV8cO1,28000,more than downpayment,more than downpayment,0,5000
bUiV8cO1,800,6/3/2019,10000,bUiV8cO1,28800,more than downpayment,more than downpayment,0,800
bUiV8cO1,1000,6/14/2019,10000,bUiV8cO1,29800,more than downpayment,more than downpayment,0,1000
bUiV8cO1,500,6/15/2019,10000,bUiV8cO1,30300,more than downpayment,more than downpayment,0,500
bUiV8cO1,3000,8/23/2019,10000,bUiV8cO1,33300,more than downpayment,more than downpayment,0,3000
bUJ9WONn,8900,3/16/2019,8900,,8900,equal to downpayment,,8900,0
bUJ9WONn,3900,4/21/2019,8900,bUJ9WONn,12800,more than downpayment,equal to downpayment,0,3900
bUJ9WONn,4000,5/21/2019,8900,bUJ9WONn,16800,more than downpayment,more than downpayment,0,4000
bUJ9WONn,4000,6/27/2019,8900,bUJ9WONn,20800,more than downpayment,more than downpayment,0,4000
bUJ9WONn,3850,7/22/2019,8900,bUJ9WONn,24650,more than downpayment,more than downpayment,0,3850
bUJ9WONn,3900,8/21/2019,8900,bUJ9WONn,28550,more than downpayment,more than downpayment,0,3900
bUJ9WONn,3900,9/27/2019,8900,bUJ9WONn,32450,more than downpayment,more than downpayment,0,3900
bUJ9WONn,3900,10/26/2019,8900,bUJ9WONn,36350,more than downpayment,more than downpayment,0,3900
bUJ9WONn,4000,1/20/2020,8900,bUJ9WONn,40350,more than downpayment,more than downpayment,0,4000
bUJ9WONn,4000,1/27/2020,8900,bUJ9WONn,44350,more than downpayment,more than downpayment,0,4000
BV5VY64O,9900,11/4/2019,9900,,9900,equal to downpayment,,9900,0
BV5VY64O,4500,11/7/2019,9900,BV5VY64O,14400,more than downpayment,equal to downpayment,0,4500
BV5VY64O,2000,12/12/2019,9900,BV5VY64O,16400,more than downpayment,more than downpayment,0,2000
BV5VY64O,1300,1/21/2020,9900,BV5VY64O,17700,more than downpayment,more than downpayment,0,1300
BVEB7BKM,9900,11/23/2019,9900,,9900,equal to downpayment,,9900,0
BVEB7BKM,3900,2/5/2020,9900,BVEB7BKM,13800,more than downpayment,equal to downpayment,0,3900
BVLALFNT,9900,12/27/2019,9900,,9900,equal to downpayment,,9900,0
BVODNKX9,9900,9/28/2019,9900,,9900,equal to downpayment,,9900,0
BVODNKX9,3900,11/8/2019,9900,BVODNKX9,13800,more than downpayment,equal to downpayment,0,3900
BVODNKX9,3900,12/15/2019,9900,BVODNKX9,17700,more than downpayment,more than downpayment,0,3900
BVODNKX9,3900,1/28/2020,9900,BVODNKX9,21600,more than downpayment,more than downpayment,0,3900
BVqzNDYM,10000,12/3/2018,9900,,10000,more than downpayment,,9900,100
BVqzNDYM,4500,1/24/2019,9900,BVqzNDYM,14500,more than downpayment,more than downpayment,0,4500
BVqzNDYM,4500,2/23/2019,9900,BVqzNDYM,19000,more than downpayment,more than downpayment,0,4500
BVqzNDYM,4500,3/23/2019,9900,BVqzNDYM,23500,more than downpayment,more than downpayment,0,4500
BVqzNDYM,4500,4/24/2019,9900,BVqzNDYM,28000,more than downpayment,more than downpayment,0,4500
BVqzNDYM,4500,5/28/2019,9900,BVqzNDYM,32500,more than downpayment,more than downpayment,0,4500
BVqzNDYM,4500,6/24/2019,9900,BVqzNDYM,37000,more than downpayment,more than downpayment,0,4500
BVqzNDYM,4500,7/24/2019,9900,BVqzNDYM,41500,more than downpayment,more than downpayment,0,4500
BVqzNDYM,4500,8/27/2019,9900,BVqzNDYM,46000,more than downpayment,more than downpayment,0,4500
BVqzNDYM,4500,9/23/2019,9900,BVqzNDYM,50500,more than downpayment,more than downpayment,0,4500
BVqzNDYM,4500,11/5/2019,9900,BVqzNDYM,55000,more than downpayment,more than downpayment,0,4500
BVqzNDYM,4500,12/4/2019,9900,BVqzNDYM,59500,more than downpayment,more than downpayment,0,4500
BVqzNDYM,4500,1/6/2020,9900,BVqzNDYM,64000,more than downpayment,more than downpayment,0,4500
BVqzNDYM,4500,2/6/2020,9900,BVqzNDYM,68500,more than downpayment,more than downpayment,0,4500
bwHCWEhb,9900,10/29/2018,9900,,9900,equal to downpayment,,9900,0
bwHCWEhb,4600,12/7/2018,9900,bwHCWEhb,14500,more than downpayment,equal to downpayment,0,4600
bwHCWEhb,5000,1/16/2019,9900,bwHCWEhb,19500,more than downpayment,more than downpayment,0,5000
bwHCWEhb,5000,2/17/2019,9900,bwHCWEhb,24500,more than downpayment,more than downpayment,0,5000
bwHCWEhb,4500,3/17/2019,9900,bwHCWEhb,29000,more than downpayment,more than downpayment,0,4500
bwHCWEhb,4500,4/17/2019,9900,bwHCWEhb,33500,more than downpayment,more than downpayment,0,4500
bwHCWEhb,4500,5/19/2019,9900,bwHCWEhb,38000,more than downpayment,more than downpayment,0,4500
bwHCWEhb,4500,6/23/2019,9900,bwHCWEhb,42500,more than downpayment,more than downpayment,0,4500
bwHCWEhb,4500,7/19/2019,9900,bwHCWEhb,47000,more than downpayment,more than downpayment,0,4500
bwHCWEhb,4500,8/22/2019,9900,bwHCWEhb,51500,more than downpayment,more than downpayment,0,4500
bwHCWEhb,4500,9/25/2019,9900,bwHCWEhb,56000,more than downpayment,more than downpayment,0,4500
bwHCWEhb,4500,10/28/2019,9900,bwHCWEhb,60500,more than downpayment,more than downpayment,0,4500
bwHCWEhb,3400,11/25/2019,9900,bwHCWEhb,63900,more than downpayment,more than downpayment,0,3400
BWRYK94W,9910,10/25/2019,9900,,9910,more than downpayment,,9900,10
BWRYK94W,3900,1/2/2020,9900,BWRYK94W,13810,more than downpayment,more than downpayment,0,3900
BWRYK94W,3900,2/3/2020,9900,BWRYK94W,17710,more than downpayment,more than downpayment,0,3900
bwVaPmBh,10000,9/9/2017,10000,,10000,equal to downpayment,,10000,0
bwVaPmBh,3000,11/5/2017,10000,bwVaPmBh,13000,more than downpayment,equal to downpayment,0,3000
bwVaPmBh,3000,12/4/2017,10000,bwVaPmBh,16000,more than downpayment,more than downpayment,0,3000
bwVaPmBh,3000,1/3/2018,10000,bwVaPmBh,19000,more than downpayment,more than downpayment,0,3000
bwVaPmBh,3000,2/28/2018,10000,bwVaPmBh,22000,more than downpayment,more than downpayment,0,3000
bwVaPmBh,3000,4/4/2018,10000,bwVaPmBh,25000,more than downpayment,more than downpayment,0,3000
bwVaPmBh,3000,5/8/2018,10000,bwVaPmBh,28000,more than downpayment,more than downpayment,0,3000
bwVaPmBh,3000,6/9/2018,10000,bwVaPmBh,31000,more than downpayment,more than downpayment,0,3000
bwVaPmBh,3000,7/7/2018,10000,bwVaPmBh,34000,more than downpayment,more than downpayment,0,3000
bwVaPmBh,14000,8/7/2018,10000,bwVaPmBh,48000,more than downpayment,more than downpayment,0,14000
bwVaPmBh,3000,8/20/2018,10000,bwVaPmBh,51000,more than downpayment,more than downpayment,0,3000
bwVaPmBh,4000,9/8/2018,10000,bwVaPmBh,55000,more than downpayment,more than downpayment,0,4000
bXLZ30Lz,8900,8/29/2019,8900,,8900,equal to downpayment,,8900,0
bXLZ30Lz,3900,11/18/2019,8900,bXLZ30Lz,12800,more than downpayment,equal to downpayment,0,3900
bXLZ30Lz,3900,1/4/2020,8900,bXLZ30Lz,16700,more than downpayment,more than downpayment,0,3900
bXLZ30Lz,3900,1/29/2020,8900,bXLZ30Lz,20600,more than downpayment,more than downpayment,0,3900
BxOkdNs3,10000,3/20/2019,10000,,10000,equal to downpayment,,10000,0
BxOkdNs3,4500,4/18/2019,10000,BxOkdNs3,14500,more than downpayment,equal to downpayment,0,4500
BxOkdNs3,4500,5/24/2019,10000,BxOkdNs3,19000,more than downpayment,more than downpayment,0,4500
BxOkdNs3,4500,6/25/2019,10000,BxOkdNs3,23500,more than downpayment,more than downpayment,0,4500
BxOkdNs3,4500,7/29/2019,10000,BxOkdNs3,28000,more than downpayment,more than downpayment,0,4500
BxOkdNs3,4500,9/9/2019,10000,BxOkdNs3,32500,more than downpayment,more than downpayment,0,4500
BxOkdNs3,4500,10/22/2019,10000,BxOkdNs3,37000,more than downpayment,more than downpayment,0,4500
BxOkdNs3,4500,11/30/2019,10000,BxOkdNs3,41500,more than downpayment,more than downpayment,0,4500
BxOkdNs3,500,12/31/2019,10000,BxOkdNs3,42000,more than downpayment,more than downpayment,0,500
BxOkdNs3,500,1/7/2020,10000,BxOkdNs3,42500,more than downpayment,more than downpayment,0,500
BxOkdNs3,1000,1/21/2020,10000,BxOkdNs3,43500,more than downpayment,more than downpayment,0,1000
byQgM2of,8900,3/4/2019,8900,,8900,equal to downpayment,,8900,0
byQgM2of,3900,4/13/2019,8900,byQgM2of,12800,more than downpayment,equal to downpayment,0,3900
byQgM2of,3900,5/15/2019,8900,byQgM2of,16700,more than downpayment,more than downpayment,0,3900
byQgM2of,3900,6/14/2019,8900,byQgM2of,20600,more than downpayment,more than downpayment,0,3900
byQgM2of,3900,7/25/2019,8900,byQgM2of,24500,more than downpayment,more than downpayment,0,3900
byQgM2of,3900,8/16/2019,8900,byQgM2of,28400,more than downpayment,more than downpayment,0,3900
byQgM2of,3900,10/29/2019,8900,byQgM2of,32300,more than downpayment,more than downpayment,0,3900
byQgM2of,3900,11/29/2019,8900,byQgM2of,36200,more than downpayment,more than downpayment,0,3900
byQgM2of,3900,1/3/2020,8900,byQgM2of,40100,more than downpayment,more than downpayment,0,3900
byQgM2of,3900,1/28/2020,8900,byQgM2of,44000,more than downpayment,more than downpayment,0,3900
bZ27skJ5,9900,11/28/2018,9900,,9900,equal to downpayment,,9900,0
bZ27skJ5,9000,3/26/2019,9900,bZ27skJ5,18900,more than downpayment,equal to downpayment,0,9000
BZM25WXU,8900,9/9/2019,26250,,8900,less than downpayment,,8900,0
BZM25WXU,96100,10/3/2019,26250,BZM25WXU,105000,more than downpayment,less than downpayment,17350,78750
BZQ6CF8Q,10000,9/17/2019,9900,,10000,more than downpayment,,9900,100
BZQ6CF8Q,10000,10/1/2019,9900,BZQ6CF8Q,20000,more than downpayment,more than downpayment,0,10000
BZQ6CF8Q,12000,12/26/2019,9900,BZQ6CF8Q,32000,more than downpayment,more than downpayment,0,12000
BZYDPDE9,8900,1/25/2020,8900,,8900,equal to downpayment,,8900,0
c0376377,4500,11/7/2019,9900,,4500,less than downpayment,,4500,0
c0376377,5400,11/13/2019,9900,c0376377,9900,equal to downpayment,less than downpayment,5400,0
c0376377,3900,1/21/2020,9900,c0376377,13800,more than downpayment,equal to downpayment,0,3900
c12b4f42,1594,10/14/2019,1594,,1594,equal to downpayment,,1594,0
c16459c9,9900,11/18/2019,9900,,9900,equal to downpayment,,9900,0
c16459c9,4000,1/2/2020,9900,c16459c9,13900,more than downpayment,equal to downpayment,0,4000
c16459c9,4000,2/3/2020,9900,c16459c9,17900,more than downpayment,more than downpayment,0,4000
c1874167,8900,1/16/2020,8900,,8900,equal to downpayment,,8900,0
c19b18f8,8900,11/11/2019,8900,,8900,equal to downpayment,,8900,0
c19b18f8,3900,12/16/2019,8900,c19b18f8,12800,more than downpayment,equal to downpayment,0,3900
c19b18f8,4000,1/16/2020,8900,c19b18f8,16800,more than downpayment,more than downpayment,0,4000
c1edc126,9900,10/25/2019,9900,,9900,equal to downpayment,,9900,0
c1edc126,3900,12/3/2019,9900,c1edc126,13800,more than downpayment,equal to downpayment,0,3900
c1edc126,2900,1/9/2020,9900,c1edc126,16700,more than downpayment,more than downpayment,0,2900
c1edc126,1000,1/13/2020,9900,c1edc126,17700,more than downpayment,more than downpayment,0,1000
c1edc126,3900,2/5/2020,9900,c1edc126,21600,more than downpayment,more than downpayment,0,3900
c2300aa6,8900,11/13/2019,8900,,8900,equal to downpayment,,8900,0
c2300aa6,3900,12/14/2019,8900,c2300aa6,12800,more than downpayment,equal to downpayment,0,3900
c2300aa6,3900,2/8/2020,8900,c2300aa6,16700,more than downpayment,more than downpayment,0,3900
c24ebada,9900,1/13/2020,9900,,9900,equal to downpayment,,9900,0
C2rFajCs,6000,5/10/2017,8000,,6000,less than downpayment,,6000,0
C2rFajCs,2000,6/15/2017,8000,C2rFajCs,8000,equal to downpayment,less than downpayment,2000,0
C2rFajCs,2000,7/27/2017,8000,C2rFajCs,10000,more than downpayment,equal to downpayment,0,2000
C2rFajCs,2000,8/23/2017,8000,C2rFajCs,12000,more than downpayment,more than downpayment,0,2000
C2rFajCs,2000,9/20/2017,8000,C2rFajCs,14000,more than downpayment,more than downpayment,0,2000
C2rFajCs,2000,10/2/2017,8000,C2rFajCs,16000,more than downpayment,more than downpayment,0,2000
C2rFajCs,2000,11/3/2017,8000,C2rFajCs,18000,more than downpayment,more than downpayment,0,2000
C2rFajCs,2000,12/11/2017,8000,C2rFajCs,20000,more than downpayment,more than downpayment,0,2000
C2rFajCs,2000,1/12/2018,8000,C2rFajCs,22000,more than downpayment,more than downpayment,0,2000
C2rFajCs,2000,2/18/2018,8000,C2rFajCs,24000,more than downpayment,more than downpayment,0,2000
C2rFajCs,2000,3/12/2018,8000,C2rFajCs,26000,more than downpayment,more than downpayment,0,2000
C2rFajCs,2000,4/18/2018,8000,C2rFajCs,28000,more than downpayment,more than downpayment,0,2000
C2rFajCs,2000,5/24/2018,8000,C2rFajCs,30000,more than downpayment,more than downpayment,0,2000
C2rFajCs,2000,6/27/2018,8000,C2rFajCs,32000,more than downpayment,more than downpayment,0,2000
C2rFajCs,2000,7/24/2018,8000,C2rFajCs,34000,more than downpayment,more than downpayment,0,2000
C2rFajCs,2000,8/21/2018,8000,C2rFajCs,36000,more than downpayment,more than downpayment,0,2000
C2rFajCs,1000,9/22/2018,8000,C2rFajCs,37000,more than downpayment,more than downpayment,0,1000
c3589832,8900,11/27/2019,9900,,8900,less than downpayment,,8900,0
c3589832,10000,1/1/2020,9900,c3589832,18900,more than downpayment,less than downpayment,1000,9000
c3589832,3900,2/5/2020,9900,c3589832,22800,more than downpayment,more than downpayment,0,3900
C35X5D7W,8900,5/28/2019,8900,,8900,equal to downpayment,,8900,0
c3ac0561,200,1/22/2020,8900,,200,less than downpayment,,200,0
c3ac0561,300,1/30/2020,8900,c3ac0561,500,less than downpayment,less than downpayment,300,0
c3ac0561,500,2/8/2020,8900,c3ac0561,1000,less than downpayment,less than downpayment,500,0
C3GoO4c5,10000,11/30/2018,10000,,10000,equal to downpayment,,10000,0
C3GoO4c5,4000,1/9/2019,10000,C3GoO4c5,14000,more than downpayment,equal to downpayment,0,4000
C3GoO4c5,500,1/16/2019,10000,C3GoO4c5,14500,more than downpayment,more than downpayment,0,500
C3GoO4c5,1500,2/12/2019,10000,C3GoO4c5,16000,more than downpayment,more than downpayment,0,1500
C3GoO4c5,2000,2/27/2019,10000,C3GoO4c5,18000,more than downpayment,more than downpayment,0,2000
C3GoO4c5,1000,3/7/2019,10000,C3GoO4c5,19000,more than downpayment,more than downpayment,0,1000
C3GoO4c5,4000,3/10/2019,10000,C3GoO4c5,23000,more than downpayment,more than downpayment,0,4000
C3GoO4c5,500,3/17/2019,10000,C3GoO4c5,23500,more than downpayment,more than downpayment,0,500
C3GoO4c5,500,3/20/2019,10000,C3GoO4c5,24000,more than downpayment,more than downpayment,0,500
C3GoO4c5,500,4/8/2019,10000,C3GoO4c5,24500,more than downpayment,more than downpayment,0,500
C3GoO4c5,2000,4/10/2019,10000,C3GoO4c5,26500,more than downpayment,more than downpayment,0,2000
C3GoO4c5,1500,5/9/2019,10000,C3GoO4c5,28000,more than downpayment,more than downpayment,0,1500
C3GoO4c5,1500,5/25/2019,10000,C3GoO4c5,29500,more than downpayment,more than downpayment,0,1500
C3GoO4c5,1500,5/28/2019,10000,C3GoO4c5,31000,more than downpayment,more than downpayment,0,1500
C3GoO4c5,1000,6/4/2019,10000,C3GoO4c5,32000,more than downpayment,more than downpayment,0,1000
C3GoO4c5,500,6/11/2019,10000,C3GoO4c5,32500,more than downpayment,more than downpayment,0,500
C3GoO4c5,1000,6/28/2019,10000,C3GoO4c5,33500,more than downpayment,more than downpayment,0,1000
C3GoO4c5,600,7/15/2019,10000,C3GoO4c5,34100,more than downpayment,more than downpayment,0,600
C3GoO4c5,2000,8/7/2019,10000,C3GoO4c5,36100,more than downpayment,more than downpayment,0,2000
C3GoO4c5,500,10/9/2019,10000,C3GoO4c5,36600,more than downpayment,more than downpayment,0,500
C3GoO4c5,500,10/10/2019,10000,C3GoO4c5,37100,more than downpayment,more than downpayment,0,500
C3GoO4c5,4000,11/13/2019,10000,C3GoO4c5,41100,more than downpayment,more than downpayment,0,4000
C3GoO4c5,500,11/28/2019,10000,C3GoO4c5,41600,more than downpayment,more than downpayment,0,500
C3GoO4c5,500,12/2/2019,10000,C3GoO4c5,42100,more than downpayment,more than downpayment,0,500
C3GoO4c5,1000,1/3/2020,10000,C3GoO4c5,43100,more than downpayment,more than downpayment,0,1000
c3sq86Ai,20000,5/26/2017,20000,,20000,equal to downpayment,,20000,0
c3sq86Ai,2000,3/12/2018,20000,c3sq86Ai,22000,more than downpayment,equal to downpayment,0,2000
c3sq86Ai,3000,3/13/2018,20000,c3sq86Ai,25000,more than downpayment,more than downpayment,0,3000
c3sq86Ai,4000,3/21/2018,20000,c3sq86Ai,29000,more than downpayment,more than downpayment,0,4000
c3sq86Ai,6000,4/2/2018,20000,c3sq86Ai,35000,more than downpayment,more than downpayment,0,6000
c3sq86Ai,2000,4/23/2018,20000,c3sq86Ai,37000,more than downpayment,more than downpayment,0,2000
c3sq86Ai,3000,4/26/2018,20000,c3sq86Ai,40000,more than downpayment,more than downpayment,0,3000
C47N04y9,9900,6/7/2019,8900,,9900,more than downpayment,,8900,1000
C47N04y9,3900,8/1/2019,8900,C47N04y9,13800,more than downpayment,more than downpayment,0,3900
C47N04y9,3900,9/25/2019,8900,C47N04y9,17700,more than downpayment,more than downpayment,0,3900
C47N04y9,3900,10/26/2019,8900,C47N04y9,21600,more than downpayment,more than downpayment,0,3900
C47N04y9,5000,1/1/2020,8900,C47N04y9,26600,more than downpayment,more than downpayment,0,5000
C47N04y9,3900,1/27/2020,8900,C47N04y9,30500,more than downpayment,more than downpayment,0,3900
c4c24240,8900,10/3/2019,8900,,8900,equal to downpayment,,8900,0
c4c24240,3900,11/4/2019,8900,c4c24240,12800,more than downpayment,equal to downpayment,0,3900
c4c24240,3900,12/6/2019,8900,c4c24240,16700,more than downpayment,more than downpayment,0,3900
c4c24240,3900,1/8/2020,8900,c4c24240,20600,more than downpayment,more than downpayment,0,3900
c4c24240,3900,2/6/2020,8900,c4c24240,24500,more than downpayment,more than downpayment,0,3900
C52L5VNZ,8900,5/24/2019,8900,,8900,equal to downpayment,,8900,0
C52L5VNZ,3900,7/25/2019,8900,C52L5VNZ,12800,more than downpayment,equal to downpayment,0,3900
C52L5VNZ,3900,9/5/2019,8900,C52L5VNZ,16700,more than downpayment,more than downpayment,0,3900
C52L5VNZ,3900,9/9/2019,8900,C52L5VNZ,20600,more than downpayment,more than downpayment,0,3900
C52L5VNZ,15600,1/14/2020,8900,C52L5VNZ,36200,more than downpayment,more than downpayment,0,15600
C52L5VNZ,3900,2/4/2020,8900,C52L5VNZ,40100,more than downpayment,more than downpayment,0,3900
c553cb6c,9900,12/23/2019,9900,,9900,equal to downpayment,,9900,0
c5a59aff,9900,1/3/2020,9900,,9900,equal to downpayment,,9900,0
c5c3f348,9900,11/15/2019,9900,,9900,equal to downpayment,,9900,0
c5c3f348,3900,1/24/2020,9900,c5c3f348,13800,more than downpayment,equal to downpayment,0,3900
C5D55A4K,9900,12/11/2019,9900,,9900,equal to downpayment,,9900,0
c62e9594,9900,2/4/2020,9900,,9900,equal to downpayment,,9900,0
c6f3523c,4000,1/31/2020,9900,,4000,less than downpayment,,4000,0
c6f3523c,500,2/3/2020,9900,c6f3523c,4500,less than downpayment,less than downpayment,500,0
c6f3523c,1000,2/6/2020,9900,c6f3523c,5500,less than downpayment,less than downpayment,1000,0
c6f3523c,1500,2/7/2020,9900,c6f3523c,7000,less than downpayment,less than downpayment,1500,0
c6tAkdav,8900,8/30/2019,8900,,8900,equal to downpayment,,8900,0
c6tAkdav,3900,11/15/2019,8900,c6tAkdav,12800,more than downpayment,equal to downpayment,0,3900
c6tAkdav,3900,12/12/2019,8900,c6tAkdav,16700,more than downpayment,more than downpayment,0,3900
c6tAkdav,3900,1/7/2020,8900,c6tAkdav,20600,more than downpayment,more than downpayment,0,3900
C6VP5yJX,9900,6/8/2019,9900,,9900,equal to downpayment,,9900,0
C6VP5yJX,3900,8/1/2019,9900,C6VP5yJX,13800,more than downpayment,equal to downpayment,0,3900
C6VP5yJX,3900,8/18/2019,9900,C6VP5yJX,17700,more than downpayment,more than downpayment,0,3900
C6VP5yJX,3900,9/26/2019,9900,C6VP5yJX,21600,more than downpayment,more than downpayment,0,3900
C6VP5yJX,3900,10/31/2019,9900,C6VP5yJX,25500,more than downpayment,more than downpayment,0,3900
C6VP5yJX,2000,12/13/2019,9900,C6VP5yJX,27500,more than downpayment,more than downpayment,0,2000
C6VP5yJX,2000,1/1/2020,9900,C6VP5yJX,29500,more than downpayment,more than downpayment,0,2000
C6VP5yJX,3000,1/12/2020,9900,C6VP5yJX,32500,more than downpayment,more than downpayment,0,3000
C6VP5yJX,3900,2/9/2020,9900,C6VP5yJX,36400,more than downpayment,more than downpayment,0,3900
C7QLW9FS,9900,6/14/2019,8900,,9900,more than downpayment,,8900,1000
C7QLW9FS,3900,8/5/2019,8900,C7QLW9FS,13800,more than downpayment,more than downpayment,0,3900
C7QLW9FS,3900,9/5/2019,8900,C7QLW9FS,17700,more than downpayment,more than downpayment,0,3900
C7QLW9FS,3900,10/5/2019,8900,C7QLW9FS,21600,more than downpayment,more than downpayment,0,3900
C7QLW9FS,3900,11/5/2019,8900,C7QLW9FS,25500,more than downpayment,more than downpayment,0,3900
C7QLW9FS,3900,12/5/2019,8900,C7QLW9FS,29400,more than downpayment,more than downpayment,0,3900
C7QLW9FS,3900,1/5/2020,8900,C7QLW9FS,33300,more than downpayment,more than downpayment,0,3900
C7QLW9FS,3900,2/4/2020,8900,C7QLW9FS,37200,more than downpayment,more than downpayment,0,3900
C84iF06F,1710,1/15/2019,8900,,1710,less than downpayment,,1710,0
C84iF06F,6270,1/21/2019,8900,C84iF06F,7980,less than downpayment,less than downpayment,6270,0
C84iF06F,920,1/22/2019,8900,C84iF06F,8900,equal to downpayment,less than downpayment,920,0
C84iF06F,3900,2/25/2019,8900,C84iF06F,12800,more than downpayment,equal to downpayment,0,3900
C84iF06F,3900,4/4/2019,8900,C84iF06F,16700,more than downpayment,more than downpayment,0,3900
C84iF06F,1500,5/15/2019,8900,C84iF06F,18200,more than downpayment,more than downpayment,0,1500
C84iF06F,5000,10/9/2019,8900,C84iF06F,23200,more than downpayment,more than downpayment,0,5000
C84iF06F,3050,10/31/2019,8900,C84iF06F,26250,more than downpayment,more than downpayment,0,3050
C84iF06F,2100,12/8/2019,8900,C84iF06F,28350,more than downpayment,more than downpayment,0,2100
C84iF06F,8000,1/9/2020,8900,C84iF06F,36350,more than downpayment,more than downpayment,0,8000
C84iF06F,3900,1/20/2020,8900,C84iF06F,40250,more than downpayment,more than downpayment,0,3900
c8a12fff,9900,1/29/2020,9900,,9900,equal to downpayment,,9900,0
C8F7EDSQ,1500,12/18/2019,9900,,1500,less than downpayment,,1500,0
C8F7EDSQ,5000,12/23/2019,9900,C8F7EDSQ,6500,less than downpayment,less than downpayment,5000,0
C8F7EDSQ,3400,1/6/2020,9900,C8F7EDSQ,9900,equal to downpayment,less than downpayment,3400,0
c912de66,9900,10/30/2019,9900,,9900,equal to downpayment,,9900,0
c912de66,3900,11/30/2019,9900,c912de66,13800,more than downpayment,equal to downpayment,0,3900
c912de66,3900,12/29/2019,9900,c912de66,17700,more than downpayment,more than downpayment,0,3900
c912de66,3900,1/29/2020,9900,c912de66,21600,more than downpayment,more than downpayment,0,3900
c92407d0,8900,1/29/2020,8900,,8900,equal to downpayment,,8900,0
C92PFP3N,9900,1/10/2020,9900,,9900,equal to downpayment,,9900,0
c944649b,9900,11/30/2019,9900,,9900,equal to downpayment,,9900,0
c944649b,3900,2/7/2020,9900,c944649b,13800,more than downpayment,equal to downpayment,0,3900
c95a5302,9900,9/5/2019,9900,,9900,equal to downpayment,,9900,0
c95a5302,3900,11/4/2019,9900,c95a5302,13800,more than downpayment,equal to downpayment,0,3900
c95a5302,3900,11/28/2019,9900,c95a5302,17700,more than downpayment,more than downpayment,0,3900
c95a5302,3900,12/27/2019,9900,c95a5302,21600,more than downpayment,more than downpayment,0,3900
c95a5302,3900,1/29/2020,9900,c95a5302,25500,more than downpayment,more than downpayment,0,3900
c9a9b5f3,9900,12/24/2019,9900,,9900,equal to downpayment,,9900,0
ca1a5a25,9900,10/16/2019,9900,,9900,equal to downpayment,,9900,0
ca1a5a25,3900,12/4/2019,9900,ca1a5a25,13800,more than downpayment,equal to downpayment,0,3900
ca1a5a25,3900,1/3/2020,9900,ca1a5a25,17700,more than downpayment,more than downpayment,0,3900
ca1a5a25,3900,2/3/2020,9900,ca1a5a25,21600,more than downpayment,more than downpayment,0,3900
ca6720a6,8900,1/30/2020,8900,,8900,equal to downpayment,,8900,0
ca6f0400,5999,10/3/2019,7900,,5999,less than downpayment,,5999,0
ca6f0400,2000,10/6/2019,7900,ca6f0400,7999,more than downpayment,less than downpayment,1901,99
ca6f0400,3100,10/26/2019,7900,ca6f0400,11099,more than downpayment,more than downpayment,0,3100
ca6f0400,3100,11/26/2019,7900,ca6f0400,14199,more than downpayment,more than downpayment,0,3100
ca6f0400,3100,12/21/2019,7900,ca6f0400,17299,more than downpayment,more than downpayment,0,3100
ca6f0400,3100,1/25/2020,7900,ca6f0400,20399,more than downpayment,more than downpayment,0,3100
cad20645,9900,9/28/2019,9900,,9900,equal to downpayment,,9900,0
cad20645,10000,10/26/2019,9900,cad20645,19900,more than downpayment,equal to downpayment,0,10000
cad20645,5000,12/3/2019,9900,cad20645,24900,more than downpayment,more than downpayment,0,5000
cad20645,4000,1/4/2020,9900,cad20645,28900,more than downpayment,more than downpayment,0,4000
cad20645,4000,2/5/2020,9900,cad20645,32900,more than downpayment,more than downpayment,0,4000
cAHOydAi,9900,6/26/2019,9900,,9900,equal to downpayment,,9900,0
cAHOydAi,3900,8/4/2019,9900,cAHOydAi,13800,more than downpayment,equal to downpayment,0,3900
cAHOydAi,3900,9/15/2019,9900,cAHOydAi,17700,more than downpayment,more than downpayment,0,3900
cAHOydAi,3900,10/15/2019,9900,cAHOydAi,21600,more than downpayment,more than downpayment,0,3900
cAHOydAi,3900,11/5/2019,9900,cAHOydAi,25500,more than downpayment,more than downpayment,0,3900
cAHOydAi,6000,1/17/2020,9900,cAHOydAi,31500,more than downpayment,more than downpayment,0,6000
cb855a46,9900,11/25/2019,9900,,9900,equal to downpayment,,9900,0
cb855a46,3900,12/29/2019,9900,cb855a46,13800,more than downpayment,equal to downpayment,0,3900
CB8VVN6S,25000,1/2/2020,9900,,25000,more than downpayment,,9900,15100
cbc23d37,26250,12/20/2019,26250,,26250,equal to downpayment,,26250,0
cbc23d37,26250,1/27/2020,26250,cbc23d37,52500,more than downpayment,equal to downpayment,0,26250
CBO4mbDB,9900,8/15/2019,9900,,9900,equal to downpayment,,9900,0
CBO4mbDB,2000,10/14/2019,9900,CBO4mbDB,11900,more than downpayment,equal to downpayment,0,2000
CBO4mbDB,2000,11/24/2019,9900,CBO4mbDB,13900,more than downpayment,more than downpayment,0,2000
CBO4mbDB,2000,12/10/2019,9900,CBO4mbDB,15900,more than downpayment,more than downpayment,0,2000
ccb572e3,9900,12/17/2019,9900,,9900,equal to downpayment,,9900,0
ccc0c451,23400,10/1/2019,23400,,23400,equal to downpayment,,23400,0
ccc0c451,7300,11/4/2019,23400,ccc0c451,30700,more than downpayment,equal to downpayment,0,7300
ccc0c451,7300,12/3/2019,23400,ccc0c451,38000,more than downpayment,more than downpayment,0,7300
ccc0c451,7300,1/2/2020,23400,ccc0c451,45300,more than downpayment,more than downpayment,0,7300
ccc0c451,7300,2/7/2020,23400,ccc0c451,52600,more than downpayment,more than downpayment,0,7300
cCX3x0Ma,10000,7/29/2019,9900,,10000,more than downpayment,,9900,100
cCX3x0Ma,4000,9/25/2019,9900,cCX3x0Ma,14000,more than downpayment,more than downpayment,0,4000
cCX3x0Ma,4000,10/12/2019,9900,cCX3x0Ma,18000,more than downpayment,more than downpayment,0,4000
cCX3x0Ma,4000,11/15/2019,9900,cCX3x0Ma,22000,more than downpayment,more than downpayment,0,4000
cCX3x0Ma,4000,12/20/2019,9900,cCX3x0Ma,26000,more than downpayment,more than downpayment,0,4000
cCX3x0Ma,4000,1/20/2020,9900,cCX3x0Ma,30000,more than downpayment,more than downpayment,0,4000
cd5e1b05,9900,1/28/2020,9900,,9900,equal to downpayment,,9900,0
cd64bb2f,8900,1/6/2020,8900,,8900,equal to downpayment,,8900,0
cd64bb2f,5000,2/4/2020,8900,cd64bb2f,13900,more than downpayment,equal to downpayment,0,5000
cdae9dc7,9900,11/13/2019,9900,,9900,equal to downpayment,,9900,0
cdae9dc7,3900,1/16/2020,9900,cdae9dc7,13800,more than downpayment,equal to downpayment,0,3900
CDOUWfVi,8900,5/29/2019,8900,,8900,equal to downpayment,,8900,0
CDOUWfVi,3900,7/17/2019,8900,CDOUWfVi,12800,more than downpayment,equal to downpayment,0,3900
CDOUWfVi,3900,8/31/2019,8900,CDOUWfVi,16700,more than downpayment,more than downpayment,0,3900
CDOUWfVi,3900,10/1/2019,8900,CDOUWfVi,20600,more than downpayment,more than downpayment,0,3900
CDOUWfVi,3900,11/4/2019,8900,CDOUWfVi,24500,more than downpayment,more than downpayment,0,3900
CDOUWfVi,7800,12/20/2019,8900,CDOUWfVi,32300,more than downpayment,more than downpayment,0,7800
CDOUWfVi,3900,1/30/2020,8900,CDOUWfVi,36200,more than downpayment,more than downpayment,0,3900
cdpq2B1J,8900,4/12/2019,8900,,8900,equal to downpayment,,8900,0
cdpq2B1J,3900,4/14/2019,8900,cdpq2B1J,12800,more than downpayment,equal to downpayment,0,3900
cdpq2B1J,3900,7/13/2019,8900,cdpq2B1J,16700,more than downpayment,more than downpayment,0,3900
cdpq2B1J,3900,7/27/2019,8900,cdpq2B1J,20600,more than downpayment,more than downpayment,0,3900
cdpq2B1J,1500,8/31/2019,8900,cdpq2B1J,22100,more than downpayment,more than downpayment,0,1500
cdpq2B1J,1000,9/12/2019,8900,cdpq2B1J,23100,more than downpayment,more than downpayment,0,1000
cdpq2B1J,2000,9/16/2019,8900,cdpq2B1J,25100,more than downpayment,more than downpayment,0,2000
cdpq2B1J,3400,9/24/2019,8900,cdpq2B1J,28500,more than downpayment,more than downpayment,0,3400
cdpq2B1J,3900,10/25/2019,8900,cdpq2B1J,32400,more than downpayment,more than downpayment,0,3900
cdpq2B1J,900,11/25/2019,8900,cdpq2B1J,33300,more than downpayment,more than downpayment,0,900
cdpq2B1J,3000,11/30/2019,8900,cdpq2B1J,36300,more than downpayment,more than downpayment,0,3000
cdpq2B1J,3800,12/30/2019,8900,cdpq2B1J,40100,more than downpayment,more than downpayment,0,3800
cdpq2B1J,3900,1/28/2020,8900,cdpq2B1J,44000,more than downpayment,more than downpayment,0,3900
CE0c6awE,9900,11/2/2018,9900,,9900,equal to downpayment,,9900,0
CE0c6awE,5000,11/27/2018,9900,CE0c6awE,14900,more than downpayment,equal to downpayment,0,5000
CE0c6awE,4500,1/16/2019,9900,CE0c6awE,19400,more than downpayment,more than downpayment,0,4500
CE0c6awE,4500,2/24/2019,9900,CE0c6awE,23900,more than downpayment,more than downpayment,0,4500
CE0c6awE,4500,3/26/2019,9900,CE0c6awE,28400,more than downpayment,more than downpayment,0,4500
CE0c6awE,4500,5/3/2019,9900,CE0c6awE,32900,more than downpayment,more than downpayment,0,4500
CE0c6awE,4500,5/23/2019,9900,CE0c6awE,37400,more than downpayment,more than downpayment,0,4500
CE0c6awE,4500,7/5/2019,9900,CE0c6awE,41900,more than downpayment,more than downpayment,0,4500
CE0c6awE,4500,7/28/2019,9900,CE0c6awE,46400,more than downpayment,more than downpayment,0,4500
CE0c6awE,4500,9/4/2019,9900,CE0c6awE,50900,more than downpayment,more than downpayment,0,4500
CE0c6awE,4500,9/21/2019,9900,CE0c6awE,55400,more than downpayment,more than downpayment,0,4500
CE0c6awE,6500,11/14/2019,9900,CE0c6awE,61900,more than downpayment,more than downpayment,0,6500
CE0c6awE,2000,12/5/2019,9900,CE0c6awE,63900,more than downpayment,more than downpayment,0,2000
ce2225ba,9900,11/29/2019,9900,,9900,equal to downpayment,,9900,0
ce2225ba,3900,1/31/2020,9900,ce2225ba,13800,more than downpayment,equal to downpayment,0,3900
CE2A7XPS,9900,12/29/2019,9900,,9900,equal to downpayment,,9900,0
ceLeFERE,10000,11/7/2018,10000,,10000,equal to downpayment,,10000,0
ceLeFERE,4500,12/29/2018,10000,ceLeFERE,14500,more than downpayment,equal to downpayment,0,4500
ceLeFERE,2500,3/5/2019,10000,ceLeFERE,17000,more than downpayment,more than downpayment,0,2500
ceLeFERE,4500,8/23/2019,10000,ceLeFERE,21500,more than downpayment,more than downpayment,0,4500
ceLeFERE,4500,11/29/2019,10000,ceLeFERE,26000,more than downpayment,more than downpayment,0,4500
ceLeFERE,5000,12/23/2019,10000,ceLeFERE,31000,more than downpayment,more than downpayment,0,5000
CEMOBTZ7,9900,11/29/2019,9900,,9900,equal to downpayment,,9900,0
CEMOBTZ7,3900,2/3/2020,9900,CEMOBTZ7,13800,more than downpayment,equal to downpayment,0,3900
cevht7HZ,9900,6/27/2019,9900,,9900,equal to downpayment,,9900,0
cevht7HZ,3900,8/23/2019,9900,cevht7HZ,13800,more than downpayment,equal to downpayment,0,3900
cevht7HZ,3900,9/7/2019,9900,cevht7HZ,17700,more than downpayment,more than downpayment,0,3900
cevht7HZ,3900,10/10/2019,9900,cevht7HZ,21600,more than downpayment,more than downpayment,0,3900
cevht7HZ,3900,11/7/2019,9900,cevht7HZ,25500,more than downpayment,more than downpayment,0,3900
cevht7HZ,3900,12/5/2019,9900,cevht7HZ,29400,more than downpayment,more than downpayment,0,3900
cevht7HZ,3900,1/21/2020,9900,cevht7HZ,33300,more than downpayment,more than downpayment,0,3900
CF7KOSLS,9900,9/18/2019,9900,,9900,equal to downpayment,,9900,0
CF7KOSLS,3900,12/27/2019,9900,CF7KOSLS,13800,more than downpayment,equal to downpayment,0,3900
CF7KOSLS,3900,2/3/2020,9900,CF7KOSLS,17700,more than downpayment,more than downpayment,0,3900
cfeKTOdg,8900,5/6/2019,8900,,8900,equal to downpayment,,8900,0
cfeKTOdg,3900,6/17/2019,8900,cfeKTOdg,12800,more than downpayment,equal to downpayment,0,3900
cfeKTOdg,3900,7/26/2019,8900,cfeKTOdg,16700,more than downpayment,more than downpayment,0,3900
cfeKTOdg,3900,8/16/2019,8900,cfeKTOdg,20600,more than downpayment,more than downpayment,0,3900
cfeKTOdg,3900,9/17/2019,8900,cfeKTOdg,24500,more than downpayment,more than downpayment,0,3900
cfeKTOdg,4000,10/18/2019,8900,cfeKTOdg,28500,more than downpayment,more than downpayment,0,4000
cfeKTOdg,4000,12/1/2019,8900,cfeKTOdg,32500,more than downpayment,more than downpayment,0,4000
cfeKTOdg,4000,12/30/2019,8900,cfeKTOdg,36500,more than downpayment,more than downpayment,0,4000
cfeKTOdg,4000,1/16/2020,8900,cfeKTOdg,40500,more than downpayment,more than downpayment,0,4000
CFKDYDHR,9900,1/1/2020,9900,,9900,equal to downpayment,,9900,0
CFL7DYEO,9900,1/1/2020,9900,,9900,equal to downpayment,,9900,0
CFUUq1x6,9900,7/8/2019,9900,,9900,equal to downpayment,,9900,0
CFUUq1x6,2250,9/13/2019,9900,CFUUq1x6,12150,more than downpayment,equal to downpayment,0,2250
CFUUq1x6,1700,9/24/2019,9900,CFUUq1x6,13850,more than downpayment,more than downpayment,0,1700
CFUUq1x6,4000,12/24/2019,9900,CFUUq1x6,17850,more than downpayment,more than downpayment,0,4000
CFUUq1x6,2000,12/29/2019,9900,CFUUq1x6,19850,more than downpayment,more than downpayment,0,2000
CFUUq1x6,4000,2/3/2020,9900,CFUUq1x6,23850,more than downpayment,more than downpayment,0,4000
CgF1hVAJ,8900,4/1/2019,8900,,8900,equal to downpayment,,8900,0
CgF1hVAJ,3900,5/3/2019,8900,CgF1hVAJ,12800,more than downpayment,equal to downpayment,0,3900
CgF1hVAJ,3900,6/1/2019,8900,CgF1hVAJ,16700,more than downpayment,more than downpayment,0,3900
CgF1hVAJ,7800,8/2/2019,8900,CgF1hVAJ,24500,more than downpayment,more than downpayment,0,7800
CgF1hVAJ,3900,9/2/2019,8900,CgF1hVAJ,28400,more than downpayment,more than downpayment,0,3900
CgF1hVAJ,3900,10/5/2019,8900,CgF1hVAJ,32300,more than downpayment,more than downpayment,0,3900
CgF1hVAJ,3900,11/2/2019,8900,CgF1hVAJ,36200,more than downpayment,more than downpayment,0,3900
CgF1hVAJ,3900,12/3/2019,8900,CgF1hVAJ,40100,more than downpayment,more than downpayment,0,3900
CgF1hVAJ,3900,12/30/2019,8900,CgF1hVAJ,44000,more than downpayment,more than downpayment,0,3900
CgF1hVAJ,3900,2/5/2020,8900,CgF1hVAJ,47900,more than downpayment,more than downpayment,0,3900
CGkHAkma,9900,6/10/2019,8900,,9900,more than downpayment,,8900,1000
CGkHAkma,3900,7/26/2019,8900,CGkHAkma,13800,more than downpayment,more than downpayment,0,3900
CGkHAkma,3900,8/26/2019,8900,CGkHAkma,17700,more than downpayment,more than downpayment,0,3900
CGkHAkma,3900,9/26/2019,8900,CGkHAkma,21600,more than downpayment,more than downpayment,0,3900
CGkHAkma,3900,12/30/2019,8900,CGkHAkma,25500,more than downpayment,more than downpayment,0,3900
CGkHAkma,3900,1/29/2020,8900,CGkHAkma,29400,more than downpayment,more than downpayment,0,3900
CGUQT835,10000,9/10/2019,8900,,10000,more than downpayment,,8900,1100
CGUQT835,10000,12/17/2019,8900,CGUQT835,20000,more than downpayment,more than downpayment,0,10000
CGUQT835,4000,12/24/2019,8900,CGUQT835,24000,more than downpayment,more than downpayment,0,4000
CGXlZIC8,10000,2/20/2019,8900,,10000,more than downpayment,,8900,1100
CGXlZIC8,3900,4/10/2019,8900,CGXlZIC8,13900,more than downpayment,more than downpayment,0,3900
CGXlZIC8,3900,5/16/2019,8900,CGXlZIC8,17800,more than downpayment,more than downpayment,0,3900
CGXlZIC8,3900,6/28/2019,8900,CGXlZIC8,21700,more than downpayment,more than downpayment,0,3900
CGXlZIC8,3900,7/12/2019,8900,CGXlZIC8,25600,more than downpayment,more than downpayment,0,3900
CGXlZIC8,3900,9/5/2019,8900,CGXlZIC8,29500,more than downpayment,more than downpayment,0,3900
CGXlZIC8,3900,10/1/2019,8900,CGXlZIC8,33400,more than downpayment,more than downpayment,0,3900
CGXlZIC8,7800,11/11/2019,8900,CGXlZIC8,41200,more than downpayment,more than downpayment,0,7800
CGXlZIC8,3900,12/31/2019,8900,CGXlZIC8,45100,more than downpayment,more than downpayment,0,3900
CGXlZIC8,3900,1/31/2020,8900,CGXlZIC8,49000,more than downpayment,more than downpayment,0,3900
CHEK4ADE,9900,2/6/2020,9900,,9900,equal to downpayment,,9900,0
CHO1TDAA,34000,1/8/2020,8900,,34000,more than downpayment,,8900,25100
CI1IPMFD,8900,9/3/2019,8900,,8900,equal to downpayment,,8900,0
CI1IPMFD,5000,10/22/2019,8900,CI1IPMFD,13900,more than downpayment,equal to downpayment,0,5000
CI1IPMFD,4000,11/19/2019,8900,CI1IPMFD,17900,more than downpayment,more than downpayment,0,4000
CI1IPMFD,4000,12/17/2019,8900,CI1IPMFD,21900,more than downpayment,more than downpayment,0,4000
CI1IPMFD,4000,1/22/2020,8900,CI1IPMFD,25900,more than downpayment,more than downpayment,0,4000
CIe8cKrB,10000,9/11/2018,10000,,10000,equal to downpayment,,10000,0
CIe8cKrB,4500,10/10/2018,10000,CIe8cKrB,14500,more than downpayment,equal to downpayment,0,4500
CIe8cKrB,4500,11/4/2018,10000,CIe8cKrB,19000,more than downpayment,more than downpayment,0,4500
CIe8cKrB,4500,12/5/2018,10000,CIe8cKrB,23500,more than downpayment,more than downpayment,0,4500
CIe8cKrB,4500,1/1/2019,10000,CIe8cKrB,28000,more than downpayment,more than downpayment,0,4500
CIe8cKrB,4500,2/3/2019,10000,CIe8cKrB,32500,more than downpayment,more than downpayment,0,4500
CIe8cKrB,4500,3/5/2019,10000,CIe8cKrB,37000,more than downpayment,more than downpayment,0,4500
CIe8cKrB,4500,4/5/2019,10000,CIe8cKrB,41500,more than downpayment,more than downpayment,0,4500
CIe8cKrB,4500,5/8/2019,10000,CIe8cKrB,46000,more than downpayment,more than downpayment,0,4500
CIe8cKrB,4500,6/10/2019,10000,CIe8cKrB,50500,more than downpayment,more than downpayment,0,4500
CIe8cKrB,4500,7/12/2019,10000,CIe8cKrB,55000,more than downpayment,more than downpayment,0,4500
CIe8cKrB,4500,8/8/2019,10000,CIe8cKrB,59500,more than downpayment,more than downpayment,0,4500
CIe8cKrB,4500,9/5/2019,10000,CIe8cKrB,64000,more than downpayment,more than downpayment,0,4500
CIRAJmYT,9900,7/1/2019,9900,,9900,equal to downpayment,,9900,0
CIRAJmYT,3900,8/27/2019,9900,CIRAJmYT,13800,more than downpayment,equal to downpayment,0,3900
CIRAJmYT,3900,9/26/2019,9900,CIRAJmYT,17700,more than downpayment,more than downpayment,0,3900
CIRAJmYT,3900,10/28/2019,9900,CIRAJmYT,21600,more than downpayment,more than downpayment,0,3900
CIRAJmYT,3900,11/26/2019,9900,CIRAJmYT,25500,more than downpayment,more than downpayment,0,3900
CIRAJmYT,3900,12/30/2019,9900,CIRAJmYT,29400,more than downpayment,more than downpayment,0,3900
CIRAJmYT,3900,1/29/2020,9900,CIRAJmYT,33300,more than downpayment,more than downpayment,0,3900
CIW5OW73,15000,11/20/2019,9900,,15000,more than downpayment,,9900,5100
CIW5OW73,3900,2/3/2020,9900,CIW5OW73,18900,more than downpayment,more than downpayment,0,3900
CJ1OJ5AE,9900,12/20/2019,9900,,9900,equal to downpayment,,9900,0
cJborP6f,8900,4/10/2019,8900,,8900,equal to downpayment,,8900,0
cJborP6f,12000,5/6/2019,8900,cJborP6f,20900,more than downpayment,equal to downpayment,0,12000
cJborP6f,20000,6/30/2019,8900,cJborP6f,40900,more than downpayment,more than downpayment,0,20000
cJborP6f,10000,8/20/2019,8900,cJborP6f,50900,more than downpayment,more than downpayment,0,10000
cJborP6f,5000,9/24/2019,8900,cJborP6f,55900,more than downpayment,more than downpayment,0,5000
cJborP6f,4000,11/25/2019,8900,cJborP6f,59900,more than downpayment,more than downpayment,0,4000
CK0huPqx,25465,3/10/2019,8900,,25465,more than downpayment,,8900,16565
CK0huPqx,3900,4/24/2019,8900,CK0huPqx,29365,more than downpayment,more than downpayment,0,3900
CK0huPqx,3900,5/24/2019,8900,CK0huPqx,33265,more than downpayment,more than downpayment,0,3900
CK0huPqx,3900,6/26/2019,8900,CK0huPqx,37165,more than downpayment,more than downpayment,0,3900
CK0huPqx,3900,7/25/2019,8900,CK0huPqx,41065,more than downpayment,more than downpayment,0,3900
CK0huPqx,3900,8/25/2019,8900,CK0huPqx,44965,more than downpayment,more than downpayment,0,3900
CK0huPqx,3900,9/25/2019,8900,CK0huPqx,48865,more than downpayment,more than downpayment,0,3900
CK0huPqx,3900,10/27/2019,8900,CK0huPqx,52765,more than downpayment,more than downpayment,0,3900
CK0huPqx,3900,11/29/2019,8900,CK0huPqx,56665,more than downpayment,more than downpayment,0,3900
CK0huPqx,3900,12/29/2019,8900,CK0huPqx,60565,more than downpayment,more than downpayment,0,3900
CK0huPqx,3900,1/29/2020,8900,CK0huPqx,64465,more than downpayment,more than downpayment,0,3900
cKJP3n1Z,8900,3/6/2019,8900,,8900,equal to downpayment,,8900,0
ckwGEZQy,10000,6/10/2019,8900,,10000,more than downpayment,,8900,1100
ckwGEZQy,5000,7/30/2019,8900,ckwGEZQy,15000,more than downpayment,more than downpayment,0,5000
ckwGEZQy,4000,9/3/2019,8900,ckwGEZQy,19000,more than downpayment,more than downpayment,0,4000
ckwGEZQy,4000,9/29/2019,8900,ckwGEZQy,23000,more than downpayment,more than downpayment,0,4000
ckwGEZQy,5000,10/30/2019,8900,ckwGEZQy,28000,more than downpayment,more than downpayment,0,5000
ckwGEZQy,4000,12/1/2019,8900,ckwGEZQy,32000,more than downpayment,more than downpayment,0,4000
ckwGEZQy,4000,12/26/2019,8900,ckwGEZQy,36000,more than downpayment,more than downpayment,0,4000
ckwGEZQy,4000,2/4/2020,8900,ckwGEZQy,40000,more than downpayment,more than downpayment,0,4000
CLZ57M36,2000,6/29/2019,1999,,2000,more than downpayment,,1999,1
CM8R9TLR,9900,1/11/2020,9900,,9900,equal to downpayment,,9900,0
CNpYhqlb,10000,7/5/2019,10000,,10000,equal to downpayment,,10000,0
CNpYhqlb,4000,8/1/2019,10000,CNpYhqlb,14000,more than downpayment,equal to downpayment,0,4000
CNpYhqlb,4500,8/26/2019,10000,CNpYhqlb,18500,more than downpayment,more than downpayment,0,4500
CNpYhqlb,4500,10/3/2019,10000,CNpYhqlb,23000,more than downpayment,more than downpayment,0,4500
CNpYhqlb,4500,11/6/2019,10000,CNpYhqlb,27500,more than downpayment,more than downpayment,0,4500
CNpYhqlb,4500,12/26/2019,10000,CNpYhqlb,32000,more than downpayment,more than downpayment,0,4500
CNpYhqlb,4500,1/28/2020,10000,CNpYhqlb,36500,more than downpayment,more than downpayment,0,4500
CnZdLh7f,21000,9/12/2019,8900,,21000,more than downpayment,,8900,12100
CnZdLh7f,10000,11/9/2019,8900,CnZdLh7f,31000,more than downpayment,more than downpayment,0,10000
CnZdLh7f,10000,1/28/2020,8900,CnZdLh7f,41000,more than downpayment,more than downpayment,0,10000
CO2JUVFO,9900,12/9/2019,9900,,9900,equal to downpayment,,9900,0
CO4N1DR7,9900,9/12/2019,9900,,9900,equal to downpayment,,9900,0
CO4N1DR7,3900,10/10/2019,9900,CO4N1DR7,13800,more than downpayment,equal to downpayment,0,3900
CO4N1DR7,3900,11/5/2019,9900,CO4N1DR7,17700,more than downpayment,more than downpayment,0,3900
CO4N1DR7,3900,12/4/2019,9900,CO4N1DR7,21600,more than downpayment,more than downpayment,0,3900
CO4N1DR7,3900,1/4/2020,9900,CO4N1DR7,25500,more than downpayment,more than downpayment,0,3900
CO4N1DR7,3900,2/5/2020,9900,CO4N1DR7,29400,more than downpayment,more than downpayment,0,3900
Cpnx6yVu,10000,3/7/2019,10000,,10000,equal to downpayment,,10000,0
Cpnx6yVu,4500,4/15/2019,10000,Cpnx6yVu,14500,more than downpayment,equal to downpayment,0,4500
Cpnx6yVu,4500,6/17/2019,10000,Cpnx6yVu,19000,more than downpayment,more than downpayment,0,4500
Cpnx6yVu,4500,7/26/2019,10000,Cpnx6yVu,23500,more than downpayment,more than downpayment,0,4500
Cpnx6yVu,3000,8/30/2019,10000,Cpnx6yVu,26500,more than downpayment,more than downpayment,0,3000
Cpnx6yVu,1500,10/3/2019,10000,Cpnx6yVu,28000,more than downpayment,more than downpayment,0,1500
Cpnx6yVu,4000,10/28/2019,10000,Cpnx6yVu,32000,more than downpayment,more than downpayment,0,4000
Cpnx6yVu,2000,11/27/2019,10000,Cpnx6yVu,34000,more than downpayment,more than downpayment,0,2000
Cpnx6yVu,5000,1/22/2020,10000,Cpnx6yVu,39000,more than downpayment,more than downpayment,0,5000
cPrc6Rla,8900,4/3/2019,8900,,8900,equal to downpayment,,8900,0
cPrc6Rla,2000,5/11/2019,8900,cPrc6Rla,10900,more than downpayment,equal to downpayment,0,2000
cPrc6Rla,2000,5/13/2019,8900,cPrc6Rla,12900,more than downpayment,more than downpayment,0,2000
cPrc6Rla,4000,6/23/2019,8900,cPrc6Rla,16900,more than downpayment,more than downpayment,0,4000
cPrc6Rla,4000,8/1/2019,8900,cPrc6Rla,20900,more than downpayment,more than downpayment,0,4000
CPSUJWID,23400,8/19/2019,8900,,23400,more than downpayment,,8900,14500
CPSUJWID,7300,10/16/2019,8900,CPSUJWID,30700,more than downpayment,more than downpayment,0,7300
CPSUJWID,7300,11/14/2019,8900,CPSUJWID,38000,more than downpayment,more than downpayment,0,7300
CPSUJWID,7300,12/13/2019,8900,CPSUJWID,45300,more than downpayment,more than downpayment,0,7300
CPSUJWID,7300,1/12/2020,8900,CPSUJWID,52600,more than downpayment,more than downpayment,0,7300
CQKYVObv,8900,4/27/2019,8900,,8900,equal to downpayment,,8900,0
CQKYVObv,1500,4/30/2019,8900,CQKYVObv,10400,more than downpayment,equal to downpayment,0,1500
CQKYVObv,2600,5/27/2019,8900,CQKYVObv,13000,more than downpayment,more than downpayment,0,2600
CQKYVObv,3000,6/15/2019,8900,CQKYVObv,16000,more than downpayment,more than downpayment,0,3000
CQKYVObv,350,6/16/2019,8900,CQKYVObv,16350,more than downpayment,more than downpayment,0,350
CQKYVObv,750,6/19/2019,8900,CQKYVObv,17100,more than downpayment,more than downpayment,0,750
CQKYVObv,750,6/25/2019,8900,CQKYVObv,17850,more than downpayment,more than downpayment,0,750
CQKYVObv,3000,7/10/2019,8900,CQKYVObv,20850,more than downpayment,more than downpayment,0,3000
CQKYVObv,1050,7/29/2019,8900,CQKYVObv,21900,more than downpayment,more than downpayment,0,1050
CQKYVObv,3100,8/7/2019,8900,CQKYVObv,25000,more than downpayment,more than downpayment,0,3100
CQKYVObv,400,8/14/2019,8900,CQKYVObv,25400,more than downpayment,more than downpayment,0,400
CQKYVObv,1500,8/17/2019,8900,CQKYVObv,26900,more than downpayment,more than downpayment,0,1500
CQKYVObv,500,8/30/2019,8900,CQKYVObv,27400,more than downpayment,more than downpayment,0,500
CQKYVObv,3000,9/6/2019,8900,CQKYVObv,30400,more than downpayment,more than downpayment,0,3000
CQKYVObv,1500,9/10/2019,8900,CQKYVObv,31900,more than downpayment,more than downpayment,0,1500
CQKYVObv,1500,9/14/2019,8900,CQKYVObv,33400,more than downpayment,more than downpayment,0,1500
CQKYVObv,1350,10/4/2019,8900,CQKYVObv,34750,more than downpayment,more than downpayment,0,1350
CQKYVObv,1500,10/16/2019,8900,CQKYVObv,36250,more than downpayment,more than downpayment,0,1500
CQKYVObv,900,10/23/2019,8900,CQKYVObv,37150,more than downpayment,more than downpayment,0,900
CQKYVObv,3000,11/17/2019,8900,CQKYVObv,40150,more than downpayment,more than downpayment,0,3000
CQKYVObv,4000,12/23/2019,8900,CQKYVObv,44150,more than downpayment,more than downpayment,0,4000
CQKYVObv,2000,1/14/2020,8900,CQKYVObv,46150,more than downpayment,more than downpayment,0,2000
CQKYVObv,2000,1/25/2020,8900,CQKYVObv,48150,more than downpayment,more than downpayment,0,2000
CQLOW9H1,9000,9/3/2019,8900,,9000,more than downpayment,,8900,100
CQLOW9H1,3900,11/2/2019,8900,CQLOW9H1,12900,more than downpayment,more than downpayment,0,3900
CQLOW9H1,3900,12/3/2019,8900,CQLOW9H1,16800,more than downpayment,more than downpayment,0,3900
CQLOW9H1,4000,1/2/2020,8900,CQLOW9H1,20800,more than downpayment,more than downpayment,0,4000
CQLOW9H1,4000,2/4/2020,8900,CQLOW9H1,24800,more than downpayment,more than downpayment,0,4000
CQMGLTYO,2000,12/24/2019,9900,,2000,less than downpayment,,2000,0
CQMGLTYO,7900,12/31/2019,9900,CQMGLTYO,9900,equal to downpayment,less than downpayment,7900,0
CQRW5OLI,9900,10/3/2019,9900,,9900,equal to downpayment,,9900,0
CQRW5OLI,3900,11/20/2019,9900,CQRW5OLI,13800,more than downpayment,equal to downpayment,0,3900
CQRW5OLI,3900,12/23/2019,9900,CQRW5OLI,17700,more than downpayment,more than downpayment,0,3900
CQRW5OLI,3900,1/25/2020,9900,CQRW5OLI,21600,more than downpayment,more than downpayment,0,3900
CQVPHT2Q,8900,9/30/2019,8900,,8900,equal to downpayment,,8900,0
CR8mXbJ4,8900,5/8/2019,8900,,8900,equal to downpayment,,8900,0
CR8mXbJ4,4000,6/16/2019,8900,CR8mXbJ4,12900,more than downpayment,equal to downpayment,0,4000
CR8mXbJ4,3900,7/12/2019,8900,CR8mXbJ4,16800,more than downpayment,more than downpayment,0,3900
CR8mXbJ4,3900,8/26/2019,8900,CR8mXbJ4,20700,more than downpayment,more than downpayment,0,3900
CR8mXbJ4,3900,9/25/2019,8900,CR8mXbJ4,24600,more than downpayment,more than downpayment,0,3900
CR8mXbJ4,3900,11/4/2019,8900,CR8mXbJ4,28500,more than downpayment,more than downpayment,0,3900
CR8mXbJ4,4000,12/2/2019,8900,CR8mXbJ4,32500,more than downpayment,more than downpayment,0,4000
CR8mXbJ4,3900,1/9/2020,8900,CR8mXbJ4,36400,more than downpayment,more than downpayment,0,3900
CR8mXbJ4,3900,1/31/2020,8900,CR8mXbJ4,40300,more than downpayment,more than downpayment,0,3900
CRFI6OPI,9900,7/8/2019,9900,,9900,equal to downpayment,,9900,0
CRFI6OPI,3900,9/16/2019,9900,CRFI6OPI,13800,more than downpayment,equal to downpayment,0,3900
CRFI6OPI,3400,10/25/2019,9900,CRFI6OPI,17200,more than downpayment,more than downpayment,0,3400
CRFI6OPI,250,10/29/2019,9900,CRFI6OPI,17450,more than downpayment,more than downpayment,0,250
CRFI6OPI,250,10/30/2019,9900,CRFI6OPI,17700,more than downpayment,more than downpayment,0,250
crGRhgEo,8900,1/14/2019,8900,,8900,equal to downpayment,,8900,0
crGRhgEo,3900,3/15/2019,8900,crGRhgEo,12800,more than downpayment,equal to downpayment,0,3900
crGRhgEo,3900,4/30/2019,8900,crGRhgEo,16700,more than downpayment,more than downpayment,0,3900
crGRhgEo,3900,5/25/2019,8900,crGRhgEo,20600,more than downpayment,more than downpayment,0,3900
crGRhgEo,3900,6/25/2019,8900,crGRhgEo,24500,more than downpayment,more than downpayment,0,3900
crGRhgEo,3900,7/25/2019,8900,crGRhgEo,28400,more than downpayment,more than downpayment,0,3900
crGRhgEo,3900,8/26/2019,8900,crGRhgEo,32300,more than downpayment,more than downpayment,0,3900
crGRhgEo,3900,9/25/2019,8900,crGRhgEo,36200,more than downpayment,more than downpayment,0,3900
crGRhgEo,3900,10/25/2019,8900,crGRhgEo,40100,more than downpayment,more than downpayment,0,3900
crGRhgEo,3100,11/25/2019,8900,crGRhgEo,43200,more than downpayment,more than downpayment,0,3100
crGRhgEo,900,12/17/2019,8900,crGRhgEo,44100,more than downpayment,more than downpayment,0,900
crGRhgEo,3000,12/27/2019,8900,crGRhgEo,47100,more than downpayment,more than downpayment,0,3000
crGRhgEo,800,1/3/2020,8900,crGRhgEo,47900,more than downpayment,more than downpayment,0,800
crGRhgEo,3000,1/28/2020,8900,crGRhgEo,50900,more than downpayment,more than downpayment,0,3000
crGRhgEo,900,1/31/2020,8900,crGRhgEo,51800,more than downpayment,more than downpayment,0,900
CRJYXFKZ,9900,12/6/2019,9900,,9900,equal to downpayment,,9900,0
CRJYXFKZ,3900,2/3/2020,9900,CRJYXFKZ,13800,more than downpayment,equal to downpayment,0,3900
CsCWc9DV,9900,7/8/2019,9900,,9900,equal to downpayment,,9900,0
CSI27UPM,9900,12/5/2019,9900,,9900,equal to downpayment,,9900,0
CTMLPNYG,9900,11/19/2019,9900,,9900,equal to downpayment,,9900,0
CTMLPNYG,3900,12/26/2019,9900,CTMLPNYG,13800,more than downpayment,equal to downpayment,0,3900
CTMLPNYG,3900,1/23/2020,9900,CTMLPNYG,17700,more than downpayment,more than downpayment,0,3900
CTMLPNYG,3900,2/8/2020,9900,CTMLPNYG,21600,more than downpayment,more than downpayment,0,3900
CUol43ZL,10000,9/20/2018,10000,,10000,equal to downpayment,,10000,0
CUol43ZL,4500,10/25/2018,10000,CUol43ZL,14500,more than downpayment,equal to downpayment,0,4500
CUol43ZL,4500,11/26/2018,10000,CUol43ZL,19000,more than downpayment,more than downpayment,0,4500
CUol43ZL,4500,12/31/2018,10000,CUol43ZL,23500,more than downpayment,more than downpayment,0,4500
CUol43ZL,4500,1/26/2019,10000,CUol43ZL,28000,more than downpayment,more than downpayment,0,4500
CUol43ZL,4500,2/28/2019,10000,CUol43ZL,32500,more than downpayment,more than downpayment,0,4500
CUol43ZL,4500,3/25/2019,10000,CUol43ZL,37000,more than downpayment,more than downpayment,0,4500
CUol43ZL,4500,4/26/2019,10000,CUol43ZL,41500,more than downpayment,more than downpayment,0,4500
CUol43ZL,4500,5/29/2019,10000,CUol43ZL,46000,more than downpayment,more than downpayment,0,4500
CUol43ZL,4500,6/27/2019,10000,CUol43ZL,50500,more than downpayment,more than downpayment,0,4500
CUol43ZL,4500,7/29/2019,10000,CUol43ZL,55000,more than downpayment,more than downpayment,0,4500
CUol43ZL,4500,8/28/2019,10000,CUol43ZL,59500,more than downpayment,more than downpayment,0,4500
CUol43ZL,4500,10/3/2019,10000,CUol43ZL,64000,more than downpayment,more than downpayment,0,4500
CV3EQLTE,9900,6/4/2019,9900,,9900,equal to downpayment,,9900,0
CV3EQLTE,3900,7/16/2019,9900,CV3EQLTE,13800,more than downpayment,equal to downpayment,0,3900
CV3EQLTE,3900,8/16/2019,9900,CV3EQLTE,17700,more than downpayment,more than downpayment,0,3900
CV3EQLTE,3900,9/3/2019,9900,CV3EQLTE,21600,more than downpayment,more than downpayment,0,3900
CV3EQLTE,2700,10/16/2019,9900,CV3EQLTE,24300,more than downpayment,more than downpayment,0,2700
CV3EQLTE,4600,11/5/2019,9900,CV3EQLTE,28900,more than downpayment,more than downpayment,0,4600
CV3EQLTE,4000,12/4/2019,9900,CV3EQLTE,32900,more than downpayment,more than downpayment,0,4000
CV3EQLTE,6300,2/4/2020,9900,CV3EQLTE,39200,more than downpayment,more than downpayment,0,6300
CV5X5D8S,9900,2/3/2020,9900,,9900,equal to downpayment,,9900,0
CVASQEMM,9900,7/30/2019,9900,,9900,equal to downpayment,,9900,0
CVASQEMM,4000,8/29/2019,9900,CVASQEMM,13900,more than downpayment,equal to downpayment,0,4000
CVASQEMM,4000,9/27/2019,9900,CVASQEMM,17900,more than downpayment,more than downpayment,0,4000
CVASQEMM,4000,11/6/2019,9900,CVASQEMM,21900,more than downpayment,more than downpayment,0,4000
CVASQEMM,4000,11/30/2019,9900,CVASQEMM,25900,more than downpayment,more than downpayment,0,4000
CVASQEMM,3500,1/30/2020,9900,CVASQEMM,29400,more than downpayment,more than downpayment,0,3500
CVDA3RYF,9900,7/16/2019,9900,,9900,equal to downpayment,,9900,0
CVGQQ5GM,9900,10/13/2019,9900,,9900,equal to downpayment,,9900,0
CVGQQ5GM,3900,1/4/2020,9900,CVGQQ5GM,13800,more than downpayment,equal to downpayment,0,3900
CVGQQ5GM,3900,2/4/2020,9900,CVGQQ5GM,17700,more than downpayment,more than downpayment,0,3900
cVJxLZR1,8900,7/25/2019,8900,,8900,equal to downpayment,,8900,0
cVJxLZR1,3900,9/5/2019,8900,cVJxLZR1,12800,more than downpayment,equal to downpayment,0,3900
cVJxLZR1,3900,10/2/2019,8900,cVJxLZR1,16700,more than downpayment,more than downpayment,0,3900
cVJxLZR1,3900,11/5/2019,8900,cVJxLZR1,20600,more than downpayment,more than downpayment,0,3900
cVJxLZR1,3900,12/5/2019,8900,cVJxLZR1,24500,more than downpayment,more than downpayment,0,3900
cVJxLZR1,7800,2/3/2020,8900,cVJxLZR1,32300,more than downpayment,more than downpayment,0,7800
cVlNQ16o,9900,11/7/2018,9900,,9900,equal to downpayment,,9900,0
cVlNQ16o,4500,12/20/2018,9900,cVlNQ16o,14400,more than downpayment,equal to downpayment,0,4500
cVlNQ16o,4500,1/24/2019,9900,cVlNQ16o,18900,more than downpayment,more than downpayment,0,4500
cVlNQ16o,4500,2/19/2019,9900,cVlNQ16o,23400,more than downpayment,more than downpayment,0,4500
cVlNQ16o,4500,3/25/2019,9900,cVlNQ16o,27900,more than downpayment,more than downpayment,0,4500
cVlNQ16o,4500,4/25/2019,9900,cVlNQ16o,32400,more than downpayment,more than downpayment,0,4500
cVlNQ16o,4500,5/25/2019,9900,cVlNQ16o,36900,more than downpayment,more than downpayment,0,4500
cVlNQ16o,4500,6/25/2019,9900,cVlNQ16o,41400,more than downpayment,more than downpayment,0,4500
cVlNQ16o,4500,7/25/2019,9900,cVlNQ16o,45900,more than downpayment,more than downpayment,0,4500
cVlNQ16o,4500,8/27/2019,9900,cVlNQ16o,50400,more than downpayment,more than downpayment,0,4500
cVlNQ16o,4500,10/2/2019,9900,cVlNQ16o,54900,more than downpayment,more than downpayment,0,4500
cVlNQ16o,9000,12/15/2019,9900,cVlNQ16o,63900,more than downpayment,more than downpayment,0,9000
CW5F37GI,10000,12/18/2019,9900,,10000,more than downpayment,,9900,100
CwfOPNAu,29227,7/17/2019,9900,,29227,more than downpayment,,9900,19327
CwfOPNAu,3900,8/13/2019,9900,CwfOPNAu,33127,more than downpayment,more than downpayment,0,3900
CwfOPNAu,3900,9/21/2019,9900,CwfOPNAu,37027,more than downpayment,more than downpayment,0,3900
CwfOPNAu,4000,10/19/2019,9900,CwfOPNAu,41027,more than downpayment,more than downpayment,0,4000
CwfOPNAu,3900,11/7/2019,9900,CwfOPNAu,44927,more than downpayment,more than downpayment,0,3900
CwfOPNAu,8000,1/20/2020,9900,CwfOPNAu,52927,more than downpayment,more than downpayment,0,8000
cwh10vUG,8900,2/4/2019,8900,,8900,equal to downpayment,,8900,0
cwh10vUG,3900,3/13/2019,8900,cwh10vUG,12800,more than downpayment,equal to downpayment,0,3900
cwh10vUG,3900,4/9/2019,8900,cwh10vUG,16700,more than downpayment,more than downpayment,0,3900
cwh10vUG,3900,5/9/2019,8900,cwh10vUG,20600,more than downpayment,more than downpayment,0,3900
cwh10vUG,3900,6/8/2019,8900,cwh10vUG,24500,more than downpayment,more than downpayment,0,3900
cwh10vUG,3900,7/4/2019,8900,cwh10vUG,28400,more than downpayment,more than downpayment,0,3900
cwh10vUG,3900,8/3/2019,8900,cwh10vUG,32300,more than downpayment,more than downpayment,0,3900
cwh10vUG,3900,9/12/2019,8900,cwh10vUG,36200,more than downpayment,more than downpayment,0,3900
cwh10vUG,3900,12/4/2019,8900,cwh10vUG,40100,more than downpayment,more than downpayment,0,3900
cXl57WJ6,8900,5/13/2019,9900,,8900,less than downpayment,,8900,0
cXl57WJ6,3900,6/30/2019,9900,cXl57WJ6,12800,more than downpayment,less than downpayment,1000,2900
cXl57WJ6,3900,7/21/2019,9900,cXl57WJ6,16700,more than downpayment,more than downpayment,0,3900
cXl57WJ6,3900,8/30/2019,9900,cXl57WJ6,20600,more than downpayment,more than downpayment,0,3900
cXl57WJ6,3900,9/27/2019,9900,cXl57WJ6,24500,more than downpayment,more than downpayment,0,3900
cXl57WJ6,3900,10/24/2019,9900,cXl57WJ6,28400,more than downpayment,more than downpayment,0,3900
cXl57WJ6,4900,11/30/2019,9900,cXl57WJ6,33300,more than downpayment,more than downpayment,0,4900
cXl57WJ6,3900,1/8/2020,9900,cXl57WJ6,37200,more than downpayment,more than downpayment,0,3900
cxSXJfV3,10000,6/18/2017,10000,,10000,equal to downpayment,,10000,0
cxSXJfV3,5000,9/5/2017,10000,cxSXJfV3,15000,more than downpayment,equal to downpayment,0,5000
cxSXJfV3,10500,12/15/2017,10000,cxSXJfV3,25500,more than downpayment,more than downpayment,0,10500
cxSXJfV3,3000,2/1/2018,10000,cxSXJfV3,28500,more than downpayment,more than downpayment,0,3000
cxSXJfV3,5000,4/11/2018,10000,cxSXJfV3,33500,more than downpayment,more than downpayment,0,5000
cxSXJfV3,6000,1/17/2019,10000,cxSXJfV3,39500,more than downpayment,more than downpayment,0,6000
cxSXJfV3,6000,2/7/2019,10000,cxSXJfV3,45500,more than downpayment,more than downpayment,0,6000
cxSXJfV3,4000,5/2/2019,10000,cxSXJfV3,49500,more than downpayment,more than downpayment,0,4000
cxSXJfV3,2500,5/9/2019,10000,cxSXJfV3,52000,more than downpayment,more than downpayment,0,2500
CXXGtNVA,9900,7/11/2019,9900,,9900,equal to downpayment,,9900,0
CXXGtNVA,4000,8/19/2019,9900,CXXGtNVA,13900,more than downpayment,equal to downpayment,0,4000
CXXGtNVA,4000,9/14/2019,9900,CXXGtNVA,17900,more than downpayment,more than downpayment,0,4000
CXXGtNVA,4000,10/11/2019,9900,CXXGtNVA,21900,more than downpayment,more than downpayment,0,4000
CXXGtNVA,4000,11/11/2019,9900,CXXGtNVA,25900,more than downpayment,more than downpayment,0,4000
CXXGtNVA,4000,12/7/2019,9900,CXXGtNVA,29900,more than downpayment,more than downpayment,0,4000
CXXGtNVA,4000,12/21/2019,9900,CXXGtNVA,33900,more than downpayment,more than downpayment,0,4000
cyimvvxK,8900,4/15/2019,8900,,8900,equal to downpayment,,8900,0
cyimvvxK,10000,4/27/2019,8900,cyimvvxK,18900,more than downpayment,equal to downpayment,0,10000
cyimvvxK,3900,7/17/2019,8900,cyimvvxK,22800,more than downpayment,more than downpayment,0,3900
cyimvvxK,4000,10/17/2019,8900,cyimvvxK,26800,more than downpayment,more than downpayment,0,4000
cyimvvxK,3900,12/2/2019,8900,cyimvvxK,30700,more than downpayment,more than downpayment,0,3900
cyimvvxK,3900,1/29/2020,8900,cyimvvxK,34600,more than downpayment,more than downpayment,0,3900
CZdjDyp2,10000,6/13/2017,10000,,10000,equal to downpayment,,10000,0
CZdjDyp2,3500,7/20/2017,10000,CZdjDyp2,13500,more than downpayment,equal to downpayment,0,3500
CZdjDyp2,3500,10/2/2017,10000,CZdjDyp2,17000,more than downpayment,more than downpayment,0,3500
CZdjDyp2,3500,11/30/2017,10000,CZdjDyp2,20500,more than downpayment,more than downpayment,0,3500
CZdjDyp2,4000,1/29/2018,10000,CZdjDyp2,24500,more than downpayment,more than downpayment,0,4000
CZdjDyp2,2000,3/23/2018,10000,CZdjDyp2,26500,more than downpayment,more than downpayment,0,2000
CZdjDyp2,2000,3/30/2018,10000,CZdjDyp2,28500,more than downpayment,more than downpayment,0,2000
CZdjDyp2,2000,4/9/2018,10000,CZdjDyp2,30500,more than downpayment,more than downpayment,0,2000
CZdjDyp2,4000,8/7/2018,10000,CZdjDyp2,34500,more than downpayment,more than downpayment,0,4000
CZdjDyp2,4000,9/17/2018,10000,CZdjDyp2,38500,more than downpayment,more than downpayment,0,4000
CZdjDyp2,6500,11/1/2018,10000,CZdjDyp2,45000,more than downpayment,more than downpayment,0,6500
CZEL62CB,9900,8/9/2019,9900,,9900,equal to downpayment,,9900,0
CZEL62CB,3900,10/5/2019,9900,CZEL62CB,13800,more than downpayment,equal to downpayment,0,3900
CZEL62CB,3900,11/5/2019,9900,CZEL62CB,17700,more than downpayment,more than downpayment,0,3900
CZEL62CB,3900,12/5/2019,9900,CZEL62CB,21600,more than downpayment,more than downpayment,0,3900
CZEL62CB,3900,1/3/2020,9900,CZEL62CB,25500,more than downpayment,more than downpayment,0,3900
CZEL62CB,3900,2/5/2020,9900,CZEL62CB,29400,more than downpayment,more than downpayment,0,3900
CZL9RTPT,9900,7/28/2019,9900,,9900,equal to downpayment,,9900,0
CZL9RTPT,3900,8/25/2019,9900,CZL9RTPT,13800,more than downpayment,equal to downpayment,0,3900
CZL9RTPT,3900,10/4/2019,9900,CZL9RTPT,17700,more than downpayment,more than downpayment,0,3900
CZL9RTPT,3900,11/5/2019,9900,CZL9RTPT,21600,more than downpayment,more than downpayment,0,3900
CZL9RTPT,3900,12/15/2019,9900,CZL9RTPT,25500,more than downpayment,more than downpayment,0,3900
CZL9RTPT,3000,1/3/2020,9900,CZL9RTPT,28500,more than downpayment,more than downpayment,0,3000
CZL9RTPT,900,1/28/2020,9900,CZL9RTPT,29400,more than downpayment,more than downpayment,0,900
CZL9RTPT,1000,2/9/2020,9900,CZL9RTPT,30400,more than downpayment,more than downpayment,0,1000
d00f119a,8900,12/16/2019,8900,,8900,equal to downpayment,,8900,0
d00f119a,3900,2/4/2020,8900,d00f119a,12800,more than downpayment,equal to downpayment,0,3900
d02659aa,9900,1/21/2020,9900,,9900,equal to downpayment,,9900,0
d04277aa,8900,12/26/2019,8900,,8900,equal to downpayment,,8900,0
d06ef7f8,9900,1/28/2020,9900,,9900,equal to downpayment,,9900,0
D0PDrm30,8900,3/25/2019,8900,,8900,equal to downpayment,,8900,0
D0PDrm30,3900,5/9/2019,8900,D0PDrm30,12800,more than downpayment,equal to downpayment,0,3900
D0PDrm30,3900,6/13/2019,8900,D0PDrm30,16700,more than downpayment,more than downpayment,0,3900
D0PDrm30,3900,6/30/2019,8900,D0PDrm30,20600,more than downpayment,more than downpayment,0,3900
D0PDrm30,3900,7/23/2019,8900,D0PDrm30,24500,more than downpayment,more than downpayment,0,3900
D0PDrm30,3900,8/23/2019,8900,D0PDrm30,28400,more than downpayment,more than downpayment,0,3900
D0PDrm30,3900,9/20/2019,8900,D0PDrm30,32300,more than downpayment,more than downpayment,0,3900
D0PDrm30,3900,11/24/2019,8900,D0PDrm30,36200,more than downpayment,more than downpayment,0,3900
D0PDrm30,3900,12/11/2019,8900,D0PDrm30,40100,more than downpayment,more than downpayment,0,3900
D0PDrm30,3900,12/26/2019,8900,D0PDrm30,44000,more than downpayment,more than downpayment,0,3900
D0PDrm30,3900,1/13/2020,8900,D0PDrm30,47900,more than downpayment,more than downpayment,0,3900
D0PDrm30,3900,1/23/2020,8900,D0PDrm30,51800,more than downpayment,more than downpayment,0,3900
D0PDrm30,3900,2/7/2020,8900,D0PDrm30,55700,more than downpayment,more than downpayment,0,3900
D1LBP1PJ,9900,12/10/2019,9900,,9900,equal to downpayment,,9900,0
D1QZ9XTT,5000,9/28/2019,9900,,5000,less than downpayment,,5000,0
D1X22RWQ,9900,11/27/2019,8900,,9900,more than downpayment,,8900,1000
D1X22RWQ,6000,1/27/2020,8900,D1X22RWQ,15900,more than downpayment,more than downpayment,0,6000
D25RTG4L,9900,10/9/2019,9900,,9900,equal to downpayment,,9900,0
D25RTG4L,3900,12/18/2019,9900,D25RTG4L,13800,more than downpayment,equal to downpayment,0,3900
D25RTG4L,3900,1/23/2020,9900,D25RTG4L,17700,more than downpayment,more than downpayment,0,3900
d2c4d660,9900,10/1/2019,9900,,9900,equal to downpayment,,9900,0
d2c4d660,3900,11/26/2019,9900,d2c4d660,13800,more than downpayment,equal to downpayment,0,3900
d2c4d660,3900,12/26/2019,9900,d2c4d660,17700,more than downpayment,more than downpayment,0,3900
d2c4d660,3900,1/27/2020,9900,d2c4d660,21600,more than downpayment,more than downpayment,0,3900
d33828d2,8900,9/18/2019,8900,,8900,equal to downpayment,,8900,0
d33828d2,3900,11/4/2019,8900,d33828d2,12800,more than downpayment,equal to downpayment,0,3900
d33828d2,3900,12/4/2019,8900,d33828d2,16700,more than downpayment,more than downpayment,0,3900
d33828d2,3900,1/3/2020,8900,d33828d2,20600,more than downpayment,more than downpayment,0,3900
d33828d2,3900,2/2/2020,8900,d33828d2,24500,more than downpayment,more than downpayment,0,3900
D37MTZW7,8900,1/28/2020,8900,,8900,equal to downpayment,,8900,0
D3MV45L4,9900,8/12/2019,9900,,9900,equal to downpayment,,9900,0
D3MV45L4,3999,10/4/2019,9900,D3MV45L4,13899,more than downpayment,equal to downpayment,0,3999
D3MV45L4,3900,11/14/2019,9900,D3MV45L4,17799,more than downpayment,more than downpayment,0,3900
D3MV45L4,3900,12/6/2019,9900,D3MV45L4,21699,more than downpayment,more than downpayment,0,3900
D3MV45L4,3900,1/6/2020,9900,D3MV45L4,25599,more than downpayment,more than downpayment,0,3900
D3MV45L4,3850,2/7/2020,9900,D3MV45L4,29449,more than downpayment,more than downpayment,0,3850
d434b1f8,8900,9/9/2019,8900,,8900,equal to downpayment,,8900,0
d434b1f8,3900,10/29/2019,8900,d434b1f8,12800,more than downpayment,equal to downpayment,0,3900
d434b1f8,3900,11/28/2019,8900,d434b1f8,16700,more than downpayment,more than downpayment,0,3900
d434b1f8,3900,12/23/2019,8900,d434b1f8,20600,more than downpayment,more than downpayment,0,3900
d434b1f8,3900,1/31/2020,8900,d434b1f8,24500,more than downpayment,more than downpayment,0,3900
d43ccb72,8900,10/14/2019,8900,,8900,equal to downpayment,,8900,0
d43ccb72,3900,12/27/2019,8900,d43ccb72,12800,more than downpayment,equal to downpayment,0,3900
d43ccb72,3900,1/25/2020,8900,d43ccb72,16700,more than downpayment,more than downpayment,0,3900
d4649019,50000,1/24/2020,9900,,50000,more than downpayment,,9900,40100
D54CZ8OK,10000,7/16/2019,26250,,10000,less than downpayment,,10000,0
D54CZ8OK,95000,8/26/2019,26250,D54CZ8OK,105000,more than downpayment,less than downpayment,16250,78750
d593c2da,8900,10/9/2019,8900,,8900,equal to downpayment,,8900,0
d593c2da,3900,12/5/2019,8900,d593c2da,12800,more than downpayment,equal to downpayment,0,3900
d593c2da,3900,1/7/2020,8900,d593c2da,16700,more than downpayment,more than downpayment,0,3900
d593c2da,3900,2/7/2020,8900,d593c2da,20600,more than downpayment,more than downpayment,0,3900
d5b83aa2,5000,1/23/2020,9900,,5000,less than downpayment,,5000,0
d5b83aa2,4900,1/24/2020,9900,d5b83aa2,9900,equal to downpayment,less than downpayment,4900,0
d5ddf061,9900,11/25/2019,9900,,9900,equal to downpayment,,9900,0
d5ddf061,3900,12/11/2019,9900,d5ddf061,13800,more than downpayment,equal to downpayment,0,3900
d5ddf061,3900,1/15/2020,9900,d5ddf061,17700,more than downpayment,more than downpayment,0,3900
D5VTOSHM,9900,11/17/2019,9900,,9900,equal to downpayment,,9900,0
D5VTOSHM,3900,1/15/2020,9900,D5VTOSHM,13800,more than downpayment,equal to downpayment,0,3900
d613d618,8900,9/16/2019,8900,,8900,equal to downpayment,,8900,0
d6314a80,5000,1/23/2020,8900,,5000,less than downpayment,,5000,0
d6314a80,3900,1/24/2020,8900,d6314a80,8900,equal to downpayment,less than downpayment,3900,0
d69dcd59,4999,12/30/2019,4999,,4999,equal to downpayment,,4999,0
D6F4K8WE,10000,12/25/2019,9900,,10000,more than downpayment,,9900,100
d72e0bef,9900,1/14/2020,9900,,9900,equal to downpayment,,9900,0
d74ba882,8900,12/5/2019,8900,,8900,equal to downpayment,,8900,0
d74ba882,3900,2/3/2020,8900,d74ba882,12800,more than downpayment,equal to downpayment,0,3900
d79c10c9,23400,12/5/2019,23400,,23400,equal to downpayment,,23400,0
d79c10c9,7300,1/26/2020,23400,d79c10c9,30700,more than downpayment,equal to downpayment,0,7300
d7b2a7e8,8900,10/25/2019,8900,,8900,equal to downpayment,,8900,0
d7b2a7e8,1000,10/29/2019,8900,d7b2a7e8,9900,more than downpayment,equal to downpayment,0,1000
d7b2a7e8,5000,1/25/2020,8900,d7b2a7e8,14900,more than downpayment,more than downpayment,0,5000
d7u6w4o7,50000,2/26/2019,8900,,50000,more than downpayment,,8900,41100
d800fb48,9900,11/2/2019,9900,,9900,equal to downpayment,,9900,0
d800fb48,3900,12/5/2019,9900,d800fb48,13800,more than downpayment,equal to downpayment,0,3900
d800fb48,3900,2/5/2020,9900,d800fb48,17700,more than downpayment,more than downpayment,0,3900
d88b1cb7,8900,9/17/2019,8900,,8900,equal to downpayment,,8900,0
d88b1cb7,3900,11/11/2019,8900,d88b1cb7,12800,more than downpayment,equal to downpayment,0,3900
d88b1cb7,3900,12/6/2019,8900,d88b1cb7,16700,more than downpayment,more than downpayment,0,3900
d88b1cb7,3900,12/30/2019,8900,d88b1cb7,20600,more than downpayment,more than downpayment,0,3900
d88b1cb7,3900,2/3/2020,8900,d88b1cb7,24500,more than downpayment,more than downpayment,0,3900
d96eb79f,9900,10/23/2019,9900,,9900,equal to downpayment,,9900,0
d96eb79f,3900,11/25/2019,9900,d96eb79f,13800,more than downpayment,equal to downpayment,0,3900
d96eb79f,3900,12/18/2019,9900,d96eb79f,17700,more than downpayment,more than downpayment,0,3900
d96eb79f,3900,1/14/2020,9900,d96eb79f,21600,more than downpayment,more than downpayment,0,3900
D9F8BJBP,9900,12/31/2019,9900,,9900,equal to downpayment,,9900,0
da14da74,9900,11/25/2019,9900,,9900,equal to downpayment,,9900,0
da14da74,3900,2/7/2020,9900,da14da74,13800,more than downpayment,equal to downpayment,0,3900
da6a4bd5,9900,12/20/2019,9900,,9900,equal to downpayment,,9900,0
dabKU3hd,8900,5/27/2019,9900,,8900,less than downpayment,,8900,0
dabKU3hd,1000,6/8/2019,9900,dabKU3hd,9900,equal to downpayment,less than downpayment,1000,0
dabKU3hd,3900,8/6/2019,9900,dabKU3hd,13800,more than downpayment,equal to downpayment,0,3900
dabKU3hd,3900,9/6/2019,9900,dabKU3hd,17700,more than downpayment,more than downpayment,0,3900
dabKU3hd,1000,10/16/2019,9900,dabKU3hd,18700,more than downpayment,more than downpayment,0,1000
dabKU3hd,1000,10/18/2019,9900,dabKU3hd,19700,more than downpayment,more than downpayment,0,1000
dabKU3hd,1000,11/25/2019,9900,dabKU3hd,20700,more than downpayment,more than downpayment,0,1000
dabKU3hd,5000,12/17/2019,9900,dabKU3hd,25700,more than downpayment,more than downpayment,0,5000
dabKU3hd,4000,1/22/2020,9900,dabKU3hd,29700,more than downpayment,more than downpayment,0,4000
dAEycfq1,8900,5/6/2019,8900,,8900,equal to downpayment,,8900,0
dAEycfq1,3900,6/11/2019,8900,dAEycfq1,12800,more than downpayment,equal to downpayment,0,3900
dAEycfq1,3900,7/12/2019,8900,dAEycfq1,16700,more than downpayment,more than downpayment,0,3900
dAEycfq1,7800,9/2/2019,8900,dAEycfq1,24500,more than downpayment,more than downpayment,0,7800
dAEycfq1,3900,9/24/2019,8900,dAEycfq1,28400,more than downpayment,more than downpayment,0,3900
dAEycfq1,3900,11/7/2019,8900,dAEycfq1,32300,more than downpayment,more than downpayment,0,3900
dAEycfq1,3900,1/4/2020,8900,dAEycfq1,36200,more than downpayment,more than downpayment,0,3900
dAEycfq1,3900,1/19/2020,8900,dAEycfq1,40100,more than downpayment,more than downpayment,0,3900
daKHZawD,12600,12/18/2018,9900,,12600,more than downpayment,,9900,2700
daKHZawD,4500,2/5/2019,9900,daKHZawD,17100,more than downpayment,more than downpayment,0,4500
daKHZawD,4500,2/25/2019,9900,daKHZawD,21600,more than downpayment,more than downpayment,0,4500
daKHZawD,4500,3/26/2019,9900,daKHZawD,26100,more than downpayment,more than downpayment,0,4500
daKHZawD,4500,4/26/2019,9900,daKHZawD,30600,more than downpayment,more than downpayment,0,4500
daKHZawD,4500,5/25/2019,9900,daKHZawD,35100,more than downpayment,more than downpayment,0,4500
daKHZawD,4500,6/24/2019,9900,daKHZawD,39600,more than downpayment,more than downpayment,0,4500
daKHZawD,4500,7/26/2019,9900,daKHZawD,44100,more than downpayment,more than downpayment,0,4500
daKHZawD,4500,8/26/2019,9900,daKHZawD,48600,more than downpayment,more than downpayment,0,4500
daKHZawD,4500,9/25/2019,9900,daKHZawD,53100,more than downpayment,more than downpayment,0,4500
daKHZawD,4500,10/26/2019,9900,daKHZawD,57600,more than downpayment,more than downpayment,0,4500
daKHZawD,4500,11/23/2019,9900,daKHZawD,62100,more than downpayment,more than downpayment,0,4500
daKHZawD,4500,12/30/2019,9900,daKHZawD,66600,more than downpayment,more than downpayment,0,4500
daKHZawD,4500,1/27/2020,9900,daKHZawD,71100,more than downpayment,more than downpayment,0,4500
datryuRC,10000,7/18/2017,10000,,10000,equal to downpayment,,10000,0
datryuRC,3500,8/29/2017,10000,datryuRC,13500,more than downpayment,equal to downpayment,0,3500
datryuRC,3500,9/30/2017,10000,datryuRC,17000,more than downpayment,more than downpayment,0,3500
datryuRC,3500,10/30/2017,10000,datryuRC,20500,more than downpayment,more than downpayment,0,3500
datryuRC,3500,11/30/2017,10000,datryuRC,24000,more than downpayment,more than downpayment,0,3500
datryuRC,3500,12/29/2017,10000,datryuRC,27500,more than downpayment,more than downpayment,0,3500
datryuRC,3500,1/30/2018,10000,datryuRC,31000,more than downpayment,more than downpayment,0,3500
datryuRC,3500,2/27/2018,10000,datryuRC,34500,more than downpayment,more than downpayment,0,3500
datryuRC,3500,3/30/2018,10000,datryuRC,38000,more than downpayment,more than downpayment,0,3500
datryuRC,3500,4/30/2018,10000,datryuRC,41500,more than downpayment,more than downpayment,0,3500
datryuRC,3500,5/31/2018,10000,datryuRC,45000,more than downpayment,more than downpayment,0,3500
DATTPLKH,1594,10/14/2019,1594,,1594,equal to downpayment,,1594,0
DATTPLKH,3100,12/5/2019,1594,DATTPLKH,4694,more than downpayment,equal to downpayment,0,3100
DATTPLKH,3100,1/10/2020,1594,DATTPLKH,7794,more than downpayment,more than downpayment,0,3100
DAXLUJJ2,2000,6/30/2019,1999,,2000,more than downpayment,,1999,1
DAXLUJJ2,2000,8/12/2019,1999,DAXLUJJ2,4000,more than downpayment,more than downpayment,0,2000
DAXLUJJ2,2000,9/10/2019,1999,DAXLUJJ2,6000,more than downpayment,more than downpayment,0,2000
DAXLUJJ2,2000,10/14/2019,1999,DAXLUJJ2,8000,more than downpayment,more than downpayment,0,2000
DAXLUJJ2,2000,11/14/2019,1999,DAXLUJJ2,10000,more than downpayment,more than downpayment,0,2000
DAXLUJJ2,2000,12/13/2019,1999,DAXLUJJ2,12000,more than downpayment,more than downpayment,0,2000
DAXLUJJ2,2000,1/10/2020,1999,DAXLUJJ2,14000,more than downpayment,more than downpayment,0,2000
db56e089,8900,9/24/2019,8900,,8900,equal to downpayment,,8900,0
db56e089,3900,11/5/2019,8900,db56e089,12800,more than downpayment,equal to downpayment,0,3900
db56e089,3900,12/2/2019,8900,db56e089,16700,more than downpayment,more than downpayment,0,3900
db56e089,3900,1/4/2020,8900,db56e089,20600,more than downpayment,more than downpayment,0,3900
db56e089,3900,2/5/2020,8900,db56e089,24500,more than downpayment,more than downpayment,0,3900
db99accd,8900,9/25/2019,7900,,8900,more than downpayment,,7900,1000
db99accd,3900,11/24/2019,7900,db99accd,12800,more than downpayment,more than downpayment,0,3900
db99accd,1300,1/1/2020,7900,db99accd,14100,more than downpayment,more than downpayment,0,1300
db99accd,3100,2/1/2020,7900,db99accd,17200,more than downpayment,more than downpayment,0,3100
dbf8215f,10000,1/29/2020,8900,,10000,more than downpayment,,8900,1100
dbmoSgVR,8900,5/23/2019,8900,,8900,equal to downpayment,,8900,0
DbrXrOLk,10000,1/14/2019,10000,,10000,equal to downpayment,,10000,0
DbrXrOLk,4500,2/22/2019,10000,DbrXrOLk,14500,more than downpayment,equal to downpayment,0,4500
DbrXrOLk,4500,3/22/2019,10000,DbrXrOLk,19000,more than downpayment,more than downpayment,0,4500
DbrXrOLk,4500,4/25/2019,10000,DbrXrOLk,23500,more than downpayment,more than downpayment,0,4500
DbrXrOLk,4500,5/24/2019,10000,DbrXrOLk,28000,more than downpayment,more than downpayment,0,4500
DbrXrOLk,4500,6/24/2019,10000,DbrXrOLk,32500,more than downpayment,more than downpayment,0,4500
DbrXrOLk,4500,7/24/2019,10000,DbrXrOLk,37000,more than downpayment,more than downpayment,0,4500
DbrXrOLk,4500,8/25/2019,10000,DbrXrOLk,41500,more than downpayment,more than downpayment,0,4500
DbrXrOLk,4500,10/24/2019,10000,DbrXrOLk,46000,more than downpayment,more than downpayment,0,4500
DbrXrOLk,4500,11/23/2019,10000,DbrXrOLk,50500,more than downpayment,more than downpayment,0,4500
DbrXrOLk,4500,12/14/2019,10000,DbrXrOLk,55000,more than downpayment,more than downpayment,0,4500
DbrXrOLk,4500,12/19/2019,10000,DbrXrOLk,59500,more than downpayment,more than downpayment,0,4500
DbrXrOLk,4500,1/31/2020,10000,DbrXrOLk,64000,more than downpayment,more than downpayment,0,4500
dc3e77b0,5000,12/30/2019,4999,,5000,more than downpayment,,4999,1
dc3e77b0,3100,2/6/2020,4999,dc3e77b0,8100,more than downpayment,more than downpayment,0,3100
dc80b6b5,9900,11/18/2019,9900,,9900,equal to downpayment,,9900,0
dc9e242c,8900,11/15/2019,8900,,8900,equal to downpayment,,8900,0
dc9e242c,3900,12/3/2019,8900,dc9e242c,12800,more than downpayment,equal to downpayment,0,3900
dc9e242c,3300,12/27/2019,8900,dc9e242c,16100,more than downpayment,more than downpayment,0,3300
dc9e242c,600,1/13/2020,8900,dc9e242c,16700,more than downpayment,more than downpayment,0,600
dc9e242c,3900,2/3/2020,8900,dc9e242c,20600,more than downpayment,more than downpayment,0,3900
dc9eafdb,1,2/6/2020,9900,,1,less than downpayment,,1,0
dcbb6091,8900,12/10/2019,8900,,8900,equal to downpayment,,8900,0
dcbb6091,4000,2/8/2020,8900,dcbb6091,12900,more than downpayment,equal to downpayment,0,4000
DCEROEKC,3500,11/9/2019,7900,,3500,less than downpayment,,3500,0
DCEROEKC,4400,11/14/2019,7900,DCEROEKC,7900,equal to downpayment,less than downpayment,4400,0
DCKE9RF3,9900,10/7/2019,9900,,9900,equal to downpayment,,9900,0
DCKE9RF3,3900,11/20/2019,9900,DCKE9RF3,13800,more than downpayment,equal to downpayment,0,3900
DCKE9RF3,3900,12/20/2019,9900,DCKE9RF3,17700,more than downpayment,more than downpayment,0,3900
DCKE9RF3,3900,1/20/2020,9900,DCKE9RF3,21600,more than downpayment,more than downpayment,0,3900
dCN00Ndn,9000,2/7/2019,8900,,9000,more than downpayment,,8900,100
dCN00Ndn,3900,3/15/2019,8900,dCN00Ndn,12900,more than downpayment,more than downpayment,0,3900
dCN00Ndn,3900,4/14/2019,8900,dCN00Ndn,16800,more than downpayment,more than downpayment,0,3900
dCN00Ndn,3900,5/15/2019,8900,dCN00Ndn,20700,more than downpayment,more than downpayment,0,3900
dCN00Ndn,3900,6/14/2019,8900,dCN00Ndn,24600,more than downpayment,more than downpayment,0,3900
dCN00Ndn,3900,7/14/2019,8900,dCN00Ndn,28500,more than downpayment,more than downpayment,0,3900
dCN00Ndn,3900,8/15/2019,8900,dCN00Ndn,32400,more than downpayment,more than downpayment,0,3900
dCN00Ndn,3900,9/17/2019,8900,dCN00Ndn,36300,more than downpayment,more than downpayment,0,3900
dCN00Ndn,3900,10/19/2019,8900,dCN00Ndn,40200,more than downpayment,more than downpayment,0,3900
dCN00Ndn,3900,11/17/2019,8900,dCN00Ndn,44100,more than downpayment,more than downpayment,0,3900
dCN00Ndn,3900,12/17/2019,8900,dCN00Ndn,48000,more than downpayment,more than downpayment,0,3900
dCN00Ndn,3900,1/17/2020,8900,dCN00Ndn,51900,more than downpayment,more than downpayment,0,3900
DCTN22GF,9900,6/6/2019,9900,,9900,equal to downpayment,,9900,0
DCTN22GF,3200,7/28/2019,9900,DCTN22GF,13100,more than downpayment,equal to downpayment,0,3200
DCTN22GF,700,8/1/2019,9900,DCTN22GF,13800,more than downpayment,more than downpayment,0,700
DCTN22GF,3900,8/28/2019,9900,DCTN22GF,17700,more than downpayment,more than downpayment,0,3900
DCTN22GF,3900,10/1/2019,9900,DCTN22GF,21600,more than downpayment,more than downpayment,0,3900
DCTN22GF,3900,11/18/2019,9900,DCTN22GF,25500,more than downpayment,more than downpayment,0,3900
DCTN22GF,3900,12/12/2019,9900,DCTN22GF,29400,more than downpayment,more than downpayment,0,3900
DCTN22GF,2400,1/5/2020,9900,DCTN22GF,31800,more than downpayment,more than downpayment,0,2400
DCTN22GF,1500,1/6/2020,9900,DCTN22GF,33300,more than downpayment,more than downpayment,0,1500
DCTN22GF,2500,1/27/2020,9900,DCTN22GF,35800,more than downpayment,more than downpayment,0,2500
DCTN22GF,1400,2/3/2020,9900,DCTN22GF,37200,more than downpayment,more than downpayment,0,1400
dd478dbb,8900,12/23/2019,8900,,8900,equal to downpayment,,8900,0
dd478dbb,3900,2/5/2020,8900,dd478dbb,12800,more than downpayment,equal to downpayment,0,3900
dd584479,1594,10/14/2019,1594,,1594,equal to downpayment,,1594,0
DDBOuxtV,10000,6/13/2017,10000,,10000,equal to downpayment,,10000,0
DDBOuxtV,3500,8/18/2017,10000,DDBOuxtV,13500,more than downpayment,equal to downpayment,0,3500
DDBOuxtV,5000,1/29/2018,10000,DDBOuxtV,18500,more than downpayment,more than downpayment,0,5000
DDBOuxtV,3500,4/3/2018,10000,DDBOuxtV,22000,more than downpayment,more than downpayment,0,3500
DDBOuxtV,3500,6/12/2018,10000,DDBOuxtV,25500,more than downpayment,more than downpayment,0,3500
DDBOuxtV,3500,4/3/2019,10000,DDBOuxtV,29000,more than downpayment,more than downpayment,0,3500
DDBOuxtV,3000,5/14/2019,10000,DDBOuxtV,32000,more than downpayment,more than downpayment,0,3000
DDBOuxtV,3000,1/8/2020,10000,DDBOuxtV,35000,more than downpayment,more than downpayment,0,3000
ddQB6B2G,9900,1/28/2019,9900,,9900,equal to downpayment,,9900,0
ddQB6B2G,4500,3/25/2019,9900,ddQB6B2G,14400,more than downpayment,equal to downpayment,0,4500
ddQB6B2G,4500,5/3/2019,9900,ddQB6B2G,18900,more than downpayment,more than downpayment,0,4500
DdW9wSIN,8900,3/18/2019,8900,,8900,equal to downpayment,,8900,0
DdW9wSIN,3900,4/23/2019,8900,DdW9wSIN,12800,more than downpayment,equal to downpayment,0,3900
DdW9wSIN,3900,5/17/2019,8900,DdW9wSIN,16700,more than downpayment,more than downpayment,0,3900
DdW9wSIN,3900,6/18/2019,8900,DdW9wSIN,20600,more than downpayment,more than downpayment,0,3900
DdW9wSIN,3900,7/31/2019,8900,DdW9wSIN,24500,more than downpayment,more than downpayment,0,3900
DdW9wSIN,3900,8/21/2019,8900,DdW9wSIN,28400,more than downpayment,more than downpayment,0,3900
DdW9wSIN,3900,9/23/2019,8900,DdW9wSIN,32300,more than downpayment,more than downpayment,0,3900
DdW9wSIN,3900,11/1/2019,8900,DdW9wSIN,36200,more than downpayment,more than downpayment,0,3900
DdW9wSIN,3900,11/22/2019,8900,DdW9wSIN,40100,more than downpayment,more than downpayment,0,3900
DdW9wSIN,3900,12/19/2019,8900,DdW9wSIN,44000,more than downpayment,more than downpayment,0,3900
de0e179a,7900,10/1/2019,7900,,7900,equal to downpayment,,7900,0
de6367cb,9999,11/24/2019,9900,,9999,more than downpayment,,9900,99
dec34de8,8900,9/18/2019,8900,,8900,equal to downpayment,,8900,0
dec34de8,1500,11/9/2019,8900,dec34de8,10400,more than downpayment,equal to downpayment,0,1500
dec34de8,2500,12/2/2019,8900,dec34de8,12900,more than downpayment,more than downpayment,0,2500
dec34de8,2000,12/23/2019,8900,dec34de8,14900,more than downpayment,more than downpayment,0,2000
dfc165f0,1594,10/14/2019,1594,,1594,equal to downpayment,,1594,0
dfc165f0,3100,12/10/2019,1594,dfc165f0,4694,more than downpayment,equal to downpayment,0,3100
dfc165f0,3100,1/10/2020,1594,dfc165f0,7794,more than downpayment,more than downpayment,0,3100
dfe80011,8900,11/28/2019,8900,,8900,equal to downpayment,,8900,0
dfe80011,3900,1/24/2020,8900,dfe80011,12800,more than downpayment,equal to downpayment,0,3900
DFRLLVWN,9900,1/6/2020,9900,,9900,equal to downpayment,,9900,0
dfWG5Inz,9900,7/31/2019,9900,,9900,equal to downpayment,,9900,0
dfWG5Inz,3400,11/5/2019,9900,dfWG5Inz,13300,more than downpayment,equal to downpayment,0,3400
dfWG5Inz,4000,12/18/2019,9900,dfWG5Inz,17300,more than downpayment,more than downpayment,0,4000
DG4G9MA5,9900,1/20/2020,9900,,9900,equal to downpayment,,9900,0
DGGJFT25,28000,1/17/2020,8900,,28000,more than downpayment,,8900,19100
dgpjOU9A,13553,3/19/2019,8900,,13553,more than downpayment,,8900,4653
dgpjOU9A,1639,3/20/2019,8900,dgpjOU9A,15192,more than downpayment,more than downpayment,0,1639
dgpjOU9A,3900,5/28/2019,8900,dgpjOU9A,19092,more than downpayment,more than downpayment,0,3900
dgpjOU9A,3900,6/28/2019,8900,dgpjOU9A,22992,more than downpayment,more than downpayment,0,3900
dgpjOU9A,3900,7/22/2019,8900,dgpjOU9A,26892,more than downpayment,more than downpayment,0,3900
dgpjOU9A,3900,8/28/2019,8900,dgpjOU9A,30792,more than downpayment,more than downpayment,0,3900
dgpjOU9A,3900,9/25/2019,8900,dgpjOU9A,34692,more than downpayment,more than downpayment,0,3900
dgpjOU9A,3900,10/26/2019,8900,dgpjOU9A,38592,more than downpayment,more than downpayment,0,3900
dgpjOU9A,3900,11/24/2019,8900,dgpjOU9A,42492,more than downpayment,more than downpayment,0,3900
dgpjOU9A,3900,12/29/2019,8900,dgpjOU9A,46392,more than downpayment,more than downpayment,0,3900
dgpjOU9A,3900,1/28/2020,8900,dgpjOU9A,50292,more than downpayment,more than downpayment,0,3900
DHtj8Zgr,9900,7/26/2019,9900,,9900,equal to downpayment,,9900,0
DHtj8Zgr,3900,10/22/2019,9900,DHtj8Zgr,13800,more than downpayment,equal to downpayment,0,3900
DHtj8Zgr,3900,12/19/2019,9900,DHtj8Zgr,17700,more than downpayment,more than downpayment,0,3900
DIE99lo9,12800,4/17/2019,8900,,12800,more than downpayment,,8900,3900
DIE99lo9,3900,5/23/2019,8900,DIE99lo9,16700,more than downpayment,more than downpayment,0,3900
DIE99lo9,3900,7/8/2019,8900,DIE99lo9,20600,more than downpayment,more than downpayment,0,3900
DIE99lo9,3900,8/10/2019,8900,DIE99lo9,24500,more than downpayment,more than downpayment,0,3900
DIE99lo9,3900,9/9/2019,8900,DIE99lo9,28400,more than downpayment,more than downpayment,0,3900
DIE99lo9,3900,10/11/2019,8900,DIE99lo9,32300,more than downpayment,more than downpayment,0,3900
DIE99lo9,3900,11/15/2019,8900,DIE99lo9,36200,more than downpayment,more than downpayment,0,3900
DIE99lo9,3900,12/18/2019,8900,DIE99lo9,40100,more than downpayment,more than downpayment,0,3900
DIE99lo9,3900,1/12/2020,8900,DIE99lo9,44000,more than downpayment,more than downpayment,0,3900
diMJCE0k,10000,1/11/2018,10000,,10000,equal to downpayment,,10000,0
diMJCE0k,4500,2/12/2018,10000,diMJCE0k,14500,more than downpayment,equal to downpayment,0,4500
diMJCE0k,4500,3/14/2018,10000,diMJCE0k,19000,more than downpayment,more than downpayment,0,4500
diMJCE0k,4500,4/10/2018,10000,diMJCE0k,23500,more than downpayment,more than downpayment,0,4500
diMJCE0k,4500,5/12/2018,10000,diMJCE0k,28000,more than downpayment,more than downpayment,0,4500
diMJCE0k,4500,6/17/2018,10000,diMJCE0k,32500,more than downpayment,more than downpayment,0,4500
diMJCE0k,4500,7/10/2018,10000,diMJCE0k,37000,more than downpayment,more than downpayment,0,4500
diMJCE0k,4500,8/15/2018,10000,diMJCE0k,41500,more than downpayment,more than downpayment,0,4500
diMJCE0k,4500,9/14/2018,10000,diMJCE0k,46000,more than downpayment,more than downpayment,0,4500
diMJCE0k,4500,10/3/2018,10000,diMJCE0k,50500,more than downpayment,more than downpayment,0,4500
diMJCE0k,4500,11/8/2018,10000,diMJCE0k,55000,more than downpayment,more than downpayment,0,4500
diMJCE0k,4500,12/9/2018,10000,diMJCE0k,59500,more than downpayment,more than downpayment,0,4500
diMJCE0k,4500,1/18/2019,10000,diMJCE0k,64000,more than downpayment,more than downpayment,0,4500
DiUqhzmf,8900,2/13/2019,8900,,8900,equal to downpayment,,8900,0
DiUqhzmf,3900,3/16/2019,8900,DiUqhzmf,12800,more than downpayment,equal to downpayment,0,3900
DiUqhzmf,3900,4/18/2019,8900,DiUqhzmf,16700,more than downpayment,more than downpayment,0,3900
DiUqhzmf,7800,6/12/2019,8900,DiUqhzmf,24500,more than downpayment,more than downpayment,0,7800
DiUqhzmf,3900,7/17/2019,8900,DiUqhzmf,28400,more than downpayment,more than downpayment,0,3900
DiUqhzmf,3900,10/17/2019,8900,DiUqhzmf,32300,more than downpayment,more than downpayment,0,3900
DiUqhzmf,7800,11/8/2019,8900,DiUqhzmf,40100,more than downpayment,more than downpayment,0,7800
DiUqhzmf,3900,12/21/2019,8900,DiUqhzmf,44000,more than downpayment,more than downpayment,0,3900
DIV8UUAX,9900,10/4/2019,9900,,9900,equal to downpayment,,9900,0
DIV8UUAX,3900,11/14/2019,9900,DIV8UUAX,13800,more than downpayment,equal to downpayment,0,3900
DIV8UUAX,3900,12/13/2019,9900,DIV8UUAX,17700,more than downpayment,more than downpayment,0,3900
DIV8UUAX,3900,2/2/2020,9900,DIV8UUAX,21600,more than downpayment,more than downpayment,0,3900
DJIZ14YM,9900,12/7/2019,9900,,9900,equal to downpayment,,9900,0
DjR0WGw2,10000,6/3/2019,10000,,10000,equal to downpayment,,10000,0
DjR0WGw2,4500,7/10/2019,10000,DjR0WGw2,14500,more than downpayment,equal to downpayment,0,4500
DjR0WGw2,4500,8/12/2019,10000,DjR0WGw2,19000,more than downpayment,more than downpayment,0,4500
DjR0WGw2,4500,9/11/2019,10000,DjR0WGw2,23500,more than downpayment,more than downpayment,0,4500
DjR0WGw2,4500,10/15/2019,10000,DjR0WGw2,28000,more than downpayment,more than downpayment,0,4500
DjR0WGw2,4500,11/15/2019,10000,DjR0WGw2,32500,more than downpayment,more than downpayment,0,4500
DjR0WGw2,4500,12/13/2019,10000,DjR0WGw2,37000,more than downpayment,more than downpayment,0,4500
DjR0WGw2,4500,1/14/2020,10000,DjR0WGw2,41500,more than downpayment,more than downpayment,0,4500
DjR0WGw2,4500,2/9/2020,10000,DjR0WGw2,46000,more than downpayment,more than downpayment,0,4500
DK31JF5F,8900,5/24/2019,8900,,8900,equal to downpayment,,8900,0
DK31JF5F,3900,7/12/2019,8900,DK31JF5F,12800,more than downpayment,equal to downpayment,0,3900
DK31JF5F,3900,7/25/2019,8900,DK31JF5F,16700,more than downpayment,more than downpayment,0,3900
DK31JF5F,3900,9/5/2019,8900,DK31JF5F,20600,more than downpayment,more than downpayment,0,3900
DK31JF5F,3900,10/4/2019,8900,DK31JF5F,24500,more than downpayment,more than downpayment,0,3900
DK31JF5F,3900,10/28/2019,8900,DK31JF5F,28400,more than downpayment,more than downpayment,0,3900
DK31JF5F,3900,11/19/2019,8900,DK31JF5F,32300,more than downpayment,more than downpayment,0,3900
DK31JF5F,3900,1/3/2020,8900,DK31JF5F,36200,more than downpayment,more than downpayment,0,3900
DK31JF5F,3900,1/29/2020,8900,DK31JF5F,40100,more than downpayment,more than downpayment,0,3900
dKIUoqpG,9900,6/30/2019,9900,,9900,equal to downpayment,,9900,0
dKIUoqpG,3900,8/23/2019,9900,dKIUoqpG,13800,more than downpayment,equal to downpayment,0,3900
dKIUoqpG,3900,9/26/2019,9900,dKIUoqpG,17700,more than downpayment,more than downpayment,0,3900
dKIUoqpG,3900,11/19/2019,9900,dKIUoqpG,21600,more than downpayment,more than downpayment,0,3900
dKIUoqpG,3900,12/13/2019,9900,dKIUoqpG,25500,more than downpayment,more than downpayment,0,3900
dKIUoqpG,3900,1/22/2020,9900,dKIUoqpG,29400,more than downpayment,more than downpayment,0,3900
DL6Y2GD1,9900,9/29/2019,9900,,9900,equal to downpayment,,9900,0
DL6Y2GD1,3900,11/13/2019,9900,DL6Y2GD1,13800,more than downpayment,equal to downpayment,0,3900
DL6Y2GD1,3900,12/13/2019,9900,DL6Y2GD1,17700,more than downpayment,more than downpayment,0,3900
DL6Y2GD1,3900,1/14/2020,9900,DL6Y2GD1,21600,more than downpayment,more than downpayment,0,3900
dM6B0qDU,9900,11/29/2018,9900,,9900,equal to downpayment,,9900,0
dM6B0qDU,4500,1/29/2019,9900,dM6B0qDU,14400,more than downpayment,equal to downpayment,0,4500
dM6B0qDU,4500,3/27/2019,9900,dM6B0qDU,18900,more than downpayment,more than downpayment,0,4500
dM6B0qDU,4500,5/10/2019,9900,dM6B0qDU,23400,more than downpayment,more than downpayment,0,4500
dM6B0qDU,9000,7/3/2019,9900,dM6B0qDU,32400,more than downpayment,more than downpayment,0,9000
dM6B0qDU,5000,8/7/2019,9900,dM6B0qDU,37400,more than downpayment,more than downpayment,0,5000
dM6B0qDU,9000,1/28/2020,9900,dM6B0qDU,46400,more than downpayment,more than downpayment,0,9000
DmHAseHt,8000,6/7/2019,8900,,8000,less than downpayment,,8000,0
DmHAseHt,1900,6/8/2019,8900,DmHAseHt,9900,more than downpayment,less than downpayment,900,1000
DmHAseHt,3900,7/25/2019,8900,DmHAseHt,13800,more than downpayment,more than downpayment,0,3900
DmHAseHt,3900,8/30/2019,8900,DmHAseHt,17700,more than downpayment,more than downpayment,0,3900
DmHAseHt,1500,12/9/2019,8900,DmHAseHt,19200,more than downpayment,more than downpayment,0,1500
DmHAseHt,10000,12/20/2019,8900,DmHAseHt,29200,more than downpayment,more than downpayment,0,10000
DMIJ4F9X,9900,12/2/2019,9900,,9900,equal to downpayment,,9900,0
DMIJ4F9X,3900,2/8/2020,9900,DMIJ4F9X,13800,more than downpayment,equal to downpayment,0,3900
DNn6xMzR,9900,6/12/2019,9900,,9900,equal to downpayment,,9900,0
DNn6xMzR,3900,8/7/2019,9900,DNn6xMzR,13800,more than downpayment,equal to downpayment,0,3900
DNn6xMzR,3900,10/1/2019,9900,DNn6xMzR,17700,more than downpayment,more than downpayment,0,3900
DNn6xMzR,7800,11/25/2019,9900,DNn6xMzR,25500,more than downpayment,more than downpayment,0,7800
DNn6xMzR,3900,12/5/2019,9900,DNn6xMzR,29400,more than downpayment,more than downpayment,0,3900
DNn6xMzR,3900,1/15/2020,9900,DNn6xMzR,33300,more than downpayment,more than downpayment,0,3900
dNQhGrXb,10000,8/2/2018,10000,,10000,equal to downpayment,,10000,0
dNQhGrXb,4500,9/15/2018,10000,dNQhGrXb,14500,more than downpayment,equal to downpayment,0,4500
dNQhGrXb,4500,10/16/2018,10000,dNQhGrXb,19000,more than downpayment,more than downpayment,0,4500
dNQhGrXb,4500,11/14/2018,10000,dNQhGrXb,23500,more than downpayment,more than downpayment,0,4500
dNQhGrXb,4500,12/15/2018,10000,dNQhGrXb,28000,more than downpayment,more than downpayment,0,4500
dNQhGrXb,4500,1/14/2019,10000,dNQhGrXb,32500,more than downpayment,more than downpayment,0,4500
dNQhGrXb,4500,2/17/2019,10000,dNQhGrXb,37000,more than downpayment,more than downpayment,0,4500
dNQhGrXb,4500,3/15/2019,10000,dNQhGrXb,41500,more than downpayment,more than downpayment,0,4500
dNQhGrXb,4500,4/15/2019,10000,dNQhGrXb,46000,more than downpayment,more than downpayment,0,4500
dNQhGrXb,4500,5/15/2019,10000,dNQhGrXb,50500,more than downpayment,more than downpayment,0,4500
dNQhGrXb,4500,6/15/2019,10000,dNQhGrXb,55000,more than downpayment,more than downpayment,0,4500
dNQhGrXb,4500,7/14/2019,10000,dNQhGrXb,59500,more than downpayment,more than downpayment,0,4500
dNQhGrXb,4500,8/16/2019,10000,dNQhGrXb,64000,more than downpayment,more than downpayment,0,4500
DNrhUFPK,9900,9/5/2019,9900,,9900,equal to downpayment,,9900,0
DNrhUFPK,3900,10/7/2019,9900,DNrhUFPK,13800,more than downpayment,equal to downpayment,0,3900
DNrhUFPK,3900,11/27/2019,9900,DNrhUFPK,17700,more than downpayment,more than downpayment,0,3900
DNrhUFPK,3900,12/5/2019,9900,DNrhUFPK,21600,more than downpayment,more than downpayment,0,3900
DNrhUFPK,3900,1/11/2020,9900,DNrhUFPK,25500,more than downpayment,more than downpayment,0,3900
DNrhUFPK,3900,2/7/2020,9900,DNrhUFPK,29400,more than downpayment,more than downpayment,0,3900
DNZPPABR,10000,9/26/2019,9900,,10000,more than downpayment,,9900,100
DNZPPABR,10000,11/22/2019,9900,DNZPPABR,20000,more than downpayment,more than downpayment,0,10000
DNZPPABR,5000,12/27/2019,9900,DNZPPABR,25000,more than downpayment,more than downpayment,0,5000
DNZPPABR,5000,1/27/2020,9900,DNZPPABR,30000,more than downpayment,more than downpayment,0,5000
DO5YFRC5,9900,1/22/2020,9900,,9900,equal to downpayment,,9900,0
DOMRMHFX,9900,12/9/2019,9900,,9900,equal to downpayment,,9900,0
dp0nK9P7,8900,5/21/2019,8900,,8900,equal to downpayment,,8900,0
dp0nK9P7,3900,6/28/2019,8900,dp0nK9P7,12800,more than downpayment,equal to downpayment,0,3900
dp0nK9P7,3900,8/1/2019,8900,dp0nK9P7,16700,more than downpayment,more than downpayment,0,3900
dp0nK9P7,3900,9/1/2019,8900,dp0nK9P7,20600,more than downpayment,more than downpayment,0,3900
dp0nK9P7,3900,10/5/2019,8900,dp0nK9P7,24500,more than downpayment,more than downpayment,0,3900
dp0nK9P7,3900,11/6/2019,8900,dp0nK9P7,28400,more than downpayment,more than downpayment,0,3900
dp0nK9P7,3900,12/4/2019,8900,dp0nK9P7,32300,more than downpayment,more than downpayment,0,3900
dp0nK9P7,3900,1/4/2020,8900,dp0nK9P7,36200,more than downpayment,more than downpayment,0,3900
dp0nK9P7,3900,2/1/2020,8900,dp0nK9P7,40100,more than downpayment,more than downpayment,0,3900
DP6Z3PCV,2000,6/28/2019,1999,,2000,more than downpayment,,1999,1
DP6Z3PCV,2000,8/13/2019,1999,DP6Z3PCV,4000,more than downpayment,more than downpayment,0,2000
DP6Z3PCV,2000,9/9/2019,1999,DP6Z3PCV,6000,more than downpayment,more than downpayment,0,2000
DP6Z3PCV,2000,10/14/2019,1999,DP6Z3PCV,8000,more than downpayment,more than downpayment,0,2000
DP6Z3PCV,2000,11/13/2019,1999,DP6Z3PCV,10000,more than downpayment,more than downpayment,0,2000
DP6Z3PCV,2000,12/14/2019,1999,DP6Z3PCV,12000,more than downpayment,more than downpayment,0,2000
DP6Z3PCV,2000,1/13/2020,1999,DP6Z3PCV,14000,more than downpayment,more than downpayment,0,2000
DPJN478D,9900,11/27/2019,9900,,9900,equal to downpayment,,9900,0
DPJN478D,3900,2/7/2020,9900,DPJN478D,13800,more than downpayment,equal to downpayment,0,3900
DpQhojPY,8900,3/14/2019,8900,,8900,equal to downpayment,,8900,0
DpQhojPY,4000,3/16/2019,8900,DpQhojPY,12900,more than downpayment,equal to downpayment,0,4000
DpQhojPY,3900,3/28/2019,8900,DpQhojPY,16800,more than downpayment,more than downpayment,0,3900
DpQhojPY,3800,4/5/2019,8900,DpQhojPY,20600,more than downpayment,more than downpayment,0,3800
DpQhojPY,3900,6/5/2019,8900,DpQhojPY,24500,more than downpayment,more than downpayment,0,3900
DpQhojPY,2000,8/10/2019,8900,DpQhojPY,26500,more than downpayment,more than downpayment,0,2000
DpQhojPY,1900,8/14/2019,8900,DpQhojPY,28400,more than downpayment,more than downpayment,0,1900
DpQhojPY,1900,9/10/2019,8900,DpQhojPY,30300,more than downpayment,more than downpayment,0,1900
DpQhojPY,2000,9/11/2019,8900,DpQhojPY,32300,more than downpayment,more than downpayment,0,2000
DpQhojPY,2000,10/13/2019,8900,DpQhojPY,34300,more than downpayment,more than downpayment,0,2000
DpQhojPY,1900,10/15/2019,8900,DpQhojPY,36200,more than downpayment,more than downpayment,0,1900
DpQhojPY,1900,11/15/2019,8900,DpQhojPY,38100,more than downpayment,more than downpayment,0,1900
DpQhojPY,1000,11/22/2019,8900,DpQhojPY,39100,more than downpayment,more than downpayment,0,1000
DpQhojPY,1000,12/6/2019,8900,DpQhojPY,40100,more than downpayment,more than downpayment,0,1000
DpQhojPY,1500,12/21/2019,8900,DpQhojPY,41600,more than downpayment,more than downpayment,0,1500
DpQhojPY,1000,1/11/2020,8900,DpQhojPY,42600,more than downpayment,more than downpayment,0,1000
DpQhojPY,1400,1/29/2020,8900,DpQhojPY,44000,more than downpayment,more than downpayment,0,1400
dpuUCQ7W,9900,7/3/2019,9900,,9900,equal to downpayment,,9900,0
DpwPqr4H,9000,7/15/2019,8900,,9000,more than downpayment,,8900,100
DpwPqr4H,3900,9/3/2019,8900,DpwPqr4H,12900,more than downpayment,more than downpayment,0,3900
DpwPqr4H,3900,10/4/2019,8900,DpwPqr4H,16800,more than downpayment,more than downpayment,0,3900
DpwPqr4H,3900,11/4/2019,8900,DpwPqr4H,20700,more than downpayment,more than downpayment,0,3900
DpwPqr4H,3900,12/9/2019,8900,DpwPqr4H,24600,more than downpayment,more than downpayment,0,3900
DpwPqr4H,3900,1/6/2020,8900,DpwPqr4H,28500,more than downpayment,more than downpayment,0,3900
DpwPqr4H,3900,2/4/2020,8900,DpwPqr4H,32400,more than downpayment,more than downpayment,0,3900
Dq0Q1SOB,10000,9/11/2017,10000,,10000,equal to downpayment,,10000,0
Dq0Q1SOB,3500,10/12/2017,10000,Dq0Q1SOB,13500,more than downpayment,equal to downpayment,0,3500
Dq0Q1SOB,3500,11/9/2017,10000,Dq0Q1SOB,17000,more than downpayment,more than downpayment,0,3500
Dq0Q1SOB,3500,12/13/2017,10000,Dq0Q1SOB,20500,more than downpayment,more than downpayment,0,3500
Dq0Q1SOB,3500,1/10/2018,10000,Dq0Q1SOB,24000,more than downpayment,more than downpayment,0,3500
Dq0Q1SOB,3500,3/9/2018,10000,Dq0Q1SOB,27500,more than downpayment,more than downpayment,0,3500
Dq0Q1SOB,3500,7/23/2018,10000,Dq0Q1SOB,31000,more than downpayment,more than downpayment,0,3500
Dq0Q1SOB,3500,8/20/2018,10000,Dq0Q1SOB,34500,more than downpayment,more than downpayment,0,3500
DQE8812G,9900,12/9/2019,9900,,9900,equal to downpayment,,9900,0
DQE8812G,130,1/8/2020,9900,DQE8812G,10030,more than downpayment,equal to downpayment,0,130
DQE8812G,130,1/9/2020,9900,DQE8812G,10160,more than downpayment,more than downpayment,0,130
DQE8812G,130,1/25/2020,9900,DQE8812G,10290,more than downpayment,more than downpayment,0,130
DQE8812G,130,2/7/2020,9900,DQE8812G,10420,more than downpayment,more than downpayment,0,130
DQITGURA,9900,7/22/2019,9900,,9900,equal to downpayment,,9900,0
DQITGURA,3900,9/26/2019,9900,DQITGURA,13800,more than downpayment,equal to downpayment,0,3900
dqvGvHci,8900,8/5/2019,8900,,8900,equal to downpayment,,8900,0
dqvGvHci,3500,10/2/2019,8900,dqvGvHci,12400,more than downpayment,equal to downpayment,0,3500
dqvGvHci,3500,11/11/2019,8900,dqvGvHci,15900,more than downpayment,more than downpayment,0,3500
dqvGvHci,3500,12/11/2019,8900,dqvGvHci,19400,more than downpayment,more than downpayment,0,3500
dqvGvHci,3500,1/10/2020,8900,dqvGvHci,22900,more than downpayment,more than downpayment,0,3500
DQWNYUQA,8900,12/23/2019,8900,,8900,equal to downpayment,,8900,0
DR1KYLD5,7900,11/5/2019,7900,,7900,equal to downpayment,,7900,0
DR1KYLD5,3100,12/21/2019,7900,DR1KYLD5,11000,more than downpayment,equal to downpayment,0,3100
DR1KYLD5,3100,1/25/2020,7900,DR1KYLD5,14100,more than downpayment,more than downpayment,0,3100
dR7MwQlV,24500,6/28/2019,24400,,24500,more than downpayment,,24400,100
dR7MwQlV,7300,8/5/2019,24400,dR7MwQlV,31800,more than downpayment,more than downpayment,0,7300
dR7MwQlV,7300,9/9/2019,24400,dR7MwQlV,39100,more than downpayment,more than downpayment,0,7300
dR7MwQlV,7300,10/7/2019,24400,dR7MwQlV,46400,more than downpayment,more than downpayment,0,7300
dR7MwQlV,7300,11/7/2019,24400,dR7MwQlV,53700,more than downpayment,more than downpayment,0,7300
dR7MwQlV,7300,12/26/2019,24400,dR7MwQlV,61000,more than downpayment,more than downpayment,0,7300
dR7MwQlV,7300,1/6/2020,24400,dR7MwQlV,68300,more than downpayment,more than downpayment,0,7300
DRBOIULX,10000,8/9/2019,9900,,10000,more than downpayment,,9900,100
DRBOIULX,4000,9/17/2019,9900,DRBOIULX,14000,more than downpayment,more than downpayment,0,4000
DRBOIULX,4000,10/13/2019,9900,DRBOIULX,18000,more than downpayment,more than downpayment,0,4000
DRBOIULX,4000,12/1/2019,9900,DRBOIULX,22000,more than downpayment,more than downpayment,0,4000
DRBOIULX,3300,12/31/2019,9900,DRBOIULX,25300,more than downpayment,more than downpayment,0,3300
DRBOIULX,200,1/15/2020,9900,DRBOIULX,25500,more than downpayment,more than downpayment,0,200
DRBOIULX,3900,1/30/2020,9900,DRBOIULX,29400,more than downpayment,more than downpayment,0,3900
DRDAOLDX,8900,5/21/2019,8900,,8900,equal to downpayment,,8900,0
DRDAOLDX,130,6/13/2019,8900,DRDAOLDX,9030,more than downpayment,equal to downpayment,0,130
DRDAOLDX,130,6/16/2019,8900,DRDAOLDX,9160,more than downpayment,more than downpayment,0,130
DRDAOLDX,70,6/19/2019,8900,DRDAOLDX,9230,more than downpayment,more than downpayment,0,70
DRDAOLDX,100,6/22/2019,8900,DRDAOLDX,9330,more than downpayment,more than downpayment,0,100
DRDAOLDX,70,6/23/2019,8900,DRDAOLDX,9400,more than downpayment,more than downpayment,0,70
DRDAOLDX,100,6/26/2019,8900,DRDAOLDX,9500,more than downpayment,more than downpayment,0,100
DRDAOLDX,100,6/28/2019,8900,DRDAOLDX,9600,more than downpayment,more than downpayment,0,100
DRDAOLDX,100,7/1/2019,8900,DRDAOLDX,9700,more than downpayment,more than downpayment,0,100
DRDAOLDX,139,7/5/2019,8900,DRDAOLDX,9839,more than downpayment,more than downpayment,0,139
DRDAOLDX,80,7/9/2019,8900,DRDAOLDX,9919,more than downpayment,more than downpayment,0,80
DRDAOLDX,50,7/10/2019,8900,DRDAOLDX,9969,more than downpayment,more than downpayment,0,50
DRDAOLDX,99,7/13/2019,8900,DRDAOLDX,10068,more than downpayment,more than downpayment,0,99
DRDAOLDX,100,7/15/2019,8900,DRDAOLDX,10168,more than downpayment,more than downpayment,0,100
DRDAOLDX,100,7/20/2019,8900,DRDAOLDX,10268,more than downpayment,more than downpayment,0,100
DRDAOLDX,100,7/23/2019,8900,DRDAOLDX,10368,more than downpayment,more than downpayment,0,100
DRDAOLDX,100,7/24/2019,8900,DRDAOLDX,10468,more than downpayment,more than downpayment,0,100
DRDAOLDX,70,7/27/2019,8900,DRDAOLDX,10538,more than downpayment,more than downpayment,0,70
DRDAOLDX,50,7/28/2019,8900,DRDAOLDX,10588,more than downpayment,more than downpayment,0,50
DRDAOLDX,100,7/29/2019,8900,DRDAOLDX,10688,more than downpayment,more than downpayment,0,100
DRDAOLDX,500,7/31/2019,8900,DRDAOLDX,11188,more than downpayment,more than downpayment,0,500
DRDAOLDX,100,8/2/2019,8900,DRDAOLDX,11288,more than downpayment,more than downpayment,0,100
DRDAOLDX,150,8/4/2019,8900,DRDAOLDX,11438,more than downpayment,more than downpayment,0,150
DRDAOLDX,100,8/5/2019,8900,DRDAOLDX,11538,more than downpayment,more than downpayment,0,100
DRDAOLDX,100,8/6/2019,8900,DRDAOLDX,11638,more than downpayment,more than downpayment,0,100
DRDAOLDX,100,8/9/2019,8900,DRDAOLDX,11738,more than downpayment,more than downpayment,0,100
DRDAOLDX,100,8/17/2019,8900,DRDAOLDX,11838,more than downpayment,more than downpayment,0,100
DRDAOLDX,100,8/21/2019,8900,DRDAOLDX,11938,more than downpayment,more than downpayment,0,100
DRDAOLDX,1000,8/22/2019,8900,DRDAOLDX,12938,more than downpayment,more than downpayment,0,1000
DRDAOLDX,100,8/24/2019,8900,DRDAOLDX,13038,more than downpayment,more than downpayment,0,100
DRDAOLDX,100,8/30/2019,8900,DRDAOLDX,13138,more than downpayment,more than downpayment,0,100
DRDAOLDX,100,9/3/2019,8900,DRDAOLDX,13238,more than downpayment,more than downpayment,0,100
DRDAOLDX,200,9/4/2019,8900,DRDAOLDX,13438,more than downpayment,more than downpayment,0,200
DRDAOLDX,200,9/6/2019,8900,DRDAOLDX,13638,more than downpayment,more than downpayment,0,200
DRDAOLDX,200,9/12/2019,8900,DRDAOLDX,13838,more than downpayment,more than downpayment,0,200
DRDAOLDX,100,9/14/2019,8900,DRDAOLDX,13938,more than downpayment,more than downpayment,0,100
DRDAOLDX,100,9/19/2019,8900,DRDAOLDX,14038,more than downpayment,more than downpayment,0,100
DRDAOLDX,200,9/20/2019,8900,DRDAOLDX,14238,more than downpayment,more than downpayment,0,200
DRDAOLDX,100,9/22/2019,8900,DRDAOLDX,14338,more than downpayment,more than downpayment,0,100
DRDAOLDX,200,9/25/2019,8900,DRDAOLDX,14538,more than downpayment,more than downpayment,0,200
DRDAOLDX,100,9/26/2019,8900,DRDAOLDX,14638,more than downpayment,more than downpayment,0,100
DRDAOLDX,200,10/1/2019,8900,DRDAOLDX,14838,more than downpayment,more than downpayment,0,200
DRDAOLDX,200,10/2/2019,8900,DRDAOLDX,15038,more than downpayment,more than downpayment,0,200
DRDAOLDX,100,10/3/2019,8900,DRDAOLDX,15138,more than downpayment,more than downpayment,0,100
DRDAOLDX,100,10/4/2019,8900,DRDAOLDX,15238,more than downpayment,more than downpayment,0,100
DRDAOLDX,100,10/6/2019,8900,DRDAOLDX,15338,more than downpayment,more than downpayment,0,100
DRDAOLDX,500,10/7/2019,8900,DRDAOLDX,15838,more than downpayment,more than downpayment,0,500
DRDAOLDX,100,10/8/2019,8900,DRDAOLDX,15938,more than downpayment,more than downpayment,0,100
DRDAOLDX,100,10/9/2019,8900,DRDAOLDX,16038,more than downpayment,more than downpayment,0,100
DRDAOLDX,100,10/11/2019,8900,DRDAOLDX,16138,more than downpayment,more than downpayment,0,100
DRDAOLDX,1000,10/12/2019,8900,DRDAOLDX,17138,more than downpayment,more than downpayment,0,1000
DRDAOLDX,100,10/13/2019,8900,DRDAOLDX,17238,more than downpayment,more than downpayment,0,100
DRDAOLDX,132,10/14/2019,8900,DRDAOLDX,17370,more than downpayment,more than downpayment,0,132
DRDAOLDX,100,10/15/2019,8900,DRDAOLDX,17470,more than downpayment,more than downpayment,0,100
DRDAOLDX,100,10/16/2019,8900,DRDAOLDX,17570,more than downpayment,more than downpayment,0,100
DRDAOLDX,100,10/17/2019,8900,DRDAOLDX,17670,more than downpayment,more than downpayment,0,100
DRDAOLDX,100,10/19/2019,8900,DRDAOLDX,17770,more than downpayment,more than downpayment,0,100
DRDAOLDX,100,10/20/2019,8900,DRDAOLDX,17870,more than downpayment,more than downpayment,0,100
DRDAOLDX,100,10/21/2019,8900,DRDAOLDX,17970,more than downpayment,more than downpayment,0,100
DRDAOLDX,200,10/22/2019,8900,DRDAOLDX,18170,more than downpayment,more than downpayment,0,200
DRDAOLDX,100,10/23/2019,8900,DRDAOLDX,18270,more than downpayment,more than downpayment,0,100
DRDAOLDX,100,10/24/2019,8900,DRDAOLDX,18370,more than downpayment,more than downpayment,0,100
DRDAOLDX,108,10/25/2019,8900,DRDAOLDX,18478,more than downpayment,more than downpayment,0,108
DRDAOLDX,400,10/29/2019,8900,DRDAOLDX,18878,more than downpayment,more than downpayment,0,400
DRDAOLDX,200,10/31/2019,8900,DRDAOLDX,19078,more than downpayment,more than downpayment,0,200
DRDAOLDX,200,11/1/2019,8900,DRDAOLDX,19278,more than downpayment,more than downpayment,0,200
DRDAOLDX,200,11/2/2019,8900,DRDAOLDX,19478,more than downpayment,more than downpayment,0,200
DRDAOLDX,200,11/3/2019,8900,DRDAOLDX,19678,more than downpayment,more than downpayment,0,200
DRDAOLDX,200,11/5/2019,8900,DRDAOLDX,19878,more than downpayment,more than downpayment,0,200
DRDAOLDX,200,11/8/2019,8900,DRDAOLDX,20078,more than downpayment,more than downpayment,0,200
DRDAOLDX,200,11/9/2019,8900,DRDAOLDX,20278,more than downpayment,more than downpayment,0,200
DRDAOLDX,100,11/10/2019,8900,DRDAOLDX,20378,more than downpayment,more than downpayment,0,100
DRDAOLDX,400,11/13/2019,8900,DRDAOLDX,20778,more than downpayment,more than downpayment,0,400
DRDAOLDX,200,11/14/2019,8900,DRDAOLDX,20978,more than downpayment,more than downpayment,0,200
DRDAOLDX,200,11/15/2019,8900,DRDAOLDX,21178,more than downpayment,more than downpayment,0,200
DRDAOLDX,200,11/16/2019,8900,DRDAOLDX,21378,more than downpayment,more than downpayment,0,200
DRDAOLDX,100,11/18/2019,8900,DRDAOLDX,21478,more than downpayment,more than downpayment,0,100
DRDAOLDX,100,11/19/2019,8900,DRDAOLDX,21578,more than downpayment,more than downpayment,0,100
DRDAOLDX,200,11/20/2019,8900,DRDAOLDX,21778,more than downpayment,more than downpayment,0,200
DRDAOLDX,100,11/21/2019,8900,DRDAOLDX,21878,more than downpayment,more than downpayment,0,100
DRDAOLDX,200,11/22/2019,8900,DRDAOLDX,22078,more than downpayment,more than downpayment,0,200
DRDAOLDX,200,11/23/2019,8900,DRDAOLDX,22278,more than downpayment,more than downpayment,0,200
DRDAOLDX,200,11/25/2019,8900,DRDAOLDX,22478,more than downpayment,more than downpayment,0,200
DRDAOLDX,100,11/26/2019,8900,DRDAOLDX,22578,more than downpayment,more than downpayment,0,100
DRDAOLDX,200,11/28/2019,8900,DRDAOLDX,22778,more than downpayment,more than downpayment,0,200
DRDAOLDX,200,11/29/2019,8900,DRDAOLDX,22978,more than downpayment,more than downpayment,0,200
DRDAOLDX,200,11/30/2019,8900,DRDAOLDX,23178,more than downpayment,more than downpayment,0,200
DRDAOLDX,300,12/2/2019,8900,DRDAOLDX,23478,more than downpayment,more than downpayment,0,300
DRDAOLDX,200,12/3/2019,8900,DRDAOLDX,23678,more than downpayment,more than downpayment,0,200
DRDAOLDX,200,12/4/2019,8900,DRDAOLDX,23878,more than downpayment,more than downpayment,0,200
DRDAOLDX,200,12/5/2019,8900,DRDAOLDX,24078,more than downpayment,more than downpayment,0,200
DRDAOLDX,322,12/6/2019,8900,DRDAOLDX,24400,more than downpayment,more than downpayment,0,322
DRDAOLDX,250,12/7/2019,8900,DRDAOLDX,24650,more than downpayment,more than downpayment,0,250
DRDAOLDX,300,12/8/2019,8900,DRDAOLDX,24950,more than downpayment,more than downpayment,0,300
DRDAOLDX,300,12/9/2019,8900,DRDAOLDX,25250,more than downpayment,more than downpayment,0,300
DRDAOLDX,300,12/10/2019,8900,DRDAOLDX,25550,more than downpayment,more than downpayment,0,300
DRDAOLDX,300,12/11/2019,8900,DRDAOLDX,25850,more than downpayment,more than downpayment,0,300
DRDAOLDX,300,12/12/2019,8900,DRDAOLDX,26150,more than downpayment,more than downpayment,0,300
DRDAOLDX,300,12/13/2019,8900,DRDAOLDX,26450,more than downpayment,more than downpayment,0,300
DRDAOLDX,300,12/14/2019,8900,DRDAOLDX,26750,more than downpayment,more than downpayment,0,300
DRDAOLDX,300,12/15/2019,8900,DRDAOLDX,27050,more than downpayment,more than downpayment,0,300
DRDAOLDX,500,12/16/2019,8900,DRDAOLDX,27550,more than downpayment,more than downpayment,0,500
DRDAOLDX,350,12/17/2019,8900,DRDAOLDX,27900,more than downpayment,more than downpayment,0,350
DRDAOLDX,200,12/18/2019,8900,DRDAOLDX,28100,more than downpayment,more than downpayment,0,200
DRDAOLDX,300,12/19/2019,8900,DRDAOLDX,28400,more than downpayment,more than downpayment,0,300
DRDAOLDX,400,12/20/2019,8900,DRDAOLDX,28800,more than downpayment,more than downpayment,0,400
DRDAOLDX,200,12/21/2019,8900,DRDAOLDX,29000,more than downpayment,more than downpayment,0,200
DRDAOLDX,350,12/23/2019,8900,DRDAOLDX,29350,more than downpayment,more than downpayment,0,350
DRDAOLDX,100,12/25/2019,8900,DRDAOLDX,29450,more than downpayment,more than downpayment,0,100
DRDAOLDX,300,12/26/2019,8900,DRDAOLDX,29750,more than downpayment,more than downpayment,0,300
DRDAOLDX,400,12/28/2019,8900,DRDAOLDX,30150,more than downpayment,more than downpayment,0,400
DRDAOLDX,400,12/30/2019,8900,DRDAOLDX,30550,more than downpayment,more than downpayment,0,400
DRDAOLDX,350,12/31/2019,8900,DRDAOLDX,30900,more than downpayment,more than downpayment,0,350
DRDAOLDX,600,1/1/2020,8900,DRDAOLDX,31500,more than downpayment,more than downpayment,0,600
DRDAOLDX,300,1/2/2020,8900,DRDAOLDX,31800,more than downpayment,more than downpayment,0,300
DRDAOLDX,100,1/3/2020,8900,DRDAOLDX,31900,more than downpayment,more than downpayment,0,100
DRDAOLDX,200,1/4/2020,8900,DRDAOLDX,32100,more than downpayment,more than downpayment,0,200
DRDAOLDX,400,1/5/2020,8900,DRDAOLDX,32500,more than downpayment,more than downpayment,0,400
DRDAOLDX,300,1/7/2020,8900,DRDAOLDX,32800,more than downpayment,more than downpayment,0,300
DRDAOLDX,300,1/8/2020,8900,DRDAOLDX,33100,more than downpayment,more than downpayment,0,300
DRDAOLDX,300,1/9/2020,8900,DRDAOLDX,33400,more than downpayment,more than downpayment,0,300
DRDAOLDX,300,1/11/2020,8900,DRDAOLDX,33700,more than downpayment,more than downpayment,0,300
DRDAOLDX,300,1/12/2020,8900,DRDAOLDX,34000,more than downpayment,more than downpayment,0,300
DRDAOLDX,300,1/13/2020,8900,DRDAOLDX,34300,more than downpayment,more than downpayment,0,300
DRDAOLDX,100,1/15/2020,8900,DRDAOLDX,34400,more than downpayment,more than downpayment,0,100
DRDAOLDX,300,1/16/2020,8900,DRDAOLDX,34700,more than downpayment,more than downpayment,0,300
DRDAOLDX,300,1/17/2020,8900,DRDAOLDX,35000,more than downpayment,more than downpayment,0,300
DRDAOLDX,300,1/18/2020,8900,DRDAOLDX,35300,more than downpayment,more than downpayment,0,300
DRDAOLDX,300,1/19/2020,8900,DRDAOLDX,35600,more than downpayment,more than downpayment,0,300
DRDAOLDX,300,1/20/2020,8900,DRDAOLDX,35900,more than downpayment,more than downpayment,0,300
DRDAOLDX,300,1/21/2020,8900,DRDAOLDX,36200,more than downpayment,more than downpayment,0,300
DRDAOLDX,100,1/22/2020,8900,DRDAOLDX,36300,more than downpayment,more than downpayment,0,100
DRDAOLDX,200,1/23/2020,8900,DRDAOLDX,36500,more than downpayment,more than downpayment,0,200
DRDAOLDX,300,1/25/2020,8900,DRDAOLDX,36800,more than downpayment,more than downpayment,0,300
DRDAOLDX,200,1/26/2020,8900,DRDAOLDX,37000,more than downpayment,more than downpayment,0,200
DRDAOLDX,300,1/27/2020,8900,DRDAOLDX,37300,more than downpayment,more than downpayment,0,300
DRDAOLDX,300,1/28/2020,8900,DRDAOLDX,37600,more than downpayment,more than downpayment,0,300
DRDAOLDX,100,1/29/2020,8900,DRDAOLDX,37700,more than downpayment,more than downpayment,0,100
DRDAOLDX,100,1/30/2020,8900,DRDAOLDX,37800,more than downpayment,more than downpayment,0,100
DRDAOLDX,200,1/31/2020,8900,DRDAOLDX,38000,more than downpayment,more than downpayment,0,200
DRDAOLDX,400,2/1/2020,8900,DRDAOLDX,38400,more than downpayment,more than downpayment,0,400
DRDAOLDX,200,2/2/2020,8900,DRDAOLDX,38600,more than downpayment,more than downpayment,0,200
DRDAOLDX,300,2/3/2020,8900,DRDAOLDX,38900,more than downpayment,more than downpayment,0,300
DRDAOLDX,200,2/4/2020,8900,DRDAOLDX,39100,more than downpayment,more than downpayment,0,200
DRDAOLDX,200,2/5/2020,8900,DRDAOLDX,39300,more than downpayment,more than downpayment,0,200
DRDAOLDX,300,2/6/2020,8900,DRDAOLDX,39600,more than downpayment,more than downpayment,0,300
DRDAOLDX,200,2/7/2020,8900,DRDAOLDX,39800,more than downpayment,more than downpayment,0,200
DRDAOLDX,300,2/8/2020,8900,DRDAOLDX,40100,more than downpayment,more than downpayment,0,300
DRDAOLDX,230,2/9/2020,8900,DRDAOLDX,40330,more than downpayment,more than downpayment,0,230
DRFHTCAm,8900,6/18/2019,8900,,8900,equal to downpayment,,8900,0
DRFHTCAm,1000,6/25/2019,8900,DRFHTCAm,9900,more than downpayment,equal to downpayment,0,1000
DRFHTCAm,3900,8/5/2019,8900,DRFHTCAm,13800,more than downpayment,more than downpayment,0,3900
DRFHTCAm,3900,9/5/2019,8900,DRFHTCAm,17700,more than downpayment,more than downpayment,0,3900
DRFHTCAm,3900,10/7/2019,8900,DRFHTCAm,21600,more than downpayment,more than downpayment,0,3900
DRFHTCAm,3900,11/5/2019,8900,DRFHTCAm,25500,more than downpayment,more than downpayment,0,3900
DRFHTCAm,3900,12/6/2019,8900,DRFHTCAm,29400,more than downpayment,more than downpayment,0,3900
drGylLuZ,10000,9/13/2018,10000,,10000,equal to downpayment,,10000,0
drGylLuZ,4500,10/29/2018,10000,drGylLuZ,14500,more than downpayment,equal to downpayment,0,4500
drGylLuZ,4500,11/26/2018,10000,drGylLuZ,19000,more than downpayment,more than downpayment,0,4500
drGylLuZ,4500,1/4/2019,10000,drGylLuZ,23500,more than downpayment,more than downpayment,0,4500
drGylLuZ,4500,2/27/2019,10000,drGylLuZ,28000,more than downpayment,more than downpayment,0,4500
drGylLuZ,4500,3/27/2019,10000,drGylLuZ,32500,more than downpayment,more than downpayment,0,4500
drGylLuZ,4500,5/9/2019,10000,drGylLuZ,37000,more than downpayment,more than downpayment,0,4500
drGylLuZ,4500,5/30/2019,10000,drGylLuZ,41500,more than downpayment,more than downpayment,0,4500
drGylLuZ,4500,7/1/2019,10000,drGylLuZ,46000,more than downpayment,more than downpayment,0,4500
drGylLuZ,4500,7/29/2019,10000,drGylLuZ,50500,more than downpayment,more than downpayment,0,4500
drGylLuZ,4500,9/6/2019,10000,drGylLuZ,55000,more than downpayment,more than downpayment,0,4500
drGylLuZ,4500,10/15/2019,10000,drGylLuZ,59500,more than downpayment,more than downpayment,0,4500
ds9F4jXO,18454,8/5/2019,8900,,18454,more than downpayment,,8900,9554
ds9F4jXO,3500,9/29/2019,8900,ds9F4jXO,21954,more than downpayment,more than downpayment,0,3500
ds9F4jXO,3500,12/20/2019,8900,ds9F4jXO,25454,more than downpayment,more than downpayment,0,3500
ds9F4jXO,3500,1/29/2020,8900,ds9F4jXO,28954,more than downpayment,more than downpayment,0,3500
dtbn5fjl,10000,6/1/2017,10000,,10000,equal to downpayment,,10000,0
dtbn5fjl,10000,8/3/2017,10000,dtbn5fjl,20000,more than downpayment,equal to downpayment,0,10000
DTFTNJLJ,8900,1/13/2020,8900,,8900,equal to downpayment,,8900,0
dUkdRUN2,10000,3/16/2019,10000,,10000,equal to downpayment,,10000,0
dUkdRUN2,24000,3/30/2019,10000,dUkdRUN2,34000,more than downpayment,equal to downpayment,0,24000
dUkdRUN2,10000,4/24/2019,10000,dUkdRUN2,44000,more than downpayment,more than downpayment,0,10000
dUkdRUN2,8000,7/24/2019,10000,dUkdRUN2,52000,more than downpayment,more than downpayment,0,8000
DUlmvw4A,8900,2/6/2019,8900,,8900,equal to downpayment,,8900,0
DUlmvw4A,3900,3/12/2019,8900,DUlmvw4A,12800,more than downpayment,equal to downpayment,0,3900
DUlmvw4A,3900,4/12/2019,8900,DUlmvw4A,16700,more than downpayment,more than downpayment,0,3900
DUlmvw4A,3900,5/12/2019,8900,DUlmvw4A,20600,more than downpayment,more than downpayment,0,3900
DUlmvw4A,3900,6/12/2019,8900,DUlmvw4A,24500,more than downpayment,more than downpayment,0,3900
DUlmvw4A,3900,7/12/2019,8900,DUlmvw4A,28400,more than downpayment,more than downpayment,0,3900
DUlmvw4A,2000,8/12/2019,8900,DUlmvw4A,30400,more than downpayment,more than downpayment,0,2000
DUlmvw4A,1900,10/6/2019,8900,DUlmvw4A,32300,more than downpayment,more than downpayment,0,1900
DUlmvw4A,3900,10/18/2019,8900,DUlmvw4A,36200,more than downpayment,more than downpayment,0,3900
DUlmvw4A,2000,10/23/2019,8900,DUlmvw4A,38200,more than downpayment,more than downpayment,0,2000
DUlmvw4A,3900,11/4/2019,8900,DUlmvw4A,42100,more than downpayment,more than downpayment,0,3900
DUlmvw4A,1900,11/8/2019,8900,DUlmvw4A,44000,more than downpayment,more than downpayment,0,1900
DUlmvw4A,3900,12/20/2019,8900,DUlmvw4A,47900,more than downpayment,more than downpayment,0,3900
DUlmvw4A,2000,1/13/2020,8900,DUlmvw4A,49900,more than downpayment,more than downpayment,0,2000
DUlmvw4A,1900,1/20/2020,8900,DUlmvw4A,51800,more than downpayment,more than downpayment,0,1900
dVefAL16,8900,4/4/2019,8900,,8900,equal to downpayment,,8900,0
dVefAL16,3900,5/8/2019,8900,dVefAL16,12800,more than downpayment,equal to downpayment,0,3900
dVefAL16,3900,6/8/2019,8900,dVefAL16,16700,more than downpayment,more than downpayment,0,3900
dVefAL16,3900,7/9/2019,8900,dVefAL16,20600,more than downpayment,more than downpayment,0,3900
dVefAL16,3900,8/20/2019,8900,dVefAL16,24500,more than downpayment,more than downpayment,0,3900
dVefAL16,3900,9/20/2019,8900,dVefAL16,28400,more than downpayment,more than downpayment,0,3900
dVefAL16,3900,10/21/2019,8900,dVefAL16,32300,more than downpayment,more than downpayment,0,3900
dVefAL16,3900,11/23/2019,8900,dVefAL16,36200,more than downpayment,more than downpayment,0,3900
dVefAL16,3900,12/23/2019,8900,dVefAL16,40100,more than downpayment,more than downpayment,0,3900
dVefAL16,3900,1/23/2020,8900,dVefAL16,44000,more than downpayment,more than downpayment,0,3900
dvSf3DAh,8900,7/2/2019,9900,,8900,less than downpayment,,8900,0
dvSf3DAh,1000,7/8/2019,9900,dvSf3DAh,9900,equal to downpayment,less than downpayment,1000,0
dvSf3DAh,3900,8/29/2019,9900,dvSf3DAh,13800,more than downpayment,equal to downpayment,0,3900
dvSf3DAh,3900,10/17/2019,9900,dvSf3DAh,17700,more than downpayment,more than downpayment,0,3900
dvSf3DAh,4000,11/27/2019,9900,dvSf3DAh,21700,more than downpayment,more than downpayment,0,4000
dvSf3DAh,3800,12/18/2019,9900,dvSf3DAh,25500,more than downpayment,more than downpayment,0,3800
dvSf3DAh,3900,1/6/2020,9900,dvSf3DAh,29400,more than downpayment,more than downpayment,0,3900
dvSf3DAh,3900,2/3/2020,9900,dvSf3DAh,33300,more than downpayment,more than downpayment,0,3900
dW220VYi,10000,10/22/2018,10000,,10000,equal to downpayment,,10000,0
dW220VYi,4500,12/6/2018,10000,dW220VYi,14500,more than downpayment,equal to downpayment,0,4500
dW220VYi,4500,1/7/2019,10000,dW220VYi,19000,more than downpayment,more than downpayment,0,4500
dW220VYi,4500,2/6/2019,10000,dW220VYi,23500,more than downpayment,more than downpayment,0,4500
dW220VYi,2350,2/27/2019,10000,dW220VYi,25850,more than downpayment,more than downpayment,0,2350
dW220VYi,2150,3/5/2019,10000,dW220VYi,28000,more than downpayment,more than downpayment,0,2150
dW220VYi,4000,3/29/2019,10000,dW220VYi,32000,more than downpayment,more than downpayment,0,4000
dW220VYi,500,4/5/2019,10000,dW220VYi,32500,more than downpayment,more than downpayment,0,500
dW220VYi,4000,5/2/2019,10000,dW220VYi,36500,more than downpayment,more than downpayment,0,4000
dW220VYi,500,5/16/2019,10000,dW220VYi,37000,more than downpayment,more than downpayment,0,500
dW220VYi,4500,6/4/2019,10000,dW220VYi,41500,more than downpayment,more than downpayment,0,4500
dW220VYi,4500,7/7/2019,10000,dW220VYi,46000,more than downpayment,more than downpayment,0,4500
dW220VYi,3500,8/5/2019,10000,dW220VYi,49500,more than downpayment,more than downpayment,0,3500
dW220VYi,1000,9/2/2019,10000,dW220VYi,50500,more than downpayment,more than downpayment,0,1000
dW220VYi,4500,9/26/2019,10000,dW220VYi,55000,more than downpayment,more than downpayment,0,4500
dW220VYi,4500,10/26/2019,10000,dW220VYi,59500,more than downpayment,more than downpayment,0,4500
dW220VYi,4500,12/12/2019,10000,dW220VYi,64000,more than downpayment,more than downpayment,0,4500
Dw33uzvo,8900,6/13/2019,8900,,8900,equal to downpayment,,8900,0
Dw33uzvo,1000,6/14/2019,8900,Dw33uzvo,9900,more than downpayment,equal to downpayment,0,1000
Dw33uzvo,4000,8/25/2019,8900,Dw33uzvo,13900,more than downpayment,more than downpayment,0,4000
Dw33uzvo,4000,9/25/2019,8900,Dw33uzvo,17900,more than downpayment,more than downpayment,0,4000
Dw33uzvo,4000,10/24/2019,8900,Dw33uzvo,21900,more than downpayment,more than downpayment,0,4000
Dw33uzvo,4000,11/25/2019,8900,Dw33uzvo,25900,more than downpayment,more than downpayment,0,4000
Dw33uzvo,2500,1/1/2020,8900,Dw33uzvo,28400,more than downpayment,more than downpayment,0,2500
Dw33uzvo,4000,1/23/2020,8900,Dw33uzvo,32400,more than downpayment,more than downpayment,0,4000
Dw8nsiYo,9900,7/8/2019,9900,,9900,equal to downpayment,,9900,0
Dw8nsiYo,3900,8/5/2019,9900,Dw8nsiYo,13800,more than downpayment,equal to downpayment,0,3900
Dw8nsiYo,3900,9/4/2019,9900,Dw8nsiYo,17700,more than downpayment,more than downpayment,0,3900
Dw8nsiYo,3900,9/15/2019,9900,Dw8nsiYo,21600,more than downpayment,more than downpayment,0,3900
Dw8nsiYo,3390,10/3/2019,9900,Dw8nsiYo,24990,more than downpayment,more than downpayment,0,3390
Dw8nsiYo,3900,11/4/2019,9900,Dw8nsiYo,28890,more than downpayment,more than downpayment,0,3900
Dw8nsiYo,3900,12/5/2019,9900,Dw8nsiYo,32790,more than downpayment,more than downpayment,0,3900
Dw8nsiYo,3900,1/5/2020,9900,Dw8nsiYo,36690,more than downpayment,more than downpayment,0,3900
Dw8nsiYo,3900,2/4/2020,9900,Dw8nsiYo,40590,more than downpayment,more than downpayment,0,3900
DwglEsqX,13535,2/13/2019,8900,,13535,more than downpayment,,8900,4635
DwglEsqX,3900,3/29/2019,8900,DwglEsqX,17435,more than downpayment,more than downpayment,0,3900
DwglEsqX,2000,5/1/2019,8900,DwglEsqX,19435,more than downpayment,more than downpayment,0,2000
DwglEsqX,5800,5/22/2019,8900,DwglEsqX,25235,more than downpayment,more than downpayment,0,5800
DwglEsqX,3900,7/4/2019,8900,DwglEsqX,29135,more than downpayment,more than downpayment,0,3900
DwglEsqX,7800,9/10/2019,8900,DwglEsqX,36935,more than downpayment,more than downpayment,0,7800
DwglEsqX,7800,9/30/2019,8900,DwglEsqX,44735,more than downpayment,more than downpayment,0,7800
DwglEsqX,7800,11/2/2019,8900,DwglEsqX,52535,more than downpayment,more than downpayment,0,7800
DWqGOiw4,8900,11/16/2018,8900,,8900,equal to downpayment,,8900,0
DWqGOiw4,3900,12/30/2018,8900,DWqGOiw4,12800,more than downpayment,equal to downpayment,0,3900
DWqGOiw4,3900,1/30/2019,8900,DWqGOiw4,16700,more than downpayment,more than downpayment,0,3900
DWqGOiw4,2000,3/4/2019,8900,DWqGOiw4,18700,more than downpayment,more than downpayment,0,2000
DWqGOiw4,1900,3/7/2019,8900,DWqGOiw4,20600,more than downpayment,more than downpayment,0,1900
DWqGOiw4,2000,4/10/2019,8900,DWqGOiw4,22600,more than downpayment,more than downpayment,0,2000
DWqGOiw4,1900,4/14/2019,8900,DWqGOiw4,24500,more than downpayment,more than downpayment,0,1900
DWqGOiw4,2000,5/7/2019,8900,DWqGOiw4,26500,more than downpayment,more than downpayment,0,2000
DWqGOiw4,1900,5/13/2019,8900,DWqGOiw4,28400,more than downpayment,more than downpayment,0,1900
DWqGOiw4,2000,6/5/2019,8900,DWqGOiw4,30400,more than downpayment,more than downpayment,0,2000
DWqGOiw4,1000,6/24/2019,8900,DWqGOiw4,31400,more than downpayment,more than downpayment,0,1000
DWqGOiw4,3800,7/2/2019,8900,DWqGOiw4,35200,more than downpayment,more than downpayment,0,3800
DWqGOiw4,3900,8/7/2019,8900,DWqGOiw4,39100,more than downpayment,more than downpayment,0,3900
DWqGOiw4,3900,9/9/2019,8900,DWqGOiw4,43000,more than downpayment,more than downpayment,0,3900
DWqGOiw4,1000,10/8/2019,8900,DWqGOiw4,44000,more than downpayment,more than downpayment,0,1000
DWqGOiw4,2900,11/13/2019,8900,DWqGOiw4,46900,more than downpayment,more than downpayment,0,2900
DWqGOiw4,3900,2/5/2020,8900,DWqGOiw4,50800,more than downpayment,more than downpayment,0,3900
dXbwiIPG,10000,6/10/2017,10000,,10000,equal to downpayment,,10000,0
dXbwiIPG,3500,7/10/2017,10000,dXbwiIPG,13500,more than downpayment,equal to downpayment,0,3500
dXbwiIPG,3500,8/10/2017,10000,dXbwiIPG,17000,more than downpayment,more than downpayment,0,3500
dXbwiIPG,3000,9/25/2017,10000,dXbwiIPG,20000,more than downpayment,more than downpayment,0,3000
dXbwiIPG,3000,10/25/2017,10000,dXbwiIPG,23000,more than downpayment,more than downpayment,0,3000
dXbwiIPG,3050,11/25/2017,10000,dXbwiIPG,26050,more than downpayment,more than downpayment,0,3050
dXbwiIPG,3050,4/25/2018,10000,dXbwiIPG,29100,more than downpayment,more than downpayment,0,3050
dXbwiIPG,3000,5/25/2018,10000,dXbwiIPG,32100,more than downpayment,more than downpayment,0,3000
DXGYZDZM,9900,8/21/2019,9900,,9900,equal to downpayment,,9900,0
DXGYZDZM,3900,11/11/2019,9900,DXGYZDZM,13800,more than downpayment,equal to downpayment,0,3900
DXGYZDZM,3900,12/10/2019,9900,DXGYZDZM,17700,more than downpayment,more than downpayment,0,3900
DXGYZDZM,3900,1/11/2020,9900,DXGYZDZM,21600,more than downpayment,more than downpayment,0,3900
dYwY3lp3,10000,8/3/2018,10000,,10000,equal to downpayment,,10000,0
dYwY3lp3,4500,9/11/2018,10000,dYwY3lp3,14500,more than downpayment,equal to downpayment,0,4500
dYwY3lp3,4500,10/14/2018,10000,dYwY3lp3,19000,more than downpayment,more than downpayment,0,4500
dYwY3lp3,4500,11/13/2018,10000,dYwY3lp3,23500,more than downpayment,more than downpayment,0,4500
dYwY3lp3,4500,12/13/2018,10000,dYwY3lp3,28000,more than downpayment,more than downpayment,0,4500
dYwY3lp3,4500,1/15/2019,10000,dYwY3lp3,32500,more than downpayment,more than downpayment,0,4500
dYwY3lp3,4500,2/13/2019,10000,dYwY3lp3,37000,more than downpayment,more than downpayment,0,4500
dYwY3lp3,4500,3/15/2019,10000,dYwY3lp3,41500,more than downpayment,more than downpayment,0,4500
dYwY3lp3,4500,4/15/2019,10000,dYwY3lp3,46000,more than downpayment,more than downpayment,0,4500
dYwY3lp3,4500,5/15/2019,10000,dYwY3lp3,50500,more than downpayment,more than downpayment,0,4500
dYwY3lp3,4500,6/15/2019,10000,dYwY3lp3,55000,more than downpayment,more than downpayment,0,4500
dYwY3lp3,4500,7/15/2019,10000,dYwY3lp3,59500,more than downpayment,more than downpayment,0,4500
dYwY3lp3,4500,8/30/2019,10000,dYwY3lp3,64000,more than downpayment,more than downpayment,0,4500
DYY4YY8S,9900,8/7/2019,9900,,9900,equal to downpayment,,9900,0
DYY4YY8S,3900,10/4/2019,9900,DYY4YY8S,13800,more than downpayment,equal to downpayment,0,3900
DYY4YY8S,3900,11/13/2019,9900,DYY4YY8S,17700,more than downpayment,more than downpayment,0,3900
DYY4YY8S,3900,12/14/2019,9900,DYY4YY8S,21600,more than downpayment,more than downpayment,0,3900
DYY4YY8S,3900,1/6/2020,9900,DYY4YY8S,25500,more than downpayment,more than downpayment,0,3900
DZ0zLcsd,8900,3/7/2019,8900,,8900,equal to downpayment,,8900,0
DZ0zLcsd,3900,4/10/2019,8900,DZ0zLcsd,12800,more than downpayment,equal to downpayment,0,3900
DZ0zLcsd,3900,5/28/2019,8900,DZ0zLcsd,16700,more than downpayment,more than downpayment,0,3900
DZ0zLcsd,12000,11/21/2019,8900,DZ0zLcsd,28700,more than downpayment,more than downpayment,0,12000
DZ0zLcsd,4000,12/2/2019,8900,DZ0zLcsd,32700,more than downpayment,more than downpayment,0,4000
DZ0zLcsd,2000,12/7/2019,8900,DZ0zLcsd,34700,more than downpayment,more than downpayment,0,2000
DZ0zLcsd,4000,12/23/2019,8900,DZ0zLcsd,38700,more than downpayment,more than downpayment,0,4000
DZ0zLcsd,4000,1/5/2020,8900,DZ0zLcsd,42700,more than downpayment,more than downpayment,0,4000
DZ0zLcsd,4000,2/3/2020,8900,DZ0zLcsd,46700,more than downpayment,more than downpayment,0,4000
dZRbnQQn,9900,8/24/2019,9900,,9900,equal to downpayment,,9900,0
dZRbnQQn,7800,12/5/2019,9900,dZRbnQQn,17700,more than downpayment,equal to downpayment,0,7800
dZRbnQQn,1200,1/15/2020,9900,dZRbnQQn,18900,more than downpayment,more than downpayment,0,1200
dZRbnQQn,6600,1/30/2020,9900,dZRbnQQn,25500,more than downpayment,more than downpayment,0,6600
DZRSOaXp,8900,4/15/2019,8900,,8900,equal to downpayment,,8900,0
DZRSOaXp,3900,5/18/2019,8900,DZRSOaXp,12800,more than downpayment,equal to downpayment,0,3900
DZRSOaXp,3900,6/18/2019,8900,DZRSOaXp,16700,more than downpayment,more than downpayment,0,3900
DZRSOaXp,399,7/19/2019,8900,DZRSOaXp,17099,more than downpayment,more than downpayment,0,399
DZRSOaXp,3900,7/26/2019,8900,DZRSOaXp,20999,more than downpayment,more than downpayment,0,3900
DZRSOaXp,3501,8/18/2019,8900,DZRSOaXp,24500,more than downpayment,more than downpayment,0,3501
DZRSOaXp,3999,9/19/2019,8900,DZRSOaXp,28499,more than downpayment,more than downpayment,0,3999
DZRSOaXp,3900,10/17/2019,8900,DZRSOaXp,32399,more than downpayment,more than downpayment,0,3900
DZRSOaXp,3900,11/9/2019,8900,DZRSOaXp,36299,more than downpayment,more than downpayment,0,3900
DZRSOaXp,3900,12/10/2019,8900,DZRSOaXp,40199,more than downpayment,more than downpayment,0,3900
DZRSOaXp,3900,1/9/2020,8900,DZRSOaXp,44099,more than downpayment,more than downpayment,0,3900
e05d7215,8900,12/25/2019,8900,,8900,equal to downpayment,,8900,0
e13065b0,9900,9/30/2019,9900,,9900,equal to downpayment,,9900,0
e13065b0,3900,11/1/2019,9900,e13065b0,13800,more than downpayment,equal to downpayment,0,3900
e13065b0,3900,12/17/2019,9900,e13065b0,17700,more than downpayment,more than downpayment,0,3900
e13065b0,3900,2/4/2020,9900,e13065b0,21600,more than downpayment,more than downpayment,0,3900
E166W668,5000,1/29/2020,4999,,5000,more than downpayment,,4999,1
e16b6ecf,34000,1/18/2020,34000,,34000,equal to downpayment,,34000,0
e17b9002,9900,12/28/2019,9900,,9900,equal to downpayment,,9900,0
E19X3AVC,10000,1/16/2020,9900,,10000,more than downpayment,,9900,100
e1VLy4hW,8900,2/27/2019,8900,,8900,equal to downpayment,,8900,0
e1VLy4hW,3900,4/4/2019,8900,e1VLy4hW,12800,more than downpayment,equal to downpayment,0,3900
e1VLy4hW,3900,5/5/2019,8900,e1VLy4hW,16700,more than downpayment,more than downpayment,0,3900
e1VLy4hW,3900,6/4/2019,8900,e1VLy4hW,20600,more than downpayment,more than downpayment,0,3900
e1VLy4hW,3900,7/4/2019,8900,e1VLy4hW,24500,more than downpayment,more than downpayment,0,3900
e1VLy4hW,3900,8/5/2019,8900,e1VLy4hW,28400,more than downpayment,more than downpayment,0,3900
e1VLy4hW,3900,9/5/2019,8900,e1VLy4hW,32300,more than downpayment,more than downpayment,0,3900
e1VLy4hW,3900,10/4/2019,8900,e1VLy4hW,36200,more than downpayment,more than downpayment,0,3900
e1VLy4hW,3900,11/5/2019,8900,e1VLy4hW,40100,more than downpayment,more than downpayment,0,3900
e1VLy4hW,3900,12/5/2019,8900,e1VLy4hW,44000,more than downpayment,more than downpayment,0,3900
e1VLy4hW,3900,1/4/2020,8900,e1VLy4hW,47900,more than downpayment,more than downpayment,0,3900
e1VLy4hW,3900,2/5/2020,8900,e1VLy4hW,51800,more than downpayment,more than downpayment,0,3900
e2c45b36,9900,1/15/2020,9900,,9900,equal to downpayment,,9900,0
e2cace93,9900,11/14/2019,9900,,9900,equal to downpayment,,9900,0
e2cace93,3900,12/11/2019,9900,e2cace93,13800,more than downpayment,equal to downpayment,0,3900
e2cace93,3000,1/27/2020,9900,e2cace93,16800,more than downpayment,more than downpayment,0,3000
e2ec845f,9900,11/19/2019,9900,,9900,equal to downpayment,,9900,0
e2tVNWk2,10000,9/2/2019,9900,,10000,more than downpayment,,9900,100
e2tVNWk2,4000,11/5/2019,9900,e2tVNWk2,14000,more than downpayment,more than downpayment,0,4000
e2tVNWk2,4000,12/5/2019,9900,e2tVNWk2,18000,more than downpayment,more than downpayment,0,4000
e2tVNWk2,4000,1/11/2020,9900,e2tVNWk2,22000,more than downpayment,more than downpayment,0,4000
e32e0649,50,11/25/2019,9900,,50,less than downpayment,,50,0
e3c0b488,9900,10/4/2019,9900,,9900,equal to downpayment,,9900,0
e3c0b488,3900,11/21/2019,9900,e3c0b488,13800,more than downpayment,equal to downpayment,0,3900
e3c0b488,3900,12/26/2019,9900,e3c0b488,17700,more than downpayment,more than downpayment,0,3900
e3c0b488,3900,1/25/2020,9900,e3c0b488,21600,more than downpayment,more than downpayment,0,3900
e3e5401f,9900,11/11/2019,9900,,9900,equal to downpayment,,9900,0
e3e6883f,9900,11/29/2019,9900,,9900,equal to downpayment,,9900,0
e3e6883f,200,12/19/2019,9900,e3e6883f,10100,more than downpayment,equal to downpayment,0,200
e3e6883f,3900,12/30/2019,9900,e3e6883f,14000,more than downpayment,more than downpayment,0,3900
e3e6883f,3900,2/5/2020,9900,e3e6883f,17900,more than downpayment,more than downpayment,0,3900
E3R1LRAX,9900,11/15/2019,9900,,9900,equal to downpayment,,9900,0
E3R1LRAX,3900,1/23/2020,9900,E3R1LRAX,13800,more than downpayment,equal to downpayment,0,3900
E3VM42QK,8900,1/3/2020,8900,,8900,equal to downpayment,,8900,0
E4JDXXKD,9900,10/16/2019,9900,,9900,equal to downpayment,,9900,0
E4JDXXKD,3900,12/5/2019,9900,E4JDXXKD,13800,more than downpayment,equal to downpayment,0,3900
E4JDXXKD,3900,1/5/2020,9900,E4JDXXKD,17700,more than downpayment,more than downpayment,0,3900
E4JDXXKD,3900,2/4/2020,9900,E4JDXXKD,21600,more than downpayment,more than downpayment,0,3900
E5g3ieTj,14000,11/1/2018,10000,,14000,more than downpayment,,10000,4000
E5g3ieTj,4500,12/15/2018,10000,E5g3ieTj,18500,more than downpayment,more than downpayment,0,4500
E5g3ieTj,4500,1/15/2019,10000,E5g3ieTj,23000,more than downpayment,more than downpayment,0,4500
E5g3ieTj,4500,2/26/2019,10000,E5g3ieTj,27500,more than downpayment,more than downpayment,0,4500
E65aDEZ3,10000,8/24/2018,10000,,10000,equal to downpayment,,10000,0
e6ctll1g,8900,8/7/2019,8900,,8900,equal to downpayment,,8900,0
e6ctll1g,3900,9/12/2019,8900,e6ctll1g,12800,more than downpayment,equal to downpayment,0,3900
e6ctll1g,3900,10/28/2019,8900,e6ctll1g,16700,more than downpayment,more than downpayment,0,3900
e6ctll1g,3900,11/28/2019,8900,e6ctll1g,20600,more than downpayment,more than downpayment,0,3900
e6ctll1g,3900,12/30/2019,8900,e6ctll1g,24500,more than downpayment,more than downpayment,0,3900
e6ctll1g,3900,1/27/2020,8900,e6ctll1g,28400,more than downpayment,more than downpayment,0,3900
E6ES7RZ7,9900,11/6/2019,9900,,9900,equal to downpayment,,9900,0
E6ES7RZ7,3900,12/14/2019,9900,E6ES7RZ7,13800,more than downpayment,equal to downpayment,0,3900
E6ES7RZ7,3900,1/10/2020,9900,E6ES7RZ7,17700,more than downpayment,more than downpayment,0,3900
e711a09c,9900,11/11/2019,9900,,9900,equal to downpayment,,9900,0
e711a09c,3900,12/17/2019,9900,e711a09c,13800,more than downpayment,equal to downpayment,0,3900
e711a09c,3900,1/20/2020,9900,e711a09c,17700,more than downpayment,more than downpayment,0,3900
e74e6372,9900,12/4/2019,9900,,9900,equal to downpayment,,9900,0
e74e6372,3900,1/21/2020,9900,e74e6372,13800,more than downpayment,equal to downpayment,0,3900
e75d5256,16700,11/6/2019,8900,,16700,more than downpayment,,8900,7800
e75d5256,3900,1/2/2020,8900,e75d5256,20600,more than downpayment,more than downpayment,0,3900
e75d5256,3900,2/2/2020,8900,e75d5256,24500,more than downpayment,more than downpayment,0,3900
e7694901,9900,12/17/2019,9900,,9900,equal to downpayment,,9900,0
E791cv6N,8900,4/11/2019,8900,,8900,equal to downpayment,,8900,0
E791cv6N,7800,7/4/2019,8900,E791cv6N,16700,more than downpayment,equal to downpayment,0,7800
E791cv6N,3900,8/1/2019,8900,E791cv6N,20600,more than downpayment,more than downpayment,0,3900
E791cv6N,3900,8/29/2019,8900,E791cv6N,24500,more than downpayment,more than downpayment,0,3900
E791cv6N,3900,9/30/2019,8900,E791cv6N,28400,more than downpayment,more than downpayment,0,3900
E791cv6N,3900,11/6/2019,8900,E791cv6N,32300,more than downpayment,more than downpayment,0,3900
E791cv6N,3900,11/27/2019,8900,E791cv6N,36200,more than downpayment,more than downpayment,0,3900
E791cv6N,3900,12/30/2019,8900,E791cv6N,40100,more than downpayment,more than downpayment,0,3900
E791cv6N,3900,1/30/2020,8900,E791cv6N,44000,more than downpayment,more than downpayment,0,3900
E7BHY7KA,9900,11/30/2019,9900,,9900,equal to downpayment,,9900,0
E7MB5N1B,9900,9/30/2019,9900,,9900,equal to downpayment,,9900,0
E7MB5N1B,3900,12/4/2019,9900,E7MB5N1B,13800,more than downpayment,equal to downpayment,0,3900
E7MB5N1B,3900,1/5/2020,9900,E7MB5N1B,17700,more than downpayment,more than downpayment,0,3900
E7MB5N1B,3900,2/5/2020,9900,E7MB5N1B,21600,more than downpayment,more than downpayment,0,3900
E7SNBE8J,9900,9/24/2019,9900,,9900,equal to downpayment,,9900,0
E7SNBE8J,3900,11/1/2019,9900,E7SNBE8J,13800,more than downpayment,equal to downpayment,0,3900
E7SNBE8J,3900,12/3/2019,9900,E7SNBE8J,17700,more than downpayment,more than downpayment,0,3900
E7SNBE8J,3900,12/30/2019,9900,E7SNBE8J,21600,more than downpayment,more than downpayment,0,3900
E7SNBE8J,3900,2/1/2020,9900,E7SNBE8J,25500,more than downpayment,more than downpayment,0,3900
E7XWO83S,9900,1/11/2020,9900,,9900,equal to downpayment,,9900,0
e81b3d6f,9900,1/9/2020,9900,,9900,equal to downpayment,,9900,0
e8476f41,9900,1/2/2020,9900,,9900,equal to downpayment,,9900,0
e8a1eded,9900,12/12/2019,9900,,9900,equal to downpayment,,9900,0
e8a1eded,4000,1/10/2020,9900,e8a1eded,13900,more than downpayment,equal to downpayment,0,4000
e8a1eded,5000,2/2/2020,9900,e8a1eded,18900,more than downpayment,more than downpayment,0,5000
E8AB56S2,8900,2/6/2020,8900,,8900,equal to downpayment,,8900,0
e8By2Ndb,8900,1/19/2019,8900,,8900,equal to downpayment,,8900,0
e8By2Ndb,5799,6/3/2019,8900,e8By2Ndb,14699,more than downpayment,equal to downpayment,0,5799
e8By2Ndb,6000,6/4/2019,8900,e8By2Ndb,20699,more than downpayment,more than downpayment,0,6000
E8QU3AC9,9900,9/26/2019,9900,,9900,equal to downpayment,,9900,0
E8QU3AC9,3900,12/7/2019,9900,E8QU3AC9,13800,more than downpayment,equal to downpayment,0,3900
E8QU3AC9,3900,12/31/2019,9900,E8QU3AC9,17700,more than downpayment,more than downpayment,0,3900
E8QU3AC9,3900,2/5/2020,9900,E8QU3AC9,21600,more than downpayment,more than downpayment,0,3900
e912202c,9900,12/13/2019,9900,,9900,equal to downpayment,,9900,0
E9AC9UMK,9900,6/6/2019,8900,,9900,more than downpayment,,8900,1000
E9AC9UMK,3900,7/24/2019,8900,E9AC9UMK,13800,more than downpayment,more than downpayment,0,3900
E9AC9UMK,3900,8/23/2019,8900,E9AC9UMK,17700,more than downpayment,more than downpayment,0,3900
E9AC9UMK,3900,9/21/2019,8900,E9AC9UMK,21600,more than downpayment,more than downpayment,0,3900
E9AC9UMK,3900,11/5/2019,8900,E9AC9UMK,25500,more than downpayment,more than downpayment,0,3900
E9AC9UMK,3900,12/12/2019,8900,E9AC9UMK,29400,more than downpayment,more than downpayment,0,3900
E9AC9UMK,3900,1/11/2020,8900,E9AC9UMK,33300,more than downpayment,more than downpayment,0,3900
E9AC9UMK,3900,1/28/2020,8900,E9AC9UMK,37200,more than downpayment,more than downpayment,0,3900
E9C2OKI8,9900,1/11/2020,9900,,9900,equal to downpayment,,9900,0
ea3ad1b7,9900,1/20/2020,9900,,9900,equal to downpayment,,9900,0
Ea81iXMp,8900,8/12/2019,8900,,8900,equal to downpayment,,8900,0
Ea81iXMp,3900,10/12/2019,8900,Ea81iXMp,12800,more than downpayment,equal to downpayment,0,3900
Ea81iXMp,3900,11/7/2019,8900,Ea81iXMp,16700,more than downpayment,more than downpayment,0,3900
Ea81iXMp,3900,12/9/2019,8900,Ea81iXMp,20600,more than downpayment,more than downpayment,0,3900
Ea81iXMp,3900,1/7/2020,8900,Ea81iXMp,24500,more than downpayment,more than downpayment,0,3900
Ea81iXMp,3900,2/7/2020,8900,Ea81iXMp,28400,more than downpayment,more than downpayment,0,3900
EACA2DVR,9900,6/29/2019,9900,,9900,equal to downpayment,,9900,0
EACA2DVR,3900,8/24/2019,9900,EACA2DVR,13800,more than downpayment,equal to downpayment,0,3900
EACA2DVR,3900,9/25/2019,9900,EACA2DVR,17700,more than downpayment,more than downpayment,0,3900
EACA2DVR,3900,10/24/2019,9900,EACA2DVR,21600,more than downpayment,more than downpayment,0,3900
EACA2DVR,3900,11/25/2019,9900,EACA2DVR,25500,more than downpayment,more than downpayment,0,3900
EACA2DVR,3900,12/25/2019,9900,EACA2DVR,29400,more than downpayment,more than downpayment,0,3900
EACA2DVR,3900,1/25/2020,9900,EACA2DVR,33300,more than downpayment,more than downpayment,0,3900
EAFLMNI8,8900,9/12/2019,8900,,8900,equal to downpayment,,8900,0
EAFLMNI8,3900,11/12/2019,8900,EAFLMNI8,12800,more than downpayment,equal to downpayment,0,3900
EAFLMNI8,3900,12/12/2019,8900,EAFLMNI8,16700,more than downpayment,more than downpayment,0,3900
EAFLMNI8,3900,1/15/2020,8900,EAFLMNI8,20600,more than downpayment,more than downpayment,0,3900
EAR3RNTW,9900,8/14/2019,9900,,9900,equal to downpayment,,9900,0
EAR3RNTW,3900,1/24/2020,9900,EAR3RNTW,13800,more than downpayment,equal to downpayment,0,3900
EaZ2qV90,8900,2/2/2019,8900,,8900,equal to downpayment,,8900,0
EaZ2qV90,3900,3/1/2019,8900,EaZ2qV90,12800,more than downpayment,equal to downpayment,0,3900
EaZ2qV90,3900,4/5/2019,8900,EaZ2qV90,16700,more than downpayment,more than downpayment,0,3900
EaZ2qV90,4500,6/24/2019,8900,EaZ2qV90,21200,more than downpayment,more than downpayment,0,4500
EaZ2qV90,7800,8/3/2019,8900,EaZ2qV90,29000,more than downpayment,more than downpayment,0,7800
EaZ2qV90,3500,9/20/2019,8900,EaZ2qV90,32500,more than downpayment,more than downpayment,0,3500
EaZ2qV90,3900,10/15/2019,8900,EaZ2qV90,36400,more than downpayment,more than downpayment,0,3900
EaZ2qV90,3500,11/15/2019,8900,EaZ2qV90,39900,more than downpayment,more than downpayment,0,3500
EaZ2qV90,5000,12/26/2019,8900,EaZ2qV90,44900,more than downpayment,more than downpayment,0,5000
EaZ2qV90,20000,1/8/2020,8900,EaZ2qV90,64900,more than downpayment,more than downpayment,0,20000
EB6YPAPC,20000,12/24/2019,8900,,20000,more than downpayment,,8900,11100
EB6YPAPC,10000,12/31/2019,8900,EB6YPAPC,30000,more than downpayment,more than downpayment,0,10000
EB6YPAPC,10000,1/28/2020,8900,EB6YPAPC,40000,more than downpayment,more than downpayment,0,10000
EB6YPAPC,5000,2/2/2020,8900,EB6YPAPC,45000,more than downpayment,more than downpayment,0,5000
eb7e8609,8900,10/9/2019,8900,,8900,equal to downpayment,,8900,0
EB9KN11U,9900,10/30/2019,9900,,9900,equal to downpayment,,9900,0
EB9KN11U,7800,12/4/2019,9900,EB9KN11U,17700,more than downpayment,equal to downpayment,0,7800
EB9KN11U,3900,2/5/2020,9900,EB9KN11U,21600,more than downpayment,more than downpayment,0,3900
EBDE9yNU,30000,10/11/2017,10000,,30000,more than downpayment,,10000,20000
EBDE9yNU,10000,1/26/2018,10000,EBDE9yNU,40000,more than downpayment,more than downpayment,0,10000
ebRwiVCj,25000,8/28/2017,10000,,25000,more than downpayment,,10000,15000
ebRwiVCj,10000,2/9/2018,10000,ebRwiVCj,35000,more than downpayment,more than downpayment,0,10000
ebRwiVCj,5000,5/15/2018,10000,ebRwiVCj,40000,more than downpayment,more than downpayment,0,5000
ebRwiVCj,5000,7/5/2018,10000,ebRwiVCj,45000,more than downpayment,more than downpayment,0,5000
ebRwiVCj,10000,11/16/2018,10000,ebRwiVCj,55000,more than downpayment,more than downpayment,0,10000
ebRwiVCj,140,7/16/2019,10000,ebRwiVCj,55140,more than downpayment,more than downpayment,0,140
ec7c960f,9900,12/23/2019,9900,,9900,equal to downpayment,,9900,0
ec88cdd8,8900,10/10/2019,8900,,8900,equal to downpayment,,8900,0
ec88cdd8,1000,10/24/2019,8900,ec88cdd8,9900,more than downpayment,equal to downpayment,0,1000
ec88cdd8,5000,11/1/2019,8900,ec88cdd8,14900,more than downpayment,more than downpayment,0,5000
ec88cdd8,5000,12/1/2019,8900,ec88cdd8,19900,more than downpayment,more than downpayment,0,5000
ec88cdd8,5000,1/1/2020,8900,ec88cdd8,24900,more than downpayment,more than downpayment,0,5000
ec88cdd8,5000,2/1/2020,8900,ec88cdd8,29900,more than downpayment,more than downpayment,0,5000
ECsaCRZi,8900,11/24/2018,8900,,8900,equal to downpayment,,8900,0
ECsaCRZi,500,1/17/2019,8900,ECsaCRZi,9400,more than downpayment,equal to downpayment,0,500
ECsaCRZi,2800,1/21/2019,8900,ECsaCRZi,12200,more than downpayment,more than downpayment,0,2800
ECsaCRZi,3000,4/10/2019,8900,ECsaCRZi,15200,more than downpayment,more than downpayment,0,3000
ECsaCRZi,1000,8/11/2019,8900,ECsaCRZi,16200,more than downpayment,more than downpayment,0,1000
ECsaCRZi,1000,9/15/2019,8900,ECsaCRZi,17200,more than downpayment,more than downpayment,0,1000
EcvBz67s,9900,10/29/2018,9900,,9900,equal to downpayment,,9900,0
EcvBz67s,4500,12/13/2018,9900,EcvBz67s,14400,more than downpayment,equal to downpayment,0,4500
EcvBz67s,5500,4/16/2019,9900,EcvBz67s,19900,more than downpayment,more than downpayment,0,5500
EcvBz67s,4500,11/3/2019,9900,EcvBz67s,24400,more than downpayment,more than downpayment,0,4500
EcvhmYC4,26250,8/9/2019,26250,,26250,equal to downpayment,,26250,0
ed2bfec6,5000,12/19/2019,4999,,5000,more than downpayment,,4999,1
ed4e4dde,300,12/8/2019,9900,,300,less than downpayment,,300,0
ed4e4dde,400,12/14/2019,9900,ed4e4dde,700,less than downpayment,less than downpayment,400,0
ed8493d2,5000,1/23/2020,9900,,5000,less than downpayment,,5000,0
ed8493d2,3900,1/29/2020,9900,ed8493d2,8900,less than downpayment,less than downpayment,3900,0
ed8493d2,1000,1/30/2020,9900,ed8493d2,9900,equal to downpayment,less than downpayment,1000,0
EDNUZDVG,7900,10/3/2019,7900,,7900,equal to downpayment,,7900,0
EdpVUGpT,8900,1/12/2020,8900,,8900,equal to downpayment,,8900,0
EDtHqHJT,9900,8/21/2019,9900,,9900,equal to downpayment,,9900,0
EDUOgTWT,9000,1/14/2019,8900,,9000,more than downpayment,,8900,100
EDUOgTWT,3900,2/28/2019,8900,EDUOgTWT,12900,more than downpayment,more than downpayment,0,3900
EDUOgTWT,3900,4/3/2019,8900,EDUOgTWT,16800,more than downpayment,more than downpayment,0,3900
EDUOgTWT,4000,5/10/2019,8900,EDUOgTWT,20800,more than downpayment,more than downpayment,0,4000
EDUOgTWT,3900,5/27/2019,8900,EDUOgTWT,24700,more than downpayment,more than downpayment,0,3900
EDUOgTWT,3900,7/8/2019,8900,EDUOgTWT,28600,more than downpayment,more than downpayment,0,3900
EDUOgTWT,3900,8/4/2019,8900,EDUOgTWT,32500,more than downpayment,more than downpayment,0,3900
EDUOgTWT,3900,8/27/2019,8900,EDUOgTWT,36400,more than downpayment,more than downpayment,0,3900
EDUOgTWT,3900,10/1/2019,8900,EDUOgTWT,40300,more than downpayment,more than downpayment,0,3900
EDUOgTWT,3900,10/25/2019,8900,EDUOgTWT,44200,more than downpayment,more than downpayment,0,3900
EDUOgTWT,5000,1/14/2020,8900,EDUOgTWT,49200,more than downpayment,more than downpayment,0,5000
EDUOgTWT,2800,1/23/2020,8900,EDUOgTWT,52000,more than downpayment,more than downpayment,0,2800
eea7bd93,9900,1/26/2020,9900,,9900,equal to downpayment,,9900,0
EEF6cuhS,7020,5/19/2017,7020,,7020,equal to downpayment,,7020,0
EEF6cuhS,2808,6/8/2017,7020,EEF6cuhS,9828,more than downpayment,equal to downpayment,0,2808
EEF6cuhS,2808,7/8/2017,7020,EEF6cuhS,12636,more than downpayment,more than downpayment,0,2808
EEF6cuhS,2808,8/9/2017,7020,EEF6cuhS,15444,more than downpayment,more than downpayment,0,2808
EEF6cuhS,2808,10/14/2017,7020,EEF6cuhS,18252,more than downpayment,more than downpayment,0,2808
EEF6cuhS,2808,11/15/2017,7020,EEF6cuhS,21060,more than downpayment,more than downpayment,0,2808
EEF6cuhS,2808,12/13/2017,7020,EEF6cuhS,23868,more than downpayment,more than downpayment,0,2808
EEF6cuhS,2808,1/14/2018,7020,EEF6cuhS,26676,more than downpayment,more than downpayment,0,2808
EEF6cuhS,2808,2/14/2018,7020,EEF6cuhS,29484,more than downpayment,more than downpayment,0,2808
EEF6cuhS,2808,3/15/2018,7020,EEF6cuhS,32292,more than downpayment,more than downpayment,0,2808
EEF6cuhS,2108,4/16/2018,7020,EEF6cuhS,34400,more than downpayment,more than downpayment,0,2108
EEF6cuhS,700,4/21/2018,7020,EEF6cuhS,35100,more than downpayment,more than downpayment,0,700
EEF6cuhS,2400,5/25/2018,7020,EEF6cuhS,37500,more than downpayment,more than downpayment,0,2400
EEPHUFUP,9900,11/27/2019,9900,,9900,equal to downpayment,,9900,0
EEPHUFUP,3900,2/8/2020,9900,EEPHUFUP,13800,more than downpayment,equal to downpayment,0,3900
ef3233d9,8900,12/22/2019,8900,,8900,equal to downpayment,,8900,0
ef3233d9,3900,2/6/2020,8900,ef3233d9,12800,more than downpayment,equal to downpayment,0,3900
Ef6rq2rr,5000,8/30/2018,10000,,5000,less than downpayment,,5000,0
Ef6rq2rr,5000,9/27/2018,10000,Ef6rq2rr,10000,equal to downpayment,less than downpayment,5000,0
Ef6rq2rr,4500,11/15/2018,10000,Ef6rq2rr,14500,more than downpayment,equal to downpayment,0,4500
Ef6rq2rr,4500,12/15/2018,10000,Ef6rq2rr,19000,more than downpayment,more than downpayment,0,4500
Ef6rq2rr,4500,2/1/2019,10000,Ef6rq2rr,23500,more than downpayment,more than downpayment,0,4500
Ef6rq2rr,4000,2/16/2019,10000,Ef6rq2rr,27500,more than downpayment,more than downpayment,0,4000
Ef6rq2rr,500,3/2/2019,10000,Ef6rq2rr,28000,more than downpayment,more than downpayment,0,500
Ef6rq2rr,2000,5/16/2019,10000,Ef6rq2rr,30000,more than downpayment,more than downpayment,0,2000
Ef6rq2rr,1500,6/2/2019,10000,Ef6rq2rr,31500,more than downpayment,more than downpayment,0,1500
Ef6rq2rr,2000,6/19/2019,10000,Ef6rq2rr,33500,more than downpayment,more than downpayment,0,2000
Ef6rq2rr,9000,8/15/2019,10000,Ef6rq2rr,42500,more than downpayment,more than downpayment,0,9000
Ef6rq2rr,4500,11/9/2019,10000,Ef6rq2rr,47000,more than downpayment,more than downpayment,0,4500
Ef6rq2rr,4300,12/14/2019,10000,Ef6rq2rr,51300,more than downpayment,more than downpayment,0,4300
ef9JRgBd,10000,10/4/2017,10000,,10000,equal to downpayment,,10000,0
ef9JRgBd,4500,2/9/2018,10000,ef9JRgBd,14500,more than downpayment,equal to downpayment,0,4500
ef9JRgBd,4500,2/28/2018,10000,ef9JRgBd,19000,more than downpayment,more than downpayment,0,4500
ef9JRgBd,4500,3/27/2018,10000,ef9JRgBd,23500,more than downpayment,more than downpayment,0,4500
ef9JRgBd,4500,4/30/2018,10000,ef9JRgBd,28000,more than downpayment,more than downpayment,0,4500
ef9JRgBd,4500,5/25/2018,10000,ef9JRgBd,32500,more than downpayment,more than downpayment,0,4500
ef9JRgBd,4500,6/29/2018,10000,ef9JRgBd,37000,more than downpayment,more than downpayment,0,4500
ef9JRgBd,4500,7/25/2018,10000,ef9JRgBd,41500,more than downpayment,more than downpayment,0,4500
ef9JRgBd,4500,8/26/2018,10000,ef9JRgBd,46000,more than downpayment,more than downpayment,0,4500
ef9JRgBd,4500,9/21/2018,10000,ef9JRgBd,50500,more than downpayment,more than downpayment,0,4500
ef9JRgBd,4500,10/29/2018,10000,ef9JRgBd,55000,more than downpayment,more than downpayment,0,4500
ef9JRgBd,4500,11/26/2018,10000,ef9JRgBd,59500,more than downpayment,more than downpayment,0,4500
ef9JRgBd,4500,12/21/2018,10000,ef9JRgBd,64000,more than downpayment,more than downpayment,0,4500
efcf078b,9950,1/27/2020,8900,,9950,more than downpayment,,8900,1050
Efh1VZBY,8900,5/8/2019,8900,,8900,equal to downpayment,,8900,0
Efh1VZBY,3900,6/4/2019,8900,Efh1VZBY,12800,more than downpayment,equal to downpayment,0,3900
Efh1VZBY,3900,7/1/2019,8900,Efh1VZBY,16700,more than downpayment,more than downpayment,0,3900
Efh1VZBY,3900,8/4/2019,8900,Efh1VZBY,20600,more than downpayment,more than downpayment,0,3900
Efh1VZBY,3900,9/3/2019,8900,Efh1VZBY,24500,more than downpayment,more than downpayment,0,3900
Efh1VZBY,3900,10/3/2019,8900,Efh1VZBY,28400,more than downpayment,more than downpayment,0,3900
Efh1VZBY,3900,11/7/2019,8900,Efh1VZBY,32300,more than downpayment,more than downpayment,0,3900
Efh1VZBY,3900,12/5/2019,8900,Efh1VZBY,36200,more than downpayment,more than downpayment,0,3900
Efh1VZBY,3900,1/5/2020,8900,Efh1VZBY,40100,more than downpayment,more than downpayment,0,3900
Efh1VZBY,3900,2/5/2020,8900,Efh1VZBY,44000,more than downpayment,more than downpayment,0,3900
efy6K0ib,9900,7/23/2019,9900,,9900,equal to downpayment,,9900,0
efy6K0ib,3900,9/5/2019,9900,efy6K0ib,13800,more than downpayment,equal to downpayment,0,3900
efy6K0ib,3900,10/4/2019,9900,efy6K0ib,17700,more than downpayment,more than downpayment,0,3900
efy6K0ib,3900,11/7/2019,9900,efy6K0ib,21600,more than downpayment,more than downpayment,0,3900
efy6K0ib,11700,1/17/2020,9900,efy6K0ib,33300,more than downpayment,more than downpayment,0,11700
EGWMPtHS,4000,10/30/2018,9900,,4000,less than downpayment,,4000,0
ehWA9vFZ,9900,11/5/2018,9900,,9900,equal to downpayment,,9900,0
eIAky1bc,9000,11/27/2018,8900,,9000,more than downpayment,,8900,100
eIAky1bc,4000,1/4/2019,8900,eIAky1bc,13000,more than downpayment,more than downpayment,0,4000
eIAky1bc,4000,2/4/2019,8900,eIAky1bc,17000,more than downpayment,more than downpayment,0,4000
eIAky1bc,4000,3/5/2019,8900,eIAky1bc,21000,more than downpayment,more than downpayment,0,4000
eIAky1bc,4000,4/4/2019,8900,eIAky1bc,25000,more than downpayment,more than downpayment,0,4000
eIAky1bc,4000,5/4/2019,8900,eIAky1bc,29000,more than downpayment,more than downpayment,0,4000
eIAky1bc,4000,6/7/2019,8900,eIAky1bc,33000,more than downpayment,more than downpayment,0,4000
eIAky1bc,4000,7/4/2019,8900,eIAky1bc,37000,more than downpayment,more than downpayment,0,4000
eIAky1bc,4000,8/6/2019,8900,eIAky1bc,41000,more than downpayment,more than downpayment,0,4000
eIAky1bc,4000,9/4/2019,8900,eIAky1bc,45000,more than downpayment,more than downpayment,0,4000
eIAky1bc,4000,10/4/2019,8900,eIAky1bc,49000,more than downpayment,more than downpayment,0,4000
eIAky1bc,4000,11/4/2019,8900,eIAky1bc,53000,more than downpayment,more than downpayment,0,4000
eIAky1bc,4000,12/5/2019,8900,eIAky1bc,57000,more than downpayment,more than downpayment,0,4000
eIAky1bc,4000,1/8/2020,8900,eIAky1bc,61000,more than downpayment,more than downpayment,0,4000
EIdqQuCs,8900,5/19/2019,8900,,8900,equal to downpayment,,8900,0
EIdqQuCs,3800,7/1/2019,8900,EIdqQuCs,12700,more than downpayment,equal to downpayment,0,3800
EIdqQuCs,100,7/26/2019,8900,EIdqQuCs,12800,more than downpayment,more than downpayment,0,100
EIdqQuCs,3900,8/5/2019,8900,EIdqQuCs,16700,more than downpayment,more than downpayment,0,3900
EIdqQuCs,3900,9/15/2019,8900,EIdqQuCs,20600,more than downpayment,more than downpayment,0,3900
EIdqQuCs,3900,10/18/2019,8900,EIdqQuCs,24500,more than downpayment,more than downpayment,0,3900
EIdqQuCs,3000,11/6/2019,8900,EIdqQuCs,27500,more than downpayment,more than downpayment,0,3000
EIdqQuCs,900,11/15/2019,8900,EIdqQuCs,28400,more than downpayment,more than downpayment,0,900
EIdqQuCs,3900,12/11/2019,8900,EIdqQuCs,32300,more than downpayment,more than downpayment,0,3900
EIdqQuCs,3900,1/10/2020,8900,EIdqQuCs,36200,more than downpayment,more than downpayment,0,3900
EIF8XGWX,8900,1/14/2020,8900,,8900,equal to downpayment,,8900,0
eIJ0zelT,8900,12/21/2018,8900,,8900,equal to downpayment,,8900,0
eIJ0zelT,3900,2/14/2019,8900,eIJ0zelT,12800,more than downpayment,equal to downpayment,0,3900
eIJ0zelT,3900,3/14/2019,8900,eIJ0zelT,16700,more than downpayment,more than downpayment,0,3900
eIJ0zelT,3900,4/15/2019,8900,eIJ0zelT,20600,more than downpayment,more than downpayment,0,3900
eIJ0zelT,3900,5/15/2019,8900,eIJ0zelT,24500,more than downpayment,more than downpayment,0,3900
eIJ0zelT,3900,6/15/2019,8900,eIJ0zelT,28400,more than downpayment,more than downpayment,0,3900
eIJ0zelT,3900,7/15/2019,8900,eIJ0zelT,32300,more than downpayment,more than downpayment,0,3900
eIJ0zelT,3900,8/15/2019,8900,eIJ0zelT,36200,more than downpayment,more than downpayment,0,3900
eIJ0zelT,3900,9/18/2019,8900,eIJ0zelT,40100,more than downpayment,more than downpayment,0,3900
eIJ0zelT,3900,10/14/2019,8900,eIJ0zelT,44000,more than downpayment,more than downpayment,0,3900
eIJ0zelT,3900,11/15/2019,8900,eIJ0zelT,47900,more than downpayment,more than downpayment,0,3900
eIJ0zelT,3900,12/15/2019,8900,eIJ0zelT,51800,more than downpayment,more than downpayment,0,3900
eIJ0zelT,3900,1/16/2020,8900,eIJ0zelT,55700,more than downpayment,more than downpayment,0,3900
eJ1fhzIc,8900,8/15/2019,8900,,8900,equal to downpayment,,8900,0
eJ1fhzIc,3900,10/5/2019,8900,eJ1fhzIc,12800,more than downpayment,equal to downpayment,0,3900
eJ1fhzIc,2000,1/9/2020,8900,eJ1fhzIc,14800,more than downpayment,more than downpayment,0,2000
eJ1fhzIc,1000,1/26/2020,8900,eJ1fhzIc,15800,more than downpayment,more than downpayment,0,1000
eJ1fhzIc,1000,1/29/2020,8900,eJ1fhzIc,16800,more than downpayment,more than downpayment,0,1000
EJ7BRHTE,8900,11/4/2019,9900,,8900,less than downpayment,,8900,0
EJ7BRHTE,1000,11/5/2019,9900,EJ7BRHTE,9900,equal to downpayment,less than downpayment,1000,0
EJ7BRHTE,2700,12/27/2019,9900,EJ7BRHTE,12600,more than downpayment,equal to downpayment,0,2700
EJ7BRHTE,1200,1/14/2020,9900,EJ7BRHTE,13800,more than downpayment,more than downpayment,0,1200
EJ7BRHTE,2500,1/29/2020,9900,EJ7BRHTE,16300,more than downpayment,more than downpayment,0,2500
EJ7BRHTE,1400,1/31/2020,9900,EJ7BRHTE,17700,more than downpayment,more than downpayment,0,1400
ejVYCUIu,9900,8/6/2019,9900,,9900,equal to downpayment,,9900,0
EK68b5ke,5000,5/31/2019,8900,,5000,less than downpayment,,5000,0
EK68b5ke,4000,6/3/2019,8900,EK68b5ke,9000,more than downpayment,less than downpayment,3900,100
EK68b5ke,4000,6/11/2019,8900,EK68b5ke,13000,more than downpayment,more than downpayment,0,4000
EK68b5ke,4000,7/2/2019,8900,EK68b5ke,17000,more than downpayment,more than downpayment,0,4000
EK68b5ke,1100,9/4/2019,8900,EK68b5ke,18100,more than downpayment,more than downpayment,0,1100
EK68b5ke,1200,9/15/2019,8900,EK68b5ke,19300,more than downpayment,more than downpayment,0,1200
EK68b5ke,1000,9/26/2019,8900,EK68b5ke,20300,more than downpayment,more than downpayment,0,1000
EK68b5ke,1000,10/2/2019,8900,EK68b5ke,21300,more than downpayment,more than downpayment,0,1000
EK68b5ke,4000,10/23/2019,8900,EK68b5ke,25300,more than downpayment,more than downpayment,0,4000
EK68b5ke,4000,11/5/2019,8900,EK68b5ke,29300,more than downpayment,more than downpayment,0,4000
EK68b5ke,600,2/5/2020,8900,EK68b5ke,29900,more than downpayment,more than downpayment,0,600
ELEG2BC7,9900,9/16/2019,9900,,9900,equal to downpayment,,9900,0
ELEG2BC7,3900,11/25/2019,9900,ELEG2BC7,13800,more than downpayment,equal to downpayment,0,3900
ELEG2BC7,3900,12/28/2019,9900,ELEG2BC7,17700,more than downpayment,more than downpayment,0,3900
ELEG2BC7,3900,1/26/2020,9900,ELEG2BC7,21600,more than downpayment,more than downpayment,0,3900
ELKH6FFR,9900,9/14/2019,9900,,9900,equal to downpayment,,9900,0
ELKH6FFR,3900,10/29/2019,9900,ELKH6FFR,13800,more than downpayment,equal to downpayment,0,3900
ELKH6FFR,3900,11/27/2019,9900,ELKH6FFR,17700,more than downpayment,more than downpayment,0,3900
ELKH6FFR,3900,12/25/2019,9900,ELKH6FFR,21600,more than downpayment,more than downpayment,0,3900
ELKH6FFR,3900,2/3/2020,9900,ELKH6FFR,25500,more than downpayment,more than downpayment,0,3900
elX2A4Wo,8900,7/18/2019,8900,,8900,equal to downpayment,,8900,0
elX2A4Wo,3900,9/11/2019,8900,elX2A4Wo,12800,more than downpayment,equal to downpayment,0,3900
elX2A4Wo,3900,10/10/2019,8900,elX2A4Wo,16700,more than downpayment,more than downpayment,0,3900
elX2A4Wo,3900,11/8/2019,8900,elX2A4Wo,20600,more than downpayment,more than downpayment,0,3900
elX2A4Wo,3900,12/14/2019,8900,elX2A4Wo,24500,more than downpayment,more than downpayment,0,3900
elX2A4Wo,3900,1/11/2020,8900,elX2A4Wo,28400,more than downpayment,more than downpayment,0,3900
elX2A4Wo,3900,2/7/2020,8900,elX2A4Wo,32300,more than downpayment,more than downpayment,0,3900
eLzPBekV,10000,8/12/2019,9900,,10000,more than downpayment,,9900,100
eLzPBekV,4000,9/25/2019,9900,eLzPBekV,14000,more than downpayment,more than downpayment,0,4000
eLzPBekV,4000,10/31/2019,9900,eLzPBekV,18000,more than downpayment,more than downpayment,0,4000
eLzPBekV,2000,11/19/2019,9900,eLzPBekV,20000,more than downpayment,more than downpayment,0,2000
eLzPBekV,2000,12/3/2019,9900,eLzPBekV,22000,more than downpayment,more than downpayment,0,2000
eLzPBekV,3800,1/5/2020,9900,eLzPBekV,25800,more than downpayment,more than downpayment,0,3800
eLzPBekV,3900,2/4/2020,9900,eLzPBekV,29700,more than downpayment,more than downpayment,0,3900
EN5V5IWR,9900,6/14/2019,8900,,9900,more than downpayment,,8900,1000
EN5V5IWR,3900,7/11/2019,8900,EN5V5IWR,13800,more than downpayment,more than downpayment,0,3900
EN5V5IWR,3900,8/3/2019,8900,EN5V5IWR,17700,more than downpayment,more than downpayment,0,3900
EN5V5IWR,3900,9/2/2019,8900,EN5V5IWR,21600,more than downpayment,more than downpayment,0,3900
EN5V5IWR,3900,10/6/2019,8900,EN5V5IWR,25500,more than downpayment,more than downpayment,0,3900
EN5V5IWR,3900,11/3/2019,8900,EN5V5IWR,29400,more than downpayment,more than downpayment,0,3900
EN5V5IWR,3900,12/13/2019,8900,EN5V5IWR,33300,more than downpayment,more than downpayment,0,3900
EN5V5IWR,3900,1/12/2020,8900,EN5V5IWR,37200,more than downpayment,more than downpayment,0,3900
EN5V5IWR,3900,2/2/2020,8900,EN5V5IWR,41100,more than downpayment,more than downpayment,0,3900
ENAD2HTF,9900,1/9/2020,9900,,9900,equal to downpayment,,9900,0
enJfPz3E,10000,6/16/2017,10000,,10000,equal to downpayment,,10000,0
enJfPz3E,3500,8/9/2017,10000,enJfPz3E,13500,more than downpayment,equal to downpayment,0,3500
enJfPz3E,3500,9/4/2017,10000,enJfPz3E,17000,more than downpayment,more than downpayment,0,3500
enJfPz3E,3500,10/2/2017,10000,enJfPz3E,20500,more than downpayment,more than downpayment,0,3500
enJfPz3E,3500,11/2/2017,10000,enJfPz3E,24000,more than downpayment,more than downpayment,0,3500
enJfPz3E,3500,12/4/2017,10000,enJfPz3E,27500,more than downpayment,more than downpayment,0,3500
enJfPz3E,3500,1/2/2018,10000,enJfPz3E,31000,more than downpayment,more than downpayment,0,3500
enJfPz3E,3500,2/1/2018,10000,enJfPz3E,34500,more than downpayment,more than downpayment,0,3500
enJfPz3E,3500,3/5/2018,10000,enJfPz3E,38000,more than downpayment,more than downpayment,0,3500
enJfPz3E,3500,4/3/2018,10000,enJfPz3E,41500,more than downpayment,more than downpayment,0,3500
enJfPz3E,3500,5/2/2018,10000,enJfPz3E,45000,more than downpayment,more than downpayment,0,3500
enJfPz3E,7000,6/4/2018,10000,enJfPz3E,52000,more than downpayment,more than downpayment,0,7000
EODSY8CE,8900,8/31/2019,8900,,8900,equal to downpayment,,8900,0
EODSY8CE,3900,10/30/2019,8900,EODSY8CE,12800,more than downpayment,equal to downpayment,0,3900
EODSY8CE,3900,11/30/2019,8900,EODSY8CE,16700,more than downpayment,more than downpayment,0,3900
EODSY8CE,3900,12/24/2019,8900,EODSY8CE,20600,more than downpayment,more than downpayment,0,3900
EODSY8CE,3900,2/1/2020,8900,EODSY8CE,24500,more than downpayment,more than downpayment,0,3900
Eow85Xzv,8900,8/30/2019,8900,,8900,equal to downpayment,,8900,0
Eow85Xzv,7800,12/11/2019,8900,Eow85Xzv,16700,more than downpayment,equal to downpayment,0,7800
eOYXNusu,8900,5/17/2019,8900,,8900,equal to downpayment,,8900,0
eOYXNusu,1500,6/20/2019,8900,eOYXNusu,10400,more than downpayment,equal to downpayment,0,1500
eOYXNusu,1400,7/11/2019,8900,eOYXNusu,11800,more than downpayment,more than downpayment,0,1400
eOYXNusu,600,7/19/2019,8900,eOYXNusu,12400,more than downpayment,more than downpayment,0,600
eOYXNusu,400,7/26/2019,8900,eOYXNusu,12800,more than downpayment,more than downpayment,0,400
eOYXNusu,1000,10/5/2019,8900,eOYXNusu,13800,more than downpayment,more than downpayment,0,1000
eOYXNusu,1000,11/14/2019,8900,eOYXNusu,14800,more than downpayment,more than downpayment,0,1000
EPMaPaMq,9900,1/4/2019,0,,9900,more than downpayment,,0,9900
EPMaPaMq,3900,2/14/2019,0,EPMaPaMq,13800,more than downpayment,more than downpayment,0,3900
EPMaPaMq,3900,3/15/2019,0,EPMaPaMq,17700,more than downpayment,more than downpayment,0,3900
EPMaPaMq,3900,4/13/2019,0,EPMaPaMq,21600,more than downpayment,more than downpayment,0,3900
EPMaPaMq,3900,5/14/2019,0,EPMaPaMq,25500,more than downpayment,more than downpayment,0,3900
EPMaPaMq,3900,6/14/2019,0,EPMaPaMq,29400,more than downpayment,more than downpayment,0,3900
EPMaPaMq,3900,7/12/2019,0,EPMaPaMq,33300,more than downpayment,more than downpayment,0,3900
EPMaPaMq,3900,8/14/2019,0,EPMaPaMq,37200,more than downpayment,more than downpayment,0,3900
EPMaPaMq,3900,9/14/2019,0,EPMaPaMq,41100,more than downpayment,more than downpayment,0,3900
EPMaPaMq,3900,10/12/2019,0,EPMaPaMq,45000,more than downpayment,more than downpayment,0,3900
EPMaPaMq,3900,11/12/2019,0,EPMaPaMq,48900,more than downpayment,more than downpayment,0,3900
EPMaPaMq,3900,12/14/2019,0,EPMaPaMq,52800,more than downpayment,more than downpayment,0,3900
EPMaPaMq,3900,1/14/2020,0,EPMaPaMq,56700,more than downpayment,more than downpayment,0,3900
Eppc42fX,7500,6/2/2017,7500,,7500,equal to downpayment,,7500,0
Eppc42fX,15000,10/23/2017,7500,Eppc42fX,22500,more than downpayment,equal to downpayment,0,15000
Eppc42fX,4500,1/22/2018,7500,Eppc42fX,27000,more than downpayment,more than downpayment,0,4500
Eppc42fX,5000,3/1/2018,7500,Eppc42fX,32000,more than downpayment,more than downpayment,0,5000
Eppc42fX,5000,5/3/2018,7500,Eppc42fX,37000,more than downpayment,more than downpayment,0,5000
EPtMDutv,8900,3/9/2019,8900,,8900,equal to downpayment,,8900,0
EPtMDutv,3900,4/10/2019,8900,EPtMDutv,12800,more than downpayment,equal to downpayment,0,3900
EPtMDutv,3900,5/24/2019,8900,EPtMDutv,16700,more than downpayment,more than downpayment,0,3900
EPtMDutv,3900,6/24/2019,8900,EPtMDutv,20600,more than downpayment,more than downpayment,0,3900
EPtMDutv,3900,8/6/2019,8900,EPtMDutv,24500,more than downpayment,more than downpayment,0,3900
EPtMDutv,3900,9/6/2019,8900,EPtMDutv,28400,more than downpayment,more than downpayment,0,3900
EPtMDutv,3900,10/7/2019,8900,EPtMDutv,32300,more than downpayment,more than downpayment,0,3900
EPtMDutv,3900,11/6/2019,8900,EPtMDutv,36200,more than downpayment,more than downpayment,0,3900
EPtMDutv,3900,12/2/2019,8900,EPtMDutv,40100,more than downpayment,more than downpayment,0,3900
EPtMDutv,3900,12/30/2019,8900,EPtMDutv,44000,more than downpayment,more than downpayment,0,3900
EPtMDutv,3900,2/4/2020,8900,EPtMDutv,47900,more than downpayment,more than downpayment,0,3900
EQ9ETXIL,8900,11/11/2019,8900,,8900,equal to downpayment,,8900,0
EQ9ETXIL,3900,1/1/2020,8900,EQ9ETXIL,12800,more than downpayment,equal to downpayment,0,3900
EQ9ETXIL,3900,1/21/2020,8900,EQ9ETXIL,16700,more than downpayment,more than downpayment,0,3900
Er7HZqpw,3000,5/8/2019,8900,,3000,less than downpayment,,3000,0
Er7HZqpw,3000,5/10/2019,8900,Er7HZqpw,6000,less than downpayment,less than downpayment,3000,0
Er7HZqpw,3000,5/14/2019,8900,Er7HZqpw,9000,more than downpayment,less than downpayment,2900,100
Er7HZqpw,2000,6/13/2019,8900,Er7HZqpw,11000,more than downpayment,more than downpayment,0,2000
Er7HZqpw,2500,7/8/2019,8900,Er7HZqpw,13500,more than downpayment,more than downpayment,0,2500
Er7HZqpw,1100,7/14/2019,8900,Er7HZqpw,14600,more than downpayment,more than downpayment,0,1100
Er7HZqpw,1000,7/17/2019,8900,Er7HZqpw,15600,more than downpayment,more than downpayment,0,1000
Er7HZqpw,1000,7/24/2019,8900,Er7HZqpw,16600,more than downpayment,more than downpayment,0,1000
Er7HZqpw,1000,8/12/2019,8900,Er7HZqpw,17600,more than downpayment,more than downpayment,0,1000
Er7HZqpw,1000,10/8/2019,8900,Er7HZqpw,18600,more than downpayment,more than downpayment,0,1000
Er7HZqpw,1000,10/11/2019,8900,Er7HZqpw,19600,more than downpayment,more than downpayment,0,1000
Er7HZqpw,1000,10/17/2019,8900,Er7HZqpw,20600,more than downpayment,more than downpayment,0,1000
Er7HZqpw,1000,11/9/2019,8900,Er7HZqpw,21600,more than downpayment,more than downpayment,0,1000
Er7HZqpw,500,11/14/2019,8900,Er7HZqpw,22100,more than downpayment,more than downpayment,0,500
Er7HZqpw,500,11/23/2019,8900,Er7HZqpw,22600,more than downpayment,more than downpayment,0,500
Er7HZqpw,1000,12/6/2019,8900,Er7HZqpw,23600,more than downpayment,more than downpayment,0,1000
Er7HZqpw,1500,12/31/2019,8900,Er7HZqpw,25100,more than downpayment,more than downpayment,0,1500
Er7HZqpw,2000,1/1/2020,8900,Er7HZqpw,27100,more than downpayment,more than downpayment,0,2000
Er7HZqpw,2000,1/3/2020,8900,Er7HZqpw,29100,more than downpayment,more than downpayment,0,2000
Er7HZqpw,1500,1/8/2020,8900,Er7HZqpw,30600,more than downpayment,more than downpayment,0,1500
Er7HZqpw,2000,2/6/2020,8900,Er7HZqpw,32600,more than downpayment,more than downpayment,0,2000
ES3W717W,9900,10/3/2019,9900,,9900,equal to downpayment,,9900,0
ES3W717W,3900,11/20/2019,9900,ES3W717W,13800,more than downpayment,equal to downpayment,0,3900
ES3W717W,1950,1/3/2020,9900,ES3W717W,15750,more than downpayment,more than downpayment,0,1950
ES3W717W,2000,1/7/2020,9900,ES3W717W,17750,more than downpayment,more than downpayment,0,2000
ES3W717W,3900,1/29/2020,9900,ES3W717W,21650,more than downpayment,more than downpayment,0,3900
ESCOTQME,9900,1/14/2020,9900,,9900,equal to downpayment,,9900,0
Et17fpxR,9900,6/18/2019,9900,,9900,equal to downpayment,,9900,0
Et17fpxR,3900,8/1/2019,9900,Et17fpxR,13800,more than downpayment,equal to downpayment,0,3900
Et17fpxR,3900,9/5/2019,9900,Et17fpxR,17700,more than downpayment,more than downpayment,0,3900
Et17fpxR,3900,10/11/2019,9900,Et17fpxR,21600,more than downpayment,more than downpayment,0,3900
Et17fpxR,3900,11/15/2019,9900,Et17fpxR,25500,more than downpayment,more than downpayment,0,3900
Et17fpxR,3900,12/11/2019,9900,Et17fpxR,29400,more than downpayment,more than downpayment,0,3900
Et17fpxR,3900,1/7/2020,9900,Et17fpxR,33300,more than downpayment,more than downpayment,0,3900
ET652NXJ,9900,1/24/2020,9900,,9900,equal to downpayment,,9900,0
ET6YC5TC,5000,8/6/2019,9900,,5000,less than downpayment,,5000,0
ETKpdf4R,9900,7/8/2019,9900,,9900,equal to downpayment,,9900,0
ETKpdf4R,3900,8/5/2019,9900,ETKpdf4R,13800,more than downpayment,equal to downpayment,0,3900
ETKpdf4R,3900,9/5/2019,9900,ETKpdf4R,17700,more than downpayment,more than downpayment,0,3900
ETKpdf4R,3900,10/5/2019,9900,ETKpdf4R,21600,more than downpayment,more than downpayment,0,3900
ETKpdf4R,3900,11/6/2019,9900,ETKpdf4R,25500,more than downpayment,more than downpayment,0,3900
ETKpdf4R,3900,12/6/2019,9900,ETKpdf4R,29400,more than downpayment,more than downpayment,0,3900
ETKpdf4R,3900,1/9/2020,9900,ETKpdf4R,33300,more than downpayment,more than downpayment,0,3900
ETNEVDTL,5000,1/4/2020,9900,,5000,less than downpayment,,5000,0
ETNEVDTL,4900,1/8/2020,9900,ETNEVDTL,9900,equal to downpayment,less than downpayment,4900,0
EtVrwDTv,7000,5/14/2019,8900,,7000,less than downpayment,,7000,0
EtVrwDTv,1900,5/15/2019,8900,EtVrwDTv,8900,equal to downpayment,less than downpayment,1900,0
EtVrwDTv,3900,7/2/2019,8900,EtVrwDTv,12800,more than downpayment,equal to downpayment,0,3900
EtVrwDTv,3900,9/3/2019,8900,EtVrwDTv,16700,more than downpayment,more than downpayment,0,3900
EtVrwDTv,4500,10/14/2019,8900,EtVrwDTv,21200,more than downpayment,more than downpayment,0,4500
EtVrwDTv,4600,12/9/2019,8900,EtVrwDTv,25800,more than downpayment,more than downpayment,0,4600
EtVrwDTv,3500,12/16/2019,8900,EtVrwDTv,29300,more than downpayment,more than downpayment,0,3500
EtVrwDTv,4100,1/3/2020,8900,EtVrwDTv,33400,more than downpayment,more than downpayment,0,4100
EtVrwDTv,3000,2/5/2020,8900,EtVrwDTv,36400,more than downpayment,more than downpayment,0,3000
EUNOYA1A,8900,10/28/2019,8900,,8900,equal to downpayment,,8900,0
EUNOYA1A,3744,2/3/2020,8900,EUNOYA1A,12644,more than downpayment,equal to downpayment,0,3744
euUe4eCS,9900,7/24/2019,8900,,9900,more than downpayment,,8900,1000
euUe4eCS,3900,9/25/2019,8900,euUe4eCS,13800,more than downpayment,more than downpayment,0,3900
eV9b5GJw,10000,5/28/2019,8900,,10000,more than downpayment,,8900,1100
eV9b5GJw,4000,7/19/2019,8900,eV9b5GJw,14000,more than downpayment,more than downpayment,0,4000
eV9b5GJw,4000,8/21/2019,8900,eV9b5GJw,18000,more than downpayment,more than downpayment,0,4000
eV9b5GJw,3900,9/20/2019,8900,eV9b5GJw,21900,more than downpayment,more than downpayment,0,3900
eV9b5GJw,3900,10/15/2019,8900,eV9b5GJw,25800,more than downpayment,more than downpayment,0,3900
eV9b5GJw,3900,12/2/2019,8900,eV9b5GJw,29700,more than downpayment,more than downpayment,0,3900
eV9b5GJw,1000,1/4/2020,8900,eV9b5GJw,30700,more than downpayment,more than downpayment,0,1000
eV9b5GJw,1000,1/23/2020,8900,eV9b5GJw,31700,more than downpayment,more than downpayment,0,1000
evDFsXfx,8900,2/13/2019,8900,,8900,equal to downpayment,,8900,0
evDFsXfx,3900,3/25/2019,8900,evDFsXfx,12800,more than downpayment,equal to downpayment,0,3900
evDFsXfx,3900,4/25/2019,8900,evDFsXfx,16700,more than downpayment,more than downpayment,0,3900
evDFsXfx,3900,5/25/2019,8900,evDFsXfx,20600,more than downpayment,more than downpayment,0,3900
evDFsXfx,3900,6/25/2019,8900,evDFsXfx,24500,more than downpayment,more than downpayment,0,3900
evDFsXfx,3900,7/25/2019,8900,evDFsXfx,28400,more than downpayment,more than downpayment,0,3900
evDFsXfx,3900,8/24/2019,8900,evDFsXfx,32300,more than downpayment,more than downpayment,0,3900
evDFsXfx,3900,9/25/2019,8900,evDFsXfx,36200,more than downpayment,more than downpayment,0,3900
evDFsXfx,3900,10/25/2019,8900,evDFsXfx,40100,more than downpayment,more than downpayment,0,3900
evDFsXfx,3900,11/25/2019,8900,evDFsXfx,44000,more than downpayment,more than downpayment,0,3900
evDFsXfx,3900,12/19/2019,8900,evDFsXfx,47900,more than downpayment,more than downpayment,0,3900
evDFsXfx,3900,1/26/2020,8900,evDFsXfx,51800,more than downpayment,more than downpayment,0,3900
eVDSrJk8,8900,4/9/2019,8900,,8900,equal to downpayment,,8900,0
eVDSrJk8,3900,4/28/2019,8900,eVDSrJk8,12800,more than downpayment,equal to downpayment,0,3900
eVDSrJk8,3900,5/27/2019,8900,eVDSrJk8,16700,more than downpayment,more than downpayment,0,3900
eVDSrJk8,7800,6/26/2019,8900,eVDSrJk8,24500,more than downpayment,more than downpayment,0,7800
eVDSrJk8,3900,7/25/2019,8900,eVDSrJk8,28400,more than downpayment,more than downpayment,0,3900
eVDSrJk8,3900,8/27/2019,8900,eVDSrJk8,32300,more than downpayment,more than downpayment,0,3900
eVDSrJk8,3900,9/26/2019,8900,eVDSrJk8,36200,more than downpayment,more than downpayment,0,3900
eVDSrJk8,3900,10/28/2019,8900,eVDSrJk8,40100,more than downpayment,more than downpayment,0,3900
eVDSrJk8,3900,11/27/2019,8900,eVDSrJk8,44000,more than downpayment,more than downpayment,0,3900
eVDSrJk8,3900,1/1/2020,8900,eVDSrJk8,47900,more than downpayment,more than downpayment,0,3900
eVDSrJk8,3900,1/27/2020,8900,eVDSrJk8,51800,more than downpayment,more than downpayment,0,3900
EvnBmAry,8900,5/7/2019,8900,,8900,equal to downpayment,,8900,0
EvnBmAry,3900,6/7/2019,8900,EvnBmAry,12800,more than downpayment,equal to downpayment,0,3900
EvnBmAry,3900,7/15/2019,8900,EvnBmAry,16700,more than downpayment,more than downpayment,0,3900
EvnBmAry,3900,8/6/2019,8900,EvnBmAry,20600,more than downpayment,more than downpayment,0,3900
EvnBmAry,3900,9/6/2019,8900,EvnBmAry,24500,more than downpayment,more than downpayment,0,3900
EvnBmAry,3900,10/8/2019,8900,EvnBmAry,28400,more than downpayment,more than downpayment,0,3900
EvnBmAry,3900,11/6/2019,8900,EvnBmAry,32300,more than downpayment,more than downpayment,0,3900
EvnBmAry,3900,12/17/2019,8900,EvnBmAry,36200,more than downpayment,more than downpayment,0,3900
EvnBmAry,3900,1/8/2020,8900,EvnBmAry,40100,more than downpayment,more than downpayment,0,3900
EvnBmAry,3900,2/7/2020,8900,EvnBmAry,44000,more than downpayment,more than downpayment,0,3900
EVSSNUML,9900,10/29/2019,9900,,9900,equal to downpayment,,9900,0
EVSSNUML,3900,12/20/2019,9900,EVSSNUML,13800,more than downpayment,equal to downpayment,0,3900
EVSSNUML,3900,1/7/2020,9900,EVSSNUML,17700,more than downpayment,more than downpayment,0,3900
EVSSNUML,3900,2/5/2020,9900,EVSSNUML,21600,more than downpayment,more than downpayment,0,3900
eVv4SD3h,9900,8/1/2019,9900,,9900,equal to downpayment,,9900,0
eVv4SD3h,3900,9/25/2019,9900,eVv4SD3h,13800,more than downpayment,equal to downpayment,0,3900
eVv4SD3h,3900,10/25/2019,9900,eVv4SD3h,17700,more than downpayment,more than downpayment,0,3900
eVv4SD3h,3900,11/28/2019,9900,eVv4SD3h,21600,more than downpayment,more than downpayment,0,3900
eVv4SD3h,3900,12/29/2019,9900,eVv4SD3h,25500,more than downpayment,more than downpayment,0,3900
eVv4SD3h,3900,1/27/2020,9900,eVv4SD3h,29400,more than downpayment,more than downpayment,0,3900
EW1DJJM1,8900,2/5/2020,8900,,8900,equal to downpayment,,8900,0
eW32lASz,50000,1/7/2019,8900,,50000,more than downpayment,,8900,41100
eW32lASz,10000,12/2/2019,8900,eW32lASz,60000,more than downpayment,more than downpayment,0,10000
eWPPm6yW,10000,7/31/2018,10000,,10000,equal to downpayment,,10000,0
eWPPm6yW,5000,8/31/2018,10000,eWPPm6yW,15000,more than downpayment,equal to downpayment,0,5000
eWPPm6yW,5000,10/2/2018,10000,eWPPm6yW,20000,more than downpayment,more than downpayment,0,5000
eWPPm6yW,4500,11/3/2018,10000,eWPPm6yW,24500,more than downpayment,more than downpayment,0,4500
eWPPm6yW,4500,12/3/2018,10000,eWPPm6yW,29000,more than downpayment,more than downpayment,0,4500
eWPPm6yW,4500,12/28/2018,10000,eWPPm6yW,33500,more than downpayment,more than downpayment,0,4500
eWPPm6yW,4500,2/6/2019,10000,eWPPm6yW,38000,more than downpayment,more than downpayment,0,4500
eWPPm6yW,4500,3/6/2019,10000,eWPPm6yW,42500,more than downpayment,more than downpayment,0,4500
eWPPm6yW,4500,4/8/2019,10000,eWPPm6yW,47000,more than downpayment,more than downpayment,0,4500
eWPPm6yW,4500,5/6/2019,10000,eWPPm6yW,51500,more than downpayment,more than downpayment,0,4500
eWPPm6yW,4500,6/9/2019,10000,eWPPm6yW,56000,more than downpayment,more than downpayment,0,4500
eWPPm6yW,4500,7/4/2019,10000,eWPPm6yW,60500,more than downpayment,more than downpayment,0,4500
eWPPm6yW,3500,8/1/2019,10000,eWPPm6yW,64000,more than downpayment,more than downpayment,0,3500
eWPPm6yW,10000,2/5/2020,10000,eWPPm6yW,74000,more than downpayment,more than downpayment,0,10000
EXBU5G8F,8900,1/21/2020,8900,,8900,equal to downpayment,,8900,0
eXWEXizY,9000,4/17/2019,8900,,9000,more than downpayment,,8900,100
exXn2dfY,8900,4/25/2019,8900,,8900,equal to downpayment,,8900,0
exXn2dfY,3900,5/20/2019,8900,exXn2dfY,12800,more than downpayment,equal to downpayment,0,3900
exXn2dfY,3900,6/17/2019,8900,exXn2dfY,16700,more than downpayment,more than downpayment,0,3900
exXn2dfY,3900,7/20/2019,8900,exXn2dfY,20600,more than downpayment,more than downpayment,0,3900
exXn2dfY,3900,8/19/2019,8900,exXn2dfY,24500,more than downpayment,more than downpayment,0,3900
exXn2dfY,3900,9/17/2019,8900,exXn2dfY,28400,more than downpayment,more than downpayment,0,3900
exXn2dfY,3900,10/17/2019,8900,exXn2dfY,32300,more than downpayment,more than downpayment,0,3900
exXn2dfY,3900,11/17/2019,8900,exXn2dfY,36200,more than downpayment,more than downpayment,0,3900
exXn2dfY,3900,12/17/2019,8900,exXn2dfY,40100,more than downpayment,more than downpayment,0,3900
exXn2dfY,3900,1/17/2020,8900,exXn2dfY,44000,more than downpayment,more than downpayment,0,3900
EyJod3Lv,10000,8/13/2018,10000,,10000,equal to downpayment,,10000,0
EyJod3Lv,4500,9/23/2018,10000,EyJod3Lv,14500,more than downpayment,equal to downpayment,0,4500
EyJod3Lv,4500,10/24/2018,10000,EyJod3Lv,19000,more than downpayment,more than downpayment,0,4500
EyJod3Lv,4500,11/25/2018,10000,EyJod3Lv,23500,more than downpayment,more than downpayment,0,4500
EyJod3Lv,4500,12/24/2018,10000,EyJod3Lv,28000,more than downpayment,more than downpayment,0,4500
EyJod3Lv,4500,1/26/2019,10000,EyJod3Lv,32500,more than downpayment,more than downpayment,0,4500
EyJod3Lv,4500,2/25/2019,10000,EyJod3Lv,37000,more than downpayment,more than downpayment,0,4500
EyJod3Lv,4500,3/25/2019,10000,EyJod3Lv,41500,more than downpayment,more than downpayment,0,4500
EyJod3Lv,4500,4/26/2019,10000,EyJod3Lv,46000,more than downpayment,more than downpayment,0,4500
EyJod3Lv,4500,5/28/2019,10000,EyJod3Lv,50500,more than downpayment,more than downpayment,0,4500
EyJod3Lv,4500,6/27/2019,10000,EyJod3Lv,55000,more than downpayment,more than downpayment,0,4500
EyJod3Lv,4500,7/31/2019,10000,EyJod3Lv,59500,more than downpayment,more than downpayment,0,4500
EyJod3Lv,4500,9/14/2019,10000,EyJod3Lv,64000,more than downpayment,more than downpayment,0,4500
EylM7P85,8900,1/9/2019,8900,,8900,equal to downpayment,,8900,0
EylM7P85,3900,2/28/2019,8900,EylM7P85,12800,more than downpayment,equal to downpayment,0,3900
EylM7P85,3900,3/21/2019,8900,EylM7P85,16700,more than downpayment,more than downpayment,0,3900
EylM7P85,3900,4/24/2019,8900,EylM7P85,20600,more than downpayment,more than downpayment,0,3900
EylM7P85,3900,5/31/2019,8900,EylM7P85,24500,more than downpayment,more than downpayment,0,3900
EylM7P85,3900,7/15/2019,8900,EylM7P85,28400,more than downpayment,more than downpayment,0,3900
EylM7P85,3900,7/20/2019,8900,EylM7P85,32300,more than downpayment,more than downpayment,0,3900
EylM7P85,3900,10/2/2019,8900,EylM7P85,36200,more than downpayment,more than downpayment,0,3900
EylM7P85,11700,11/28/2019,8900,EylM7P85,47900,more than downpayment,more than downpayment,0,11700
EylM7P85,3900,12/26/2019,8900,EylM7P85,51800,more than downpayment,more than downpayment,0,3900
EylM7P85,3900,1/29/2020,8900,EylM7P85,55700,more than downpayment,more than downpayment,0,3900
EYSEPTHR,9900,1/23/2020,9900,,9900,equal to downpayment,,9900,0
EYSEPTHR,50000,2/8/2020,9900,EYSEPTHR,59900,more than downpayment,equal to downpayment,0,50000
EZ2N2BCP,9900,12/4/2019,9900,,9900,equal to downpayment,,9900,0
EZEBAF4A,8900,12/11/2019,8900,,8900,equal to downpayment,,8900,0
EZEBAF4A,3900,12/23/2019,8900,EZEBAF4A,12800,more than downpayment,equal to downpayment,0,3900
EZKJdiY9,10000,7/11/2019,9900,,10000,more than downpayment,,9900,100
EZKJdiY9,5000,8/15/2019,9900,EZKJdiY9,15000,more than downpayment,more than downpayment,0,5000
EZKJdiY9,5000,9/20/2019,9900,EZKJdiY9,20000,more than downpayment,more than downpayment,0,5000
EZKJdiY9,10000,11/28/2019,9900,EZKJdiY9,30000,more than downpayment,more than downpayment,0,10000
EZQ8XNJO,9900,8/20/2019,9900,,9900,equal to downpayment,,9900,0
EZRDZFCK,8900,1/9/2020,8900,,8900,equal to downpayment,,8900,0
f1017230,7900,10/24/2019,7900,,7900,equal to downpayment,,7900,0
f1017230,3100,12/5/2019,7900,f1017230,11000,more than downpayment,equal to downpayment,0,3100
f1017230,3100,1/30/2020,7900,f1017230,14100,more than downpayment,more than downpayment,0,3100
f13808cd,8900,12/21/2019,8900,,8900,equal to downpayment,,8900,0
f1a6f3cb,8900,10/3/2019,8900,,8900,equal to downpayment,,8900,0
f26098cc,8900,9/25/2019,8900,,8900,equal to downpayment,,8900,0
f26098cc,500,10/28/2019,8900,f26098cc,9400,more than downpayment,equal to downpayment,0,500
f26098cc,500,10/30/2019,8900,f26098cc,9900,more than downpayment,more than downpayment,0,500
f26098cc,900,11/16/2019,8900,f26098cc,10800,more than downpayment,more than downpayment,0,900
f26098cc,900,11/24/2019,8900,f26098cc,11700,more than downpayment,more than downpayment,0,900
f26098cc,500,11/25/2019,8900,f26098cc,12200,more than downpayment,more than downpayment,0,500
f26098cc,300,12/4/2019,8900,f26098cc,12500,more than downpayment,more than downpayment,0,300
f26098cc,300,12/9/2019,8900,f26098cc,12800,more than downpayment,more than downpayment,0,300
f26098cc,800,12/12/2019,8900,f26098cc,13600,more than downpayment,more than downpayment,0,800
f26098cc,800,12/13/2019,8900,f26098cc,14400,more than downpayment,more than downpayment,0,800
f26098cc,800,12/17/2019,8900,f26098cc,15200,more than downpayment,more than downpayment,0,800
f26098cc,800,12/26/2019,8900,f26098cc,16000,more than downpayment,more than downpayment,0,800
f26098cc,600,1/22/2020,8900,f26098cc,16600,more than downpayment,more than downpayment,0,600
f26098cc,200,1/27/2020,8900,f26098cc,16800,more than downpayment,more than downpayment,0,200
f26098cc,400,1/29/2020,8900,f26098cc,17200,more than downpayment,more than downpayment,0,400
F26T2MKX,8900,10/27/2019,8900,,8900,equal to downpayment,,8900,0
F26T2MKX,3900,12/29/2019,8900,F26T2MKX,12800,more than downpayment,equal to downpayment,0,3900
F26T2MKX,3900,1/27/2020,8900,F26T2MKX,16700,more than downpayment,more than downpayment,0,3900
F2MD49HS,9900,1/3/2020,9900,,9900,equal to downpayment,,9900,0
F2R4A6I3,9900,1/13/2020,9900,,9900,equal to downpayment,,9900,0
F327LtYt,8900,5/27/2019,8900,,8900,equal to downpayment,,8900,0
F327LtYt,3900,8/4/2019,8900,F327LtYt,12800,more than downpayment,equal to downpayment,0,3900
F327LtYt,3900,9/6/2019,8900,F327LtYt,16700,more than downpayment,more than downpayment,0,3900
F327LtYt,3900,10/29/2019,8900,F327LtYt,20600,more than downpayment,more than downpayment,0,3900
F327LtYt,3900,11/29/2019,8900,F327LtYt,24500,more than downpayment,more than downpayment,0,3900
F327LtYt,3900,12/31/2019,8900,F327LtYt,28400,more than downpayment,more than downpayment,0,3900
F327LtYt,3900,1/30/2020,8900,F327LtYt,32300,more than downpayment,more than downpayment,0,3900
f3e70bb7,7900,11/25/2019,7900,,7900,equal to downpayment,,7900,0
f3e70bb7,3100,12/14/2019,7900,f3e70bb7,11000,more than downpayment,equal to downpayment,0,3100
f3e70bb7,3100,1/15/2020,7900,f3e70bb7,14100,more than downpayment,more than downpayment,0,3100
f3ffb6a2,9900,12/18/2019,9900,,9900,equal to downpayment,,9900,0
f3TfHvxb,8900,2/26/2019,8900,,8900,equal to downpayment,,8900,0
f3TfHvxb,3900,4/4/2019,8900,f3TfHvxb,12800,more than downpayment,equal to downpayment,0,3900
f3TfHvxb,3900,5/5/2019,8900,f3TfHvxb,16700,more than downpayment,more than downpayment,0,3900
f3TfHvxb,3900,6/5/2019,8900,f3TfHvxb,20600,more than downpayment,more than downpayment,0,3900
f3TfHvxb,3900,7/8/2019,8900,f3TfHvxb,24500,more than downpayment,more than downpayment,0,3900
f3TfHvxb,3900,8/7/2019,8900,f3TfHvxb,28400,more than downpayment,more than downpayment,0,3900
f3TfHvxb,3900,9/3/2019,8900,f3TfHvxb,32300,more than downpayment,more than downpayment,0,3900
f3TfHvxb,3900,10/7/2019,8900,f3TfHvxb,36200,more than downpayment,more than downpayment,0,3900
f3TfHvxb,3900,11/8/2019,8900,f3TfHvxb,40100,more than downpayment,more than downpayment,0,3900
f3TfHvxb,3900,12/12/2019,8900,f3TfHvxb,44000,more than downpayment,more than downpayment,0,3900
f3TfHvxb,3900,1/7/2020,8900,f3TfHvxb,47900,more than downpayment,more than downpayment,0,3900
f3TfHvxb,3900,2/5/2020,8900,f3TfHvxb,51800,more than downpayment,more than downpayment,0,3900
f4d057d2,9900,12/5/2019,9900,,9900,equal to downpayment,,9900,0
f4d057d2,3900,1/23/2020,9900,f4d057d2,13800,more than downpayment,equal to downpayment,0,3900
f4HrOGJt,8900,2/19/2019,8900,,8900,equal to downpayment,,8900,0
f4HrOGJt,3900,3/21/2019,8900,f4HrOGJt,12800,more than downpayment,equal to downpayment,0,3900
f4HrOGJt,3900,4/23/2019,8900,f4HrOGJt,16700,more than downpayment,more than downpayment,0,3900
f4HrOGJt,3900,5/25/2019,8900,f4HrOGJt,20600,more than downpayment,more than downpayment,0,3900
f4HrOGJt,3900,6/24/2019,8900,f4HrOGJt,24500,more than downpayment,more than downpayment,0,3900
f4HrOGJt,3900,7/24/2019,8900,f4HrOGJt,28400,more than downpayment,more than downpayment,0,3900
f4HrOGJt,3900,8/25/2019,8900,f4HrOGJt,32300,more than downpayment,more than downpayment,0,3900
f4HrOGJt,3900,9/25/2019,8900,f4HrOGJt,36200,more than downpayment,more than downpayment,0,3900
f4HrOGJt,3900,10/25/2019,8900,f4HrOGJt,40100,more than downpayment,more than downpayment,0,3900
f4HrOGJt,3900,11/25/2019,8900,f4HrOGJt,44000,more than downpayment,more than downpayment,0,3900
f4HrOGJt,3900,12/25/2019,8900,f4HrOGJt,47900,more than downpayment,more than downpayment,0,3900
f4HrOGJt,3900,1/25/2020,8900,f4HrOGJt,51800,more than downpayment,more than downpayment,0,3900
f54fe69f,6000,11/22/2019,7900,,6000,less than downpayment,,6000,0
f54fe69f,1900,11/26/2019,7900,f54fe69f,7900,equal to downpayment,less than downpayment,1900,0
F55R5TN2,9900,10/11/2019,9900,,9900,equal to downpayment,,9900,0
F55R5TN2,1300,12/3/2019,9900,F55R5TN2,11200,more than downpayment,equal to downpayment,0,1300
F55R5TN2,1250,12/9/2019,9900,F55R5TN2,12450,more than downpayment,more than downpayment,0,1250
F55R5TN2,1350,12/13/2019,9900,F55R5TN2,13800,more than downpayment,more than downpayment,0,1350
F55R5TN2,3000,1/7/2020,9900,F55R5TN2,16800,more than downpayment,more than downpayment,0,3000
F55R5TN2,850,1/11/2020,9900,F55R5TN2,17650,more than downpayment,more than downpayment,0,850
F55R5TN2,2000,2/6/2020,9900,F55R5TN2,19650,more than downpayment,more than downpayment,0,2000
f57c8d86,1000,10/18/2019,8900,,1000,less than downpayment,,1000,0
f57c8d86,4000,10/19/2019,8900,f57c8d86,5000,less than downpayment,less than downpayment,4000,0
f57c8d86,1000,10/30/2019,8900,f57c8d86,6000,less than downpayment,less than downpayment,1000,0
f57c8d86,1000,11/17/2019,8900,f57c8d86,7000,less than downpayment,less than downpayment,1000,0
f57c8d86,1000,11/26/2019,8900,f57c8d86,8000,less than downpayment,less than downpayment,1000,0
f57c8d86,1000,1/22/2020,8900,f57c8d86,9000,more than downpayment,less than downpayment,900,100
f57c8d86,1000,1/27/2020,8900,f57c8d86,10000,more than downpayment,more than downpayment,0,1000
f57c8d86,2000,1/30/2020,8900,f57c8d86,12000,more than downpayment,more than downpayment,0,2000
f57c8d86,1000,2/5/2020,8900,f57c8d86,13000,more than downpayment,more than downpayment,0,1000
f57c8d86,1000,2/7/2020,8900,f57c8d86,14000,more than downpayment,more than downpayment,0,1000
f5ace262,9900,10/15/2019,9900,,9900,equal to downpayment,,9900,0
f5fc0f35,9900,10/30/2019,9900,,9900,equal to downpayment,,9900,0
f5fc0f35,3900,11/30/2019,9900,f5fc0f35,13800,more than downpayment,equal to downpayment,0,3900
f5fc0f35,3900,12/21/2019,9900,f5fc0f35,17700,more than downpayment,more than downpayment,0,3900
f5fc0f35,3900,1/31/2020,9900,f5fc0f35,21600,more than downpayment,more than downpayment,0,3900
f5i8cCg6,8900,1/10/2019,8900,,8900,equal to downpayment,,8900,0
f5i8cCg6,3900,1/18/2019,8900,f5i8cCg6,12800,more than downpayment,equal to downpayment,0,3900
f5i8cCg6,3900,1/31/2019,8900,f5i8cCg6,16700,more than downpayment,more than downpayment,0,3900
f5i8cCg6,3900,2/11/2019,8900,f5i8cCg6,20600,more than downpayment,more than downpayment,0,3900
f5i8cCg6,3900,3/20/2019,8900,f5i8cCg6,24500,more than downpayment,more than downpayment,0,3900
f5i8cCg6,3900,5/9/2019,8900,f5i8cCg6,28400,more than downpayment,more than downpayment,0,3900
f5i8cCg6,3900,6/3/2019,8900,f5i8cCg6,32300,more than downpayment,more than downpayment,0,3900
f5i8cCg6,3900,6/19/2019,8900,f5i8cCg6,36200,more than downpayment,more than downpayment,0,3900
f5i8cCg6,3900,8/25/2019,8900,f5i8cCg6,40100,more than downpayment,more than downpayment,0,3900
f5i8cCg6,3900,9/24/2019,8900,f5i8cCg6,44000,more than downpayment,more than downpayment,0,3900
f5i8cCg6,3900,12/17/2019,8900,f5i8cCg6,47900,more than downpayment,more than downpayment,0,3900
f5i8cCg6,3900,1/9/2020,8900,f5i8cCg6,51800,more than downpayment,more than downpayment,0,3900
f5i8cCg6,3900,1/16/2020,8900,f5i8cCg6,55700,more than downpayment,more than downpayment,0,3900
f64cd05c,8900,10/21/2019,8900,,8900,equal to downpayment,,8900,0
f64cd05c,3900,11/25/2019,8900,f64cd05c,12800,more than downpayment,equal to downpayment,0,3900
f64cd05c,4000,12/28/2019,8900,f64cd05c,16800,more than downpayment,more than downpayment,0,4000
f64cd05c,3900,2/4/2020,8900,f64cd05c,20700,more than downpayment,more than downpayment,0,3900
f6757c74,8900,1/11/2020,8900,,8900,equal to downpayment,,8900,0
f6ecd1f1,24000,12/29/2019,23400,,24000,more than downpayment,,23400,600
f6fcaaf3,9000,1/27/2020,8900,,9000,more than downpayment,,8900,100
f7745a77,7900,9/30/2019,7900,,7900,equal to downpayment,,7900,0
f7745a77,3100,1/9/2020,7900,f7745a77,11000,more than downpayment,equal to downpayment,0,3100
f7997f9e,9900,10/3/2019,9900,,9900,equal to downpayment,,9900,0
f7997f9e,3900,12/4/2019,9900,f7997f9e,13800,more than downpayment,equal to downpayment,0,3900
f7997f9e,3900,1/5/2020,9900,f7997f9e,17700,more than downpayment,more than downpayment,0,3900
f7997f9e,3900,2/5/2020,9900,f7997f9e,21600,more than downpayment,more than downpayment,0,3900
f7e9879c,9900,9/17/2019,9900,,9900,equal to downpayment,,9900,0
f7e9879c,3900,12/3/2019,9900,f7e9879c,13800,more than downpayment,equal to downpayment,0,3900
f7e9879c,3900,1/4/2020,9900,f7e9879c,17700,more than downpayment,more than downpayment,0,3900
f7e9879c,3900,2/6/2020,9900,f7e9879c,21600,more than downpayment,more than downpayment,0,3900
F7ROXKRC,4900,10/24/2019,9900,,4900,less than downpayment,,4900,0
F7ROXKRC,9000,10/29/2019,9900,F7ROXKRC,13900,more than downpayment,less than downpayment,5000,4000
F82XDFRX,5999,9/6/2019,1999,,5999,more than downpayment,,1999,4000
F82XDFRX,2050,9/11/2019,1999,F82XDFRX,8049,more than downpayment,more than downpayment,0,2050
F82XDFRX,3100,11/3/2019,1999,F82XDFRX,11149,more than downpayment,more than downpayment,0,3100
F82XDFRX,2951,12/16/2019,1999,F82XDFRX,14100,more than downpayment,more than downpayment,0,2951
F82XDFRX,3100,1/15/2020,1999,F82XDFRX,17200,more than downpayment,more than downpayment,0,3100
F8E74XEY,9900,11/8/2019,9900,,9900,equal to downpayment,,9900,0
F8E74XEY,4000,12/12/2019,9900,F8E74XEY,13900,more than downpayment,equal to downpayment,0,4000
F8E74XEY,4000,1/6/2020,9900,F8E74XEY,17900,more than downpayment,more than downpayment,0,4000
F8F9WYCN,1,1/5/2020,9900,,1,less than downpayment,,1,0
f915dc45,9900,11/19/2019,9900,,9900,equal to downpayment,,9900,0
f915dc45,3900,1/15/2020,9900,f915dc45,13800,more than downpayment,equal to downpayment,0,3900
F9F2V76M,9900,10/1/2019,9900,,9900,equal to downpayment,,9900,0
F9F2V76M,4000,11/29/2019,9900,F9F2V76M,13900,more than downpayment,equal to downpayment,0,4000
F9F2V76M,3800,1/2/2020,9900,F9F2V76M,17700,more than downpayment,more than downpayment,0,3800
F9F2V76M,8000,2/4/2020,9900,F9F2V76M,25700,more than downpayment,more than downpayment,0,8000
f9ff2372,50000,11/14/2019,40000,,50000,more than downpayment,,40000,10000
f9ff2372,50000,1/24/2020,40000,f9ff2372,100000,more than downpayment,more than downpayment,0,50000
F9GXywST,8900,1/7/2019,8900,,8900,equal to downpayment,,8900,0
F9GXywST,3900,2/15/2019,8900,F9GXywST,12800,more than downpayment,equal to downpayment,0,3900
F9GXywST,3900,3/16/2019,8900,F9GXywST,16700,more than downpayment,more than downpayment,0,3900
F9GXywST,3900,4/12/2019,8900,F9GXywST,20600,more than downpayment,more than downpayment,0,3900
F9GXywST,3900,5/16/2019,8900,F9GXywST,24500,more than downpayment,more than downpayment,0,3900
F9GXywST,3900,6/15/2019,8900,F9GXywST,28400,more than downpayment,more than downpayment,0,3900
F9GXywST,3900,7/15/2019,8900,F9GXywST,32300,more than downpayment,more than downpayment,0,3900
F9GXywST,3900,8/16/2019,8900,F9GXywST,36200,more than downpayment,more than downpayment,0,3900
F9GXywST,3900,9/15/2019,8900,F9GXywST,40100,more than downpayment,more than downpayment,0,3900
F9GXywST,3900,10/15/2019,8900,F9GXywST,44000,more than downpayment,more than downpayment,0,3900
F9GXywST,3900,11/16/2019,8900,F9GXywST,47900,more than downpayment,more than downpayment,0,3900
F9GXywST,3900,12/16/2019,8900,F9GXywST,51800,more than downpayment,more than downpayment,0,3900
F9GXywST,3900,1/15/2020,8900,F9GXywST,55700,more than downpayment,more than downpayment,0,3900
FA21ZV4Y,9900,1/10/2020,9900,,9900,equal to downpayment,,9900,0
FaAvV62B,9900,6/5/2019,8900,,9900,more than downpayment,,8900,1000
FaAvV62B,4000,7/3/2019,8900,FaAvV62B,13900,more than downpayment,more than downpayment,0,4000
FaAvV62B,4000,8/4/2019,8900,FaAvV62B,17900,more than downpayment,more than downpayment,0,4000
FaAvV62B,3900,9/4/2019,8900,FaAvV62B,21800,more than downpayment,more than downpayment,0,3900
FaAvV62B,4000,10/4/2019,8900,FaAvV62B,25800,more than downpayment,more than downpayment,0,4000
FaAvV62B,3900,11/5/2019,8900,FaAvV62B,29700,more than downpayment,more than downpayment,0,3900
FaAvV62B,3900,12/5/2019,8900,FaAvV62B,33600,more than downpayment,more than downpayment,0,3900
FaAvV62B,4000,1/6/2020,8900,FaAvV62B,37600,more than downpayment,more than downpayment,0,4000
FaAvV62B,4000,2/5/2020,8900,FaAvV62B,41600,more than downpayment,more than downpayment,0,4000
faQMzZ0m,8900,9/23/2019,7900,,8900,more than downpayment,,7900,1000
faQMzZ0m,2100,11/21/2019,7900,faQMzZ0m,11000,more than downpayment,more than downpayment,0,2100
faQMzZ0m,500,12/5/2019,7900,faQMzZ0m,11500,more than downpayment,more than downpayment,0,500
faQMzZ0m,2600,12/24/2019,7900,faQMzZ0m,14100,more than downpayment,more than downpayment,0,2600
faQMzZ0m,3100,1/25/2020,7900,faQMzZ0m,17200,more than downpayment,more than downpayment,0,3100
FAUMEU6Q,9900,12/18/2019,9900,,9900,equal to downpayment,,9900,0
fb1e5fdc,9900,11/27/2019,9900,,9900,equal to downpayment,,9900,0
fb1e5fdc,4000,1/25/2020,9900,fb1e5fdc,13900,more than downpayment,equal to downpayment,0,4000
fb4dd0b2,8900,9/28/2019,8900,,8900,equal to downpayment,,8900,0
fb4dd0b2,1000,11/10/2019,8900,fb4dd0b2,9900,more than downpayment,equal to downpayment,0,1000
fb4dd0b2,3900,12/10/2019,8900,fb4dd0b2,13800,more than downpayment,more than downpayment,0,3900
fb4dd0b2,3900,1/14/2020,8900,fb4dd0b2,17700,more than downpayment,more than downpayment,0,3900
fbe3135c,9900,10/14/2019,9900,,9900,equal to downpayment,,9900,0
fbe3135c,4000,11/20/2019,9900,fbe3135c,13900,more than downpayment,equal to downpayment,0,4000
fbe3135c,8000,1/30/2020,9900,fbe3135c,21900,more than downpayment,more than downpayment,0,8000
FbfVoE7k,8900,11/19/2018,8900,,8900,equal to downpayment,,8900,0
FbfVoE7k,3900,12/25/2018,8900,FbfVoE7k,12800,more than downpayment,equal to downpayment,0,3900
FbfVoE7k,3900,1/23/2019,8900,FbfVoE7k,16700,more than downpayment,more than downpayment,0,3900
FbfVoE7k,3900,2/25/2019,8900,FbfVoE7k,20600,more than downpayment,more than downpayment,0,3900
FbfVoE7k,3900,3/25/2019,8900,FbfVoE7k,24500,more than downpayment,more than downpayment,0,3900
FbfVoE7k,3900,4/26/2019,8900,FbfVoE7k,28400,more than downpayment,more than downpayment,0,3900
FbfVoE7k,3900,5/26/2019,8900,FbfVoE7k,32300,more than downpayment,more than downpayment,0,3900
FbfVoE7k,3900,6/27/2019,8900,FbfVoE7k,36200,more than downpayment,more than downpayment,0,3900
FbfVoE7k,3900,7/25/2019,8900,FbfVoE7k,40100,more than downpayment,more than downpayment,0,3900
FbfVoE7k,3900,8/28/2019,8900,FbfVoE7k,44000,more than downpayment,more than downpayment,0,3900
FbfVoE7k,3900,9/25/2019,8900,FbfVoE7k,47900,more than downpayment,more than downpayment,0,3900
FbfVoE7k,3900,10/26/2019,8900,FbfVoE7k,51800,more than downpayment,more than downpayment,0,3900
FbfVoE7k,3900,11/25/2019,8900,FbfVoE7k,55700,more than downpayment,more than downpayment,0,3900
FbfVoE7k,3900,12/28/2019,8900,FbfVoE7k,59600,more than downpayment,more than downpayment,0,3900
FbfVoE7k,3900,1/25/2020,8900,FbfVoE7k,63500,more than downpayment,more than downpayment,0,3900
FbfVoE7k,31460,1/31/2020,8900,FbfVoE7k,94960,more than downpayment,more than downpayment,0,31460
FBncxSoX,2000,6/27/2019,1999,,2000,more than downpayment,,1999,1
FBncxSoX,2000,8/28/2019,1999,FBncxSoX,4000,more than downpayment,more than downpayment,0,2000
FBncxSoX,2000,10/17/2019,1999,FBncxSoX,6000,more than downpayment,more than downpayment,0,2000
FBncxSoX,2000,11/6/2019,1999,FBncxSoX,8000,more than downpayment,more than downpayment,0,2000
FBncxSoX,2000,11/29/2019,1999,FBncxSoX,10000,more than downpayment,more than downpayment,0,2000
FBncxSoX,1999,12/19/2019,1999,FBncxSoX,11999,more than downpayment,more than downpayment,0,1999
FBncxSoX,2000,1/24/2020,1999,FBncxSoX,13999,more than downpayment,more than downpayment,0,2000
FBYt3ZXq,10000,6/16/2017,10000,,10000,equal to downpayment,,10000,0
FBYt3ZXq,5000,8/17/2017,10000,FBYt3ZXq,15000,more than downpayment,equal to downpayment,0,5000
FBYt3ZXq,5000,10/9/2017,10000,FBYt3ZXq,20000,more than downpayment,more than downpayment,0,5000
FBYt3ZXq,5000,11/16/2017,10000,FBYt3ZXq,25000,more than downpayment,more than downpayment,0,5000
FBYt3ZXq,4500,12/13/2017,10000,FBYt3ZXq,29500,more than downpayment,more than downpayment,0,4500
FBYt3ZXq,4000,1/19/2018,10000,FBYt3ZXq,33500,more than downpayment,more than downpayment,0,4000
FBYt3ZXq,3000,2/21/2018,10000,FBYt3ZXq,36500,more than downpayment,more than downpayment,0,3000
FBYt3ZXq,3000,3/17/2018,10000,FBYt3ZXq,39500,more than downpayment,more than downpayment,0,3000
FBYt3ZXq,3000,4/19/2018,10000,FBYt3ZXq,42500,more than downpayment,more than downpayment,0,3000
FBYt3ZXq,3500,5/22/2018,10000,FBYt3ZXq,46000,more than downpayment,more than downpayment,0,3500
FBZxRa1g,8900,7/24/2019,8900,,8900,equal to downpayment,,8900,0
FBZxRa1g,3900,9/6/2019,8900,FBZxRa1g,12800,more than downpayment,equal to downpayment,0,3900
FBZxRa1g,3900,10/14/2019,8900,FBZxRa1g,16700,more than downpayment,more than downpayment,0,3900
FBZxRa1g,3900,11/8/2019,8900,FBZxRa1g,20600,more than downpayment,more than downpayment,0,3900
FBZxRa1g,3900,12/9/2019,8900,FBZxRa1g,24500,more than downpayment,more than downpayment,0,3900
FBZxRa1g,3900,1/7/2020,8900,FBZxRa1g,28400,more than downpayment,more than downpayment,0,3900
FBZxRa1g,3900,2/9/2020,8900,FBZxRa1g,32300,more than downpayment,more than downpayment,0,3900
fc480992,100,11/8/2019,9900,,100,less than downpayment,,100,0
fc480992,9800,12/2/2019,9900,fc480992,9900,equal to downpayment,less than downpayment,9800,0
fd053312,9900,11/26/2019,9900,,9900,equal to downpayment,,9900,0
fd053312,3900,1/25/2020,9900,fd053312,13800,more than downpayment,equal to downpayment,0,3900
FD3YLMA8,8900,12/27/2019,8900,,8900,equal to downpayment,,8900,0
fddaa8b9,9900,11/25/2019,9900,,9900,equal to downpayment,,9900,0
fddaa8b9,3900,1/15/2020,9900,fddaa8b9,13800,more than downpayment,equal to downpayment,0,3900
fDRhy6vb,9000,9/6/2019,8900,,9000,more than downpayment,,8900,100
fDRhy6vb,4000,1/20/2020,8900,fDRhy6vb,13000,more than downpayment,more than downpayment,0,4000
fDTpXtMh,3825,6/15/2017,10000,,3825,less than downpayment,,3825,0
fDTpXtMh,7500,6/22/2017,10000,fDTpXtMh,11325,more than downpayment,less than downpayment,6175,1325
fDTpXtMh,3000,8/1/2017,10000,fDTpXtMh,14325,more than downpayment,more than downpayment,0,3000
fDTpXtMh,3000,8/28/2017,10000,fDTpXtMh,17325,more than downpayment,more than downpayment,0,3000
fDTpXtMh,3000,11/1/2017,10000,fDTpXtMh,20325,more than downpayment,more than downpayment,0,3000
fDTpXtMh,3000,12/30/2017,10000,fDTpXtMh,23325,more than downpayment,more than downpayment,0,3000
fDTpXtMh,3000,1/30/2018,10000,fDTpXtMh,26325,more than downpayment,more than downpayment,0,3000
fDTpXtMh,3000,2/26/2018,10000,fDTpXtMh,29325,more than downpayment,more than downpayment,0,3000
fDTpXtMh,3000,3/27/2018,10000,fDTpXtMh,32325,more than downpayment,more than downpayment,0,3000
fDTpXtMh,2675,5/9/2018,10000,fDTpXtMh,35000,more than downpayment,more than downpayment,0,2675
fe57696e,8900,10/24/2019,8900,,8900,equal to downpayment,,8900,0
fe57696e,3900,12/17/2019,8900,fe57696e,12800,more than downpayment,equal to downpayment,0,3900
fe57696e,3900,1/24/2020,8900,fe57696e,16700,more than downpayment,more than downpayment,0,3900
fe6ffcda,8900,2/8/2020,8900,,8900,equal to downpayment,,8900,0
fe817ba3,9900,1/6/2020,9900,,9900,equal to downpayment,,9900,0
fec8471e,8900,12/17/2019,8900,,8900,equal to downpayment,,8900,0
fec8471e,3900,2/5/2020,8900,fec8471e,12800,more than downpayment,equal to downpayment,0,3900
FeItMsz1,10000,7/13/2018,10000,,10000,equal to downpayment,,10000,0
FeItMsz1,4500,8/11/2018,10000,FeItMsz1,14500,more than downpayment,equal to downpayment,0,4500
FeItMsz1,4500,9/12/2018,10000,FeItMsz1,19000,more than downpayment,more than downpayment,0,4500
FeItMsz1,4500,10/12/2018,10000,FeItMsz1,23500,more than downpayment,more than downpayment,0,4500
FeItMsz1,4500,11/12/2018,10000,FeItMsz1,28000,more than downpayment,more than downpayment,0,4500
FeItMsz1,4500,12/12/2018,10000,FeItMsz1,32500,more than downpayment,more than downpayment,0,4500
FeItMsz1,4500,1/13/2019,10000,FeItMsz1,37000,more than downpayment,more than downpayment,0,4500
FeItMsz1,4500,2/12/2019,10000,FeItMsz1,41500,more than downpayment,more than downpayment,0,4500
FeItMsz1,4500,3/12/2019,10000,FeItMsz1,46000,more than downpayment,more than downpayment,0,4500
FeItMsz1,4500,4/12/2019,10000,FeItMsz1,50500,more than downpayment,more than downpayment,0,4500
FeItMsz1,4500,5/13/2019,10000,FeItMsz1,55000,more than downpayment,more than downpayment,0,4500
FeItMsz1,4500,6/23/2019,10000,FeItMsz1,59500,more than downpayment,more than downpayment,0,4500
FeItMsz1,4500,7/12/2019,10000,FeItMsz1,64000,more than downpayment,more than downpayment,0,4500
FEU9ARPX,8800,1/9/2020,8900,,8800,less than downpayment,,8800,0
FEU9ARPX,100,1/13/2020,8900,FEU9ARPX,8900,equal to downpayment,less than downpayment,100,0
ff0f3054,7900,1/9/2020,7900,,7900,equal to downpayment,,7900,0
ff0f3054,3100,2/3/2020,7900,ff0f3054,11000,more than downpayment,equal to downpayment,0,3100
FF41SCsE,8900,3/16/2019,8900,,8900,equal to downpayment,,8900,0
FF41SCsE,3900,4/25/2019,8900,FF41SCsE,12800,more than downpayment,equal to downpayment,0,3900
FF41SCsE,3900,5/24/2019,8900,FF41SCsE,16700,more than downpayment,more than downpayment,0,3900
FF41SCsE,3900,6/25/2019,8900,FF41SCsE,20600,more than downpayment,more than downpayment,0,3900
FF41SCsE,3900,7/25/2019,8900,FF41SCsE,24500,more than downpayment,more than downpayment,0,3900
FF41SCsE,3900,8/23/2019,8900,FF41SCsE,28400,more than downpayment,more than downpayment,0,3900
FF41SCsE,3900,9/25/2019,8900,FF41SCsE,32300,more than downpayment,more than downpayment,0,3900
FF41SCsE,3900,10/29/2019,8900,FF41SCsE,36200,more than downpayment,more than downpayment,0,3900
FF41SCsE,3900,11/25/2019,8900,FF41SCsE,40100,more than downpayment,more than downpayment,0,3900
FF41SCsE,3900,12/21/2019,8900,FF41SCsE,44000,more than downpayment,more than downpayment,0,3900
FF41SCsE,3900,1/25/2020,8900,FF41SCsE,47900,more than downpayment,more than downpayment,0,3900
FFS6II4H,9900,10/26/2019,9900,,9900,equal to downpayment,,9900,0
FFS6II4H,3900,12/30/2019,9900,FFS6II4H,13800,more than downpayment,equal to downpayment,0,3900
FFS6II4H,3900,1/31/2020,9900,FFS6II4H,17700,more than downpayment,more than downpayment,0,3900
FGE4QE84,9900,1/8/2020,8900,,9900,more than downpayment,,8900,1000
FGLWTGE5,9900,9/2/2019,9900,,9900,equal to downpayment,,9900,0
FGLWTGE5,3900,11/5/2019,9900,FGLWTGE5,13800,more than downpayment,equal to downpayment,0,3900
FGLWTGE5,3900,12/6/2019,9900,FGLWTGE5,17700,more than downpayment,more than downpayment,0,3900
FGLWTGE5,3900,1/5/2020,9900,FGLWTGE5,21600,more than downpayment,more than downpayment,0,3900
FGLWTGE5,3900,2/6/2020,9900,FGLWTGE5,25500,more than downpayment,more than downpayment,0,3900
FH4BLVNV,9900,9/11/2019,8900,,9900,more than downpayment,,8900,1000
FH4BLVNV,2900,12/2/2019,8900,FH4BLVNV,12800,more than downpayment,more than downpayment,0,2900
FH4BLVNV,3900,12/30/2019,8900,FH4BLVNV,16700,more than downpayment,more than downpayment,0,3900
FH4BLVNV,3900,1/27/2020,8900,FH4BLVNV,20600,more than downpayment,more than downpayment,0,3900
FHGMYW64,9900,10/25/2019,9900,,9900,equal to downpayment,,9900,0
FHGMYW64,2000,12/3/2019,9900,FHGMYW64,11900,more than downpayment,equal to downpayment,0,2000
FHGMYW64,1900,12/10/2019,9900,FHGMYW64,13800,more than downpayment,more than downpayment,0,1900
FHGMYW64,1200,1/3/2020,9900,FHGMYW64,15000,more than downpayment,more than downpayment,0,1200
FHGMYW64,1000,1/14/2020,9900,FHGMYW64,16000,more than downpayment,more than downpayment,0,1000
FHGMYW64,600,2/4/2020,9900,FHGMYW64,16600,more than downpayment,more than downpayment,0,600
FHMLO164,9900,1/3/2020,9900,,9900,equal to downpayment,,9900,0
FI12EbSc,8900,3/1/2019,8900,,8900,equal to downpayment,,8900,0
FI12EbSc,3300,4/30/2019,8900,FI12EbSc,12200,more than downpayment,equal to downpayment,0,3300
FI12EbSc,3900,5/15/2019,8900,FI12EbSc,16100,more than downpayment,more than downpayment,0,3900
FI12EbSc,4000,6/7/2019,8900,FI12EbSc,20100,more than downpayment,more than downpayment,0,4000
FI12EbSc,4000,6/28/2019,8900,FI12EbSc,24100,more than downpayment,more than downpayment,0,4000
FI12EbSc,4000,7/29/2019,8900,FI12EbSc,28100,more than downpayment,more than downpayment,0,4000
FI12EbSc,3750,8/29/2019,8900,FI12EbSc,31850,more than downpayment,more than downpayment,0,3750
FI12EbSc,7800,11/9/2019,8900,FI12EbSc,39650,more than downpayment,more than downpayment,0,7800
FI12EbSc,3800,12/26/2019,8900,FI12EbSc,43450,more than downpayment,more than downpayment,0,3800
FI12EbSc,5000,1/30/2020,8900,FI12EbSc,48450,more than downpayment,more than downpayment,0,5000
FICYMYZC,9900,11/4/2019,9900,,9900,equal to downpayment,,9900,0
FICYMYZC,4000,12/1/2019,9900,FICYMYZC,13900,more than downpayment,equal to downpayment,0,4000
FICYMYZC,4000,12/30/2019,9900,FICYMYZC,17900,more than downpayment,more than downpayment,0,4000
FICYMYZC,4000,2/5/2020,9900,FICYMYZC,21900,more than downpayment,more than downpayment,0,4000
FIMsBtzv,8900,2/5/2019,8900,,8900,equal to downpayment,,8900,0
FIMsBtzv,3900,3/17/2019,8900,FIMsBtzv,12800,more than downpayment,equal to downpayment,0,3900
FIMsBtzv,3900,4/26/2019,8900,FIMsBtzv,16700,more than downpayment,more than downpayment,0,3900
FIMsBtzv,3900,6/12/2019,8900,FIMsBtzv,20600,more than downpayment,more than downpayment,0,3900
FIMsBtzv,3900,6/28/2019,8900,FIMsBtzv,24500,more than downpayment,more than downpayment,0,3900
FIMsBtzv,3900,8/14/2019,8900,FIMsBtzv,28400,more than downpayment,more than downpayment,0,3900
FIMsBtzv,2000,12/12/2019,8900,FIMsBtzv,30400,more than downpayment,more than downpayment,0,2000
FIMsBtzv,3900,1/9/2020,8900,FIMsBtzv,34300,more than downpayment,more than downpayment,0,3900
FIMsBtzv,3900,1/21/2020,8900,FIMsBtzv,38200,more than downpayment,more than downpayment,0,3900
FISHK1GB,8900,2/3/2020,8900,,8900,equal to downpayment,,8900,0
fiUu42KW,10000,10/2/2017,10000,,10000,equal to downpayment,,10000,0
fiUu42KW,40000,10/13/2017,10000,fiUu42KW,50000,more than downpayment,equal to downpayment,0,40000
Fjbagcdt,10000,9/13/2017,10000,,10000,equal to downpayment,,10000,0
Fjbagcdt,10000,12/19/2017,10000,Fjbagcdt,20000,more than downpayment,equal to downpayment,0,10000
Fjbagcdt,10000,2/21/2018,10000,Fjbagcdt,30000,more than downpayment,more than downpayment,0,10000
Fjbagcdt,3500,5/4/2018,10000,Fjbagcdt,33500,more than downpayment,more than downpayment,0,3500
Fjbagcdt,3500,8/10/2018,10000,Fjbagcdt,37000,more than downpayment,more than downpayment,0,3500
Fjbagcdt,3500,10/3/2018,10000,Fjbagcdt,40500,more than downpayment,more than downpayment,0,3500
Fjbagcdt,3000,2/12/2019,10000,Fjbagcdt,43500,more than downpayment,more than downpayment,0,3000
Fjbagcdt,3000,4/8/2019,10000,Fjbagcdt,46500,more than downpayment,more than downpayment,0,3000
Fjbagcdt,3000,5/9/2019,10000,Fjbagcdt,49500,more than downpayment,more than downpayment,0,3000
Fjbagcdt,2500,5/11/2019,10000,Fjbagcdt,52000,more than downpayment,more than downpayment,0,2500
FJBZ833K,9900,12/31/2019,9900,,9900,equal to downpayment,,9900,0
FJLT1W23,9900,10/26/2019,9900,,9900,equal to downpayment,,9900,0
FJLT1W23,3900,12/25/2019,9900,FJLT1W23,13800,more than downpayment,equal to downpayment,0,3900
FJLT1W23,3900,1/25/2020,9900,FJLT1W23,17700,more than downpayment,more than downpayment,0,3900
FJRCKHDH,20000,7/23/2019,8900,,20000,more than downpayment,,8900,11100
FJRCKHDH,3900,8/20/2019,8900,FJRCKHDH,23900,more than downpayment,more than downpayment,0,3900
FJRCKHDH,3900,10/4/2019,8900,FJRCKHDH,27800,more than downpayment,more than downpayment,0,3900
FJRCKHDH,3900,11/6/2019,8900,FJRCKHDH,31700,more than downpayment,more than downpayment,0,3900
FJRCKHDH,3900,12/7/2019,8900,FJRCKHDH,35600,more than downpayment,more than downpayment,0,3900
FJRCKHDH,3900,1/9/2020,8900,FJRCKHDH,39500,more than downpayment,more than downpayment,0,3900
FJRCKHDH,3900,2/9/2020,8900,FJRCKHDH,43400,more than downpayment,more than downpayment,0,3900
FJV17ZLC,9900,9/13/2019,9900,,9900,equal to downpayment,,9900,0
FJV17ZLC,3950,11/17/2019,9900,FJV17ZLC,13850,more than downpayment,equal to downpayment,0,3950
FJV17ZLC,3900,12/3/2019,9900,FJV17ZLC,17750,more than downpayment,more than downpayment,0,3900
FJV17ZLC,3900,1/14/2020,9900,FJV17ZLC,21650,more than downpayment,more than downpayment,0,3900
FJV17ZLC,3900,2/6/2020,9900,FJV17ZLC,25550,more than downpayment,more than downpayment,0,3900
fklFQuwF,8900,5/9/2019,8900,,8900,equal to downpayment,,8900,0
fklFQuwF,3900,6/14/2019,8900,fklFQuwF,12800,more than downpayment,equal to downpayment,0,3900
fklFQuwF,3900,7/22/2019,8900,fklFQuwF,16700,more than downpayment,more than downpayment,0,3900
fklFQuwF,2000,8/30/2019,8900,fklFQuwF,18700,more than downpayment,more than downpayment,0,2000
fklFQuwF,3050,9/16/2019,8900,fklFQuwF,21750,more than downpayment,more than downpayment,0,3050
fKqhGdkT,10000,2/27/2018,10000,,10000,equal to downpayment,,10000,0
fKqhGdkT,5000,3/25/2018,10000,fKqhGdkT,15000,more than downpayment,equal to downpayment,0,5000
fKqhGdkT,5000,4/26/2018,10000,fKqhGdkT,20000,more than downpayment,more than downpayment,0,5000
fKqhGdkT,5000,5/26/2018,10000,fKqhGdkT,25000,more than downpayment,more than downpayment,0,5000
fKqhGdkT,5000,6/25/2018,10000,fKqhGdkT,30000,more than downpayment,more than downpayment,0,5000
fKqhGdkT,5000,7/26/2018,10000,fKqhGdkT,35000,more than downpayment,more than downpayment,0,5000
fKqhGdkT,3500,10/17/2018,10000,fKqhGdkT,38500,more than downpayment,more than downpayment,0,3500
fKqhGdkT,3500,10/27/2018,10000,fKqhGdkT,42000,more than downpayment,more than downpayment,0,3500
fKqhGdkT,4500,11/29/2018,10000,fKqhGdkT,46500,more than downpayment,more than downpayment,0,4500
fKqhGdkT,2000,1/17/2019,10000,fKqhGdkT,48500,more than downpayment,more than downpayment,0,2000
fKqhGdkT,2000,3/7/2019,10000,fKqhGdkT,50500,more than downpayment,more than downpayment,0,2000
fKqhGdkT,4000,3/25/2019,10000,fKqhGdkT,54500,more than downpayment,more than downpayment,0,4000
fKqhGdkT,3000,4/12/2019,10000,fKqhGdkT,57500,more than downpayment,more than downpayment,0,3000
fKqhGdkT,2000,5/20/2019,10000,fKqhGdkT,59500,more than downpayment,more than downpayment,0,2000
fKqhGdkT,2000,6/18/2019,10000,fKqhGdkT,61500,more than downpayment,more than downpayment,0,2000
fKqhGdkT,1000,8/9/2019,10000,fKqhGdkT,62500,more than downpayment,more than downpayment,0,1000
fKqhGdkT,1500,10/1/2019,10000,fKqhGdkT,64000,more than downpayment,more than downpayment,0,1500
fLbcqu3G,11900,8/13/2019,9900,,11900,more than downpayment,,9900,2000
fLbcqu3G,4000,9/4/2019,9900,fLbcqu3G,15900,more than downpayment,more than downpayment,0,4000
fLbcqu3G,4000,10/5/2019,9900,fLbcqu3G,19900,more than downpayment,more than downpayment,0,4000
fLbcqu3G,4000,11/9/2019,9900,fLbcqu3G,23900,more than downpayment,more than downpayment,0,4000
fLbcqu3G,4000,12/11/2019,9900,fLbcqu3G,27900,more than downpayment,more than downpayment,0,4000
fLbcqu3G,4000,1/7/2020,9900,fLbcqu3G,31900,more than downpayment,more than downpayment,0,4000
fLbcqu3G,4000,2/8/2020,9900,fLbcqu3G,35900,more than downpayment,more than downpayment,0,4000
flhMvmCq,9900,11/28/2018,9900,,9900,equal to downpayment,,9900,0
flhMvmCq,4500,2/1/2019,9900,flhMvmCq,14400,more than downpayment,equal to downpayment,0,4500
flhMvmCq,4500,2/25/2019,9900,flhMvmCq,18900,more than downpayment,more than downpayment,0,4500
flhMvmCq,4500,3/26/2019,9900,flhMvmCq,23400,more than downpayment,more than downpayment,0,4500
flhMvmCq,4500,5/10/2019,9900,flhMvmCq,27900,more than downpayment,more than downpayment,0,4500
flhMvmCq,4500,6/3/2019,9900,flhMvmCq,32400,more than downpayment,more than downpayment,0,4500
flhMvmCq,9000,7/16/2019,9900,flhMvmCq,41400,more than downpayment,more than downpayment,0,9000
flhMvmCq,6000,9/17/2019,9900,flhMvmCq,47400,more than downpayment,more than downpayment,0,6000
flhMvmCq,5000,11/28/2019,9900,flhMvmCq,52400,more than downpayment,more than downpayment,0,5000
flhMvmCq,5500,12/16/2019,9900,flhMvmCq,57900,more than downpayment,more than downpayment,0,5500
flhMvmCq,3000,1/15/2020,9900,flhMvmCq,60900,more than downpayment,more than downpayment,0,3000
FM87BSOT,20000,11/7/2019,9900,,20000,more than downpayment,,9900,10100
FM87BSOT,2000,12/19/2019,9900,FM87BSOT,22000,more than downpayment,more than downpayment,0,2000
FMMP48PS,4000,11/8/2019,9900,,4000,less than downpayment,,4000,0
FMMP48PS,5900,11/12/2019,9900,FMMP48PS,9900,equal to downpayment,less than downpayment,5900,0
FMMP48PS,3900,12/26/2019,9900,FMMP48PS,13800,more than downpayment,equal to downpayment,0,3900
FMMP48PS,3900,1/25/2020,9900,FMMP48PS,17700,more than downpayment,more than downpayment,0,3900
Fn2y8PW6,10000,1/21/2019,9900,,10000,more than downpayment,,9900,100
Fn2y8PW6,52000,3/20/2019,9900,Fn2y8PW6,62000,more than downpayment,more than downpayment,0,52000
fNfvtL5V,8900,11/26/2018,8900,,8900,equal to downpayment,,8900,0
fNfvtL5V,3900,12/25/2018,8900,fNfvtL5V,12800,more than downpayment,equal to downpayment,0,3900
fNfvtL5V,4000,1/24/2019,8900,fNfvtL5V,16800,more than downpayment,more than downpayment,0,4000
fNfvtL5V,4000,2/25/2019,8900,fNfvtL5V,20800,more than downpayment,more than downpayment,0,4000
fNfvtL5V,4000,3/24/2019,8900,fNfvtL5V,24800,more than downpayment,more than downpayment,0,4000
fNfvtL5V,3900,4/24/2019,8900,fNfvtL5V,28700,more than downpayment,more than downpayment,0,3900
fNfvtL5V,3900,5/27/2019,8900,fNfvtL5V,32600,more than downpayment,more than downpayment,0,3900
fNfvtL5V,4000,6/26/2019,8900,fNfvtL5V,36600,more than downpayment,more than downpayment,0,4000
fNfvtL5V,4000,7/26/2019,8900,fNfvtL5V,40600,more than downpayment,more than downpayment,0,4000
fNfvtL5V,3900,8/26/2019,8900,fNfvtL5V,44500,more than downpayment,more than downpayment,0,3900
fNfvtL5V,3900,9/30/2019,8900,fNfvtL5V,48400,more than downpayment,more than downpayment,0,3900
fNfvtL5V,3900,11/4/2019,8900,fNfvtL5V,52300,more than downpayment,more than downpayment,0,3900
FNQ36MT2,9900,2/8/2020,9900,,9900,equal to downpayment,,9900,0
FnzjNjcN,9000,4/29/2019,8900,,9000,more than downpayment,,8900,100
FnzjNjcN,5000,6/2/2019,8900,FnzjNjcN,14000,more than downpayment,more than downpayment,0,5000
FnzjNjcN,4000,7/1/2019,8900,FnzjNjcN,18000,more than downpayment,more than downpayment,0,4000
FnzjNjcN,4000,8/5/2019,8900,FnzjNjcN,22000,more than downpayment,more than downpayment,0,4000
FnzjNjcN,4000,9/3/2019,8900,FnzjNjcN,26000,more than downpayment,more than downpayment,0,4000
FnzjNjcN,4000,10/2/2019,8900,FnzjNjcN,30000,more than downpayment,more than downpayment,0,4000
FnzjNjcN,3900,11/5/2019,8900,FnzjNjcN,33900,more than downpayment,more than downpayment,0,3900
FnzjNjcN,3900,12/4/2019,8900,FnzjNjcN,37800,more than downpayment,more than downpayment,0,3900
FnzjNjcN,3900,1/2/2020,8900,FnzjNjcN,41700,more than downpayment,more than downpayment,0,3900
FnzjNjcN,3900,2/4/2020,8900,FnzjNjcN,45600,more than downpayment,more than downpayment,0,3900
fO4qNkVB,10000,8/28/2017,10000,,10000,equal to downpayment,,10000,0
fO4qNkVB,3500,10/3/2017,10000,fO4qNkVB,13500,more than downpayment,equal to downpayment,0,3500
fO4qNkVB,3500,11/3/2017,10000,fO4qNkVB,17000,more than downpayment,more than downpayment,0,3500
fO4qNkVB,2000,1/31/2018,10000,fO4qNkVB,19000,more than downpayment,more than downpayment,0,2000
fO4qNkVB,3000,2/26/2018,10000,fO4qNkVB,22000,more than downpayment,more than downpayment,0,3000
fO4qNkVB,2000,4/4/2018,10000,fO4qNkVB,24000,more than downpayment,more than downpayment,0,2000
fO4qNkVB,2000,4/30/2018,10000,fO4qNkVB,26000,more than downpayment,more than downpayment,0,2000
fO4qNkVB,2000,6/4/2018,10000,fO4qNkVB,28000,more than downpayment,more than downpayment,0,2000
fO4qNkVB,2000,6/30/2018,10000,fO4qNkVB,30000,more than downpayment,more than downpayment,0,2000
fO4qNkVB,2000,8/6/2018,10000,fO4qNkVB,32000,more than downpayment,more than downpayment,0,2000
fO4qNkVB,2000,9/10/2018,10000,fO4qNkVB,34000,more than downpayment,more than downpayment,0,2000
fO4qNkVB,2000,11/2/2018,10000,fO4qNkVB,36000,more than downpayment,more than downpayment,0,2000
fO4qNkVB,2000,1/7/2019,10000,fO4qNkVB,38000,more than downpayment,more than downpayment,0,2000
fO4qNkVB,2000,2/5/2019,10000,fO4qNkVB,40000,more than downpayment,more than downpayment,0,2000
fO4qNkVB,2917,3/6/2019,10000,fO4qNkVB,42917,more than downpayment,more than downpayment,0,2917
fO4qNkVB,2087,5/8/2019,10000,fO4qNkVB,45004,more than downpayment,more than downpayment,0,2087
fO4qNkVB,2000,8/6/2019,10000,fO4qNkVB,47004,more than downpayment,more than downpayment,0,2000
FPQD1IR1,9900,8/26/2019,9900,,9900,equal to downpayment,,9900,0
FPQD1IR1,2000,12/5/2019,9900,FPQD1IR1,11900,more than downpayment,equal to downpayment,0,2000
FPQD1IR1,10000,12/11/2019,9900,FPQD1IR1,21900,more than downpayment,more than downpayment,0,10000
FPQD1IR1,3600,1/17/2020,9900,FPQD1IR1,25500,more than downpayment,more than downpayment,0,3600
FQBVUR42,9900,10/20/2019,9900,,9900,equal to downpayment,,9900,0
FQBVUR42,3950,1/24/2020,9900,FQBVUR42,13850,more than downpayment,equal to downpayment,0,3950
FQHBBLA5,9900,10/21/2019,9900,,9900,equal to downpayment,,9900,0
FQHBBLA5,3900,12/5/2019,9900,FQHBBLA5,13800,more than downpayment,equal to downpayment,0,3900
FQHBBLA5,3900,1/4/2020,9900,FQHBBLA5,17700,more than downpayment,more than downpayment,0,3900
FQHBBLA5,3900,2/5/2020,9900,FQHBBLA5,21600,more than downpayment,more than downpayment,0,3900
FQKROQ4Z,9900,11/30/2019,9900,,9900,equal to downpayment,,9900,0
FQKROQ4Z,3900,2/1/2020,9900,FQKROQ4Z,13800,more than downpayment,equal to downpayment,0,3900
fqpQhJLR,10000,12/6/2018,9900,,10000,more than downpayment,,9900,100
fqpQhJLR,5000,1/29/2019,9900,fqpQhJLR,15000,more than downpayment,more than downpayment,0,5000
fqpQhJLR,4000,3/6/2019,9900,fqpQhJLR,19000,more than downpayment,more than downpayment,0,4000
fqpQhJLR,4500,4/4/2019,9900,fqpQhJLR,23500,more than downpayment,more than downpayment,0,4500
fqpQhJLR,4500,5/7/2019,9900,fqpQhJLR,28000,more than downpayment,more than downpayment,0,4500
fqpQhJLR,4500,6/6/2019,9900,fqpQhJLR,32500,more than downpayment,more than downpayment,0,4500
fqpQhJLR,4500,7/9/2019,9900,fqpQhJLR,37000,more than downpayment,more than downpayment,0,4500
fqpQhJLR,9000,8/21/2019,9900,fqpQhJLR,46000,more than downpayment,more than downpayment,0,9000
fqpQhJLR,4500,10/14/2019,9900,fqpQhJLR,50500,more than downpayment,more than downpayment,0,4500
fqpQhJLR,4500,11/11/2019,9900,fqpQhJLR,55000,more than downpayment,more than downpayment,0,4500
fqpQhJLR,22400,1/4/2020,9900,fqpQhJLR,77400,more than downpayment,more than downpayment,0,22400
frBGwO6h,9900,6/11/2019,8900,,9900,more than downpayment,,8900,1000
frBGwO6h,5000,7/14/2019,8900,frBGwO6h,14900,more than downpayment,more than downpayment,0,5000
frBGwO6h,5000,8/19/2019,8900,frBGwO6h,19900,more than downpayment,more than downpayment,0,5000
frBGwO6h,5000,9/22/2019,8900,frBGwO6h,24900,more than downpayment,more than downpayment,0,5000
frBGwO6h,5000,10/23/2019,8900,frBGwO6h,29900,more than downpayment,more than downpayment,0,5000
frBGwO6h,5000,11/23/2019,8900,frBGwO6h,34900,more than downpayment,more than downpayment,0,5000
frBGwO6h,5000,12/20/2019,8900,frBGwO6h,39900,more than downpayment,more than downpayment,0,5000
frBGwO6h,5000,1/24/2020,8900,frBGwO6h,44900,more than downpayment,more than downpayment,0,5000
FS2P3Q3S,9900,9/11/2019,9900,,9900,equal to downpayment,,9900,0
FS2P3Q3S,3900,12/11/2019,9900,FS2P3Q3S,13800,more than downpayment,equal to downpayment,0,3900
FS2P3Q3S,3900,1/11/2020,9900,FS2P3Q3S,17700,more than downpayment,more than downpayment,0,3900
FSEKv7op,9900,7/15/2019,9900,,9900,equal to downpayment,,9900,0
FSEKv7op,40000,8/16/2019,9900,FSEKv7op,49900,more than downpayment,equal to downpayment,0,40000
FSEKv7op,11700,1/27/2020,9900,FSEKv7op,61600,more than downpayment,more than downpayment,0,11700
fSGAGu2X,9000,4/9/2019,8900,,9000,more than downpayment,,8900,100
fSGAGu2X,5000,5/7/2019,8900,fSGAGu2X,14000,more than downpayment,more than downpayment,0,5000
fSGAGu2X,5000,5/20/2019,8900,fSGAGu2X,19000,more than downpayment,more than downpayment,0,5000
fSGAGu2X,3900,6/25/2019,8900,fSGAGu2X,22900,more than downpayment,more than downpayment,0,3900
fSGAGu2X,650,6/26/2019,8900,fSGAGu2X,23550,more than downpayment,more than downpayment,0,650
fSGAGu2X,950,7/7/2019,8900,fSGAGu2X,24500,more than downpayment,more than downpayment,0,950
fSGAGu2X,1100,7/18/2019,8900,fSGAGu2X,25600,more than downpayment,more than downpayment,0,1100
fSGAGu2X,500,7/22/2019,8900,fSGAGu2X,26100,more than downpayment,more than downpayment,0,500
fSGAGu2X,950,7/24/2019,8900,fSGAGu2X,27050,more than downpayment,more than downpayment,0,950
fSGAGu2X,400,7/25/2019,8900,fSGAGu2X,27450,more than downpayment,more than downpayment,0,400
fSGAGu2X,750,8/6/2019,8900,fSGAGu2X,28200,more than downpayment,more than downpayment,0,750
fSGAGu2X,2350,9/12/2019,8900,fSGAGu2X,30550,more than downpayment,more than downpayment,0,2350
fSGAGu2X,1700,9/25/2019,8900,fSGAGu2X,32250,more than downpayment,more than downpayment,0,1700
fSGAGu2X,4000,10/26/2019,8900,fSGAGu2X,36250,more than downpayment,more than downpayment,0,4000
fSGAGu2X,4000,11/25/2019,8900,fSGAGu2X,40250,more than downpayment,more than downpayment,0,4000
fSGAGu2X,3900,12/26/2019,8900,fSGAGu2X,44150,more than downpayment,more than downpayment,0,3900
fSGAGu2X,3999,1/24/2020,8900,fSGAGu2X,48149,more than downpayment,more than downpayment,0,3999
FSQq7ow4,10000,12/2/2017,10000,,10000,equal to downpayment,,10000,0
FSQq7ow4,4500,1/21/2018,10000,FSQq7ow4,14500,more than downpayment,equal to downpayment,0,4500
FSQq7ow4,4500,2/22/2018,10000,FSQq7ow4,19000,more than downpayment,more than downpayment,0,4500
FSQq7ow4,2250,3/19/2018,10000,FSQq7ow4,21250,more than downpayment,more than downpayment,0,2250
FSQq7ow4,2250,4/5/2018,10000,FSQq7ow4,23500,more than downpayment,more than downpayment,0,2250
FSQq7ow4,1400,5/26/2018,10000,FSQq7ow4,24900,more than downpayment,more than downpayment,0,1400
FSQq7ow4,3900,5/29/2018,10000,FSQq7ow4,28800,more than downpayment,more than downpayment,0,3900
FSQq7ow4,3700,6/13/2018,10000,FSQq7ow4,32500,more than downpayment,more than downpayment,0,3700
FSQq7ow4,4500,7/11/2018,10000,FSQq7ow4,37000,more than downpayment,more than downpayment,0,4500
FSQq7ow4,4500,8/21/2018,10000,FSQq7ow4,41500,more than downpayment,more than downpayment,0,4500
FSQq7ow4,4500,9/21/2018,10000,FSQq7ow4,46000,more than downpayment,more than downpayment,0,4500
FSQq7ow4,4500,10/23/2018,10000,FSQq7ow4,50500,more than downpayment,more than downpayment,0,4500
FSQq7ow4,4500,12/24/2018,10000,FSQq7ow4,55000,more than downpayment,more than downpayment,0,4500
FSQq7ow4,2500,1/21/2019,10000,FSQq7ow4,57500,more than downpayment,more than downpayment,0,2500
FSQq7ow4,2500,2/24/2019,10000,FSQq7ow4,60000,more than downpayment,more than downpayment,0,2500
FSQq7ow4,250,5/21/2019,10000,FSQq7ow4,60250,more than downpayment,more than downpayment,0,250
FSQq7ow4,1650,5/24/2019,10000,FSQq7ow4,61900,more than downpayment,more than downpayment,0,1650
FSQq7ow4,600,6/3/2019,10000,FSQq7ow4,62500,more than downpayment,more than downpayment,0,600
FSQq7ow4,500,6/7/2019,10000,FSQq7ow4,63000,more than downpayment,more than downpayment,0,500
FSQq7ow4,500,6/21/2019,10000,FSQq7ow4,63500,more than downpayment,more than downpayment,0,500
FSQq7ow4,500,7/25/2019,10000,FSQq7ow4,64000,more than downpayment,more than downpayment,0,500
FSX31XQY,9900,11/18/2019,9900,,9900,equal to downpayment,,9900,0
FSX31XQY,3900,1/23/2020,9900,FSX31XQY,13800,more than downpayment,equal to downpayment,0,3900
FT5sOxO5,9900,7/29/2019,9900,,9900,equal to downpayment,,9900,0
FT5sOxO5,3900,9/3/2019,9900,FT5sOxO5,13800,more than downpayment,equal to downpayment,0,3900
FT5sOxO5,3900,10/5/2019,9900,FT5sOxO5,17700,more than downpayment,more than downpayment,0,3900
FT5sOxO5,3900,11/5/2019,9900,FT5sOxO5,21600,more than downpayment,more than downpayment,0,3900
FT5sOxO5,3900,12/5/2019,9900,FT5sOxO5,25500,more than downpayment,more than downpayment,0,3900
FT5sOxO5,3900,2/8/2020,9900,FT5sOxO5,29400,more than downpayment,more than downpayment,0,3900
FTLl84eI,8900,7/1/2019,9900,,8900,less than downpayment,,8900,0
FTLl84eI,1000,7/2/2019,9900,FTLl84eI,9900,equal to downpayment,less than downpayment,1000,0
FTLl84eI,3900,8/9/2019,9900,FTLl84eI,13800,more than downpayment,equal to downpayment,0,3900
FTLl84eI,3900,9/11/2019,9900,FTLl84eI,17700,more than downpayment,more than downpayment,0,3900
FTLl84eI,3900,10/11/2019,9900,FTLl84eI,21600,more than downpayment,more than downpayment,0,3900
FTLl84eI,3900,12/9/2019,9900,FTLl84eI,25500,more than downpayment,more than downpayment,0,3900
FTLl84eI,3900,12/20/2019,9900,FTLl84eI,29400,more than downpayment,more than downpayment,0,3900
FTLl84eI,3900,1/23/2020,9900,FTLl84eI,33300,more than downpayment,more than downpayment,0,3900
FTt9lrce,8900,4/17/2019,8900,,8900,equal to downpayment,,8900,0
FTt9lrce,3900,5/12/2019,8900,FTt9lrce,12800,more than downpayment,equal to downpayment,0,3900
FTt9lrce,3900,6/12/2019,8900,FTt9lrce,16700,more than downpayment,more than downpayment,0,3900
FTt9lrce,3900,7/26/2019,8900,FTt9lrce,20600,more than downpayment,more than downpayment,0,3900
FTt9lrce,3900,8/29/2019,8900,FTt9lrce,24500,more than downpayment,more than downpayment,0,3900
FTt9lrce,3900,9/25/2019,8900,FTt9lrce,28400,more than downpayment,more than downpayment,0,3900
FTt9lrce,3900,10/23/2019,8900,FTt9lrce,32300,more than downpayment,more than downpayment,0,3900
FTt9lrce,3900,11/24/2019,8900,FTt9lrce,36200,more than downpayment,more than downpayment,0,3900
FTt9lrce,3900,12/26/2019,8900,FTt9lrce,40100,more than downpayment,more than downpayment,0,3900
FTt9lrce,3900,1/25/2020,8900,FTt9lrce,44000,more than downpayment,more than downpayment,0,3900
FV1WDK3L,8900,1/18/2020,8900,,8900,equal to downpayment,,8900,0
FVIO6518,10000,6/10/2019,8900,,10000,more than downpayment,,8900,1100
FVIO6518,8000,7/23/2019,8900,FVIO6518,18000,more than downpayment,more than downpayment,0,8000
FVIO6518,5000,8/26/2019,8900,FVIO6518,23000,more than downpayment,more than downpayment,0,5000
FVIO6518,5000,9/25/2019,8900,FVIO6518,28000,more than downpayment,more than downpayment,0,5000
FVIO6518,5000,10/28/2019,8900,FVIO6518,33000,more than downpayment,more than downpayment,0,5000
FVIO6518,4000,11/29/2019,8900,FVIO6518,37000,more than downpayment,more than downpayment,0,4000
FVIO6518,4000,12/29/2019,8900,FVIO6518,41000,more than downpayment,more than downpayment,0,4000
FVIO6518,4000,1/25/2020,8900,FVIO6518,45000,more than downpayment,more than downpayment,0,4000
FVMLTO84,9900,12/30/2019,9900,,9900,equal to downpayment,,9900,0
FxbTAchR,8900,3/18/2019,8900,,8900,equal to downpayment,,8900,0
FxbTAchR,3900,5/9/2019,8900,FxbTAchR,12800,more than downpayment,equal to downpayment,0,3900
FxbTAchR,3900,6/10/2019,8900,FxbTAchR,16700,more than downpayment,more than downpayment,0,3900
FxbTAchR,3900,7/25/2019,8900,FxbTAchR,20600,more than downpayment,more than downpayment,0,3900
FxbTAchR,3900,8/20/2019,8900,FxbTAchR,24500,more than downpayment,more than downpayment,0,3900
FxbTAchR,3900,9/19/2019,8900,FxbTAchR,28400,more than downpayment,more than downpayment,0,3900
FxbTAchR,3900,10/12/2019,8900,FxbTAchR,32300,more than downpayment,more than downpayment,0,3900
FxbTAchR,3900,11/11/2019,8900,FxbTAchR,36200,more than downpayment,more than downpayment,0,3900
FxbTAchR,2000,1/20/2020,8900,FxbTAchR,38200,more than downpayment,more than downpayment,0,2000
fY4qkvqz,9900,6/25/2019,9900,,9900,equal to downpayment,,9900,0
fY4qkvqz,7800,9/11/2019,9900,fY4qkvqz,17700,more than downpayment,equal to downpayment,0,7800
fY4qkvqz,3900,10/4/2019,9900,fY4qkvqz,21600,more than downpayment,more than downpayment,0,3900
fY4qkvqz,3900,11/9/2019,9900,fY4qkvqz,25500,more than downpayment,more than downpayment,0,3900
fY4qkvqz,3900,1/3/2020,9900,fY4qkvqz,29400,more than downpayment,more than downpayment,0,3900
FY5ZPU3R,8900,9/13/2019,8900,,8900,equal to downpayment,,8900,0
FY5ZPU3R,5000,11/8/2019,8900,FY5ZPU3R,13900,more than downpayment,equal to downpayment,0,5000
FY5ZPU3R,5000,12/13/2019,8900,FY5ZPU3R,18900,more than downpayment,more than downpayment,0,5000
FY5ZPU3R,5000,1/7/2020,8900,FY5ZPU3R,23900,more than downpayment,more than downpayment,0,5000
fYdQXcGP,8900,2/18/2019,8900,,8900,equal to downpayment,,8900,0
fYdQXcGP,5000,4/3/2019,8900,fYdQXcGP,13900,more than downpayment,equal to downpayment,0,5000
fYdQXcGP,6000,5/8/2019,8900,fYdQXcGP,19900,more than downpayment,more than downpayment,0,6000
fYdQXcGP,4000,6/4/2019,8900,fYdQXcGP,23900,more than downpayment,more than downpayment,0,4000
fYdQXcGP,4000,7/4/2019,8900,fYdQXcGP,27900,more than downpayment,more than downpayment,0,4000
fYdQXcGP,4000,8/7/2019,8900,fYdQXcGP,31900,more than downpayment,more than downpayment,0,4000
fYdQXcGP,3900,9/11/2019,8900,fYdQXcGP,35800,more than downpayment,more than downpayment,0,3900
fYdQXcGP,4000,10/19/2019,8900,fYdQXcGP,39800,more than downpayment,more than downpayment,0,4000
fYdQXcGP,4200,12/12/2019,8900,fYdQXcGP,44000,more than downpayment,more than downpayment,0,4200
fYdQXcGP,4500,2/9/2020,8900,fYdQXcGP,48500,more than downpayment,more than downpayment,0,4500
Fz8syNNg,20000,12/11/2018,10000,,20000,more than downpayment,,10000,10000
Fz8syNNg,2000,4/9/2019,10000,Fz8syNNg,22000,more than downpayment,more than downpayment,0,2000
FZhsVbT9,8900,4/23/2019,8900,,8900,equal to downpayment,,8900,0
FZhsVbT9,3900,6/5/2019,8900,FZhsVbT9,12800,more than downpayment,equal to downpayment,0,3900
FZhsVbT9,3900,7/4/2019,8900,FZhsVbT9,16700,more than downpayment,more than downpayment,0,3900
FZhsVbT9,3900,8/5/2019,8900,FZhsVbT9,20600,more than downpayment,more than downpayment,0,3900
FZhsVbT9,3900,9/5/2019,8900,FZhsVbT9,24500,more than downpayment,more than downpayment,0,3900
FZhsVbT9,3900,10/7/2019,8900,FZhsVbT9,28400,more than downpayment,more than downpayment,0,3900
FZhsVbT9,3900,11/4/2019,8900,FZhsVbT9,32300,more than downpayment,more than downpayment,0,3900
FZhsVbT9,3900,12/5/2019,8900,FZhsVbT9,36200,more than downpayment,more than downpayment,0,3900
FZhsVbT9,3900,1/6/2020,8900,FZhsVbT9,40100,more than downpayment,more than downpayment,0,3900
FZhsVbT9,3900,2/5/2020,8900,FZhsVbT9,44000,more than downpayment,more than downpayment,0,3900
fzxf4ro6,8900,4/18/2019,8900,,8900,equal to downpayment,,8900,0
fzxf4ro6,3900,6/2/2019,8900,fzxf4ro6,12800,more than downpayment,equal to downpayment,0,3900
fzxf4ro6,3900,7/3/2019,8900,fzxf4ro6,16700,more than downpayment,more than downpayment,0,3900
fzxf4ro6,3900,8/3/2019,8900,fzxf4ro6,20600,more than downpayment,more than downpayment,0,3900
fzxf4ro6,3900,9/4/2019,8900,fzxf4ro6,24500,more than downpayment,more than downpayment,0,3900
fzxf4ro6,3900,10/10/2019,8900,fzxf4ro6,28400,more than downpayment,more than downpayment,0,3900
fzxf4ro6,3900,11/5/2019,8900,fzxf4ro6,32300,more than downpayment,more than downpayment,0,3900
fzxf4ro6,3900,12/9/2019,8900,fzxf4ro6,36200,more than downpayment,more than downpayment,0,3900
fzxf4ro6,3900,1/2/2020,8900,fzxf4ro6,40100,more than downpayment,more than downpayment,0,3900
fzxf4ro6,3900,2/6/2020,8900,fzxf4ro6,44000,more than downpayment,more than downpayment,0,3900
G0O1Y9eO,8900,4/17/2019,8900,,8900,equal to downpayment,,8900,0
G0O1Y9eO,3900,5/13/2019,8900,G0O1Y9eO,12800,more than downpayment,equal to downpayment,0,3900
G0O1Y9eO,3900,6/23/2019,8900,G0O1Y9eO,16700,more than downpayment,more than downpayment,0,3900
G0O1Y9eO,3900,7/19/2019,8900,G0O1Y9eO,20600,more than downpayment,more than downpayment,0,3900
G0O1Y9eO,3900,8/23/2019,8900,G0O1Y9eO,24500,more than downpayment,more than downpayment,0,3900
G0O1Y9eO,3900,9/23/2019,8900,G0O1Y9eO,28400,more than downpayment,more than downpayment,0,3900
G0O1Y9eO,3900,10/24/2019,8900,G0O1Y9eO,32300,more than downpayment,more than downpayment,0,3900
G0O1Y9eO,3900,11/23/2019,8900,G0O1Y9eO,36200,more than downpayment,more than downpayment,0,3900
G0O1Y9eO,3900,12/30/2019,8900,G0O1Y9eO,40100,more than downpayment,more than downpayment,0,3900
G0O1Y9eO,3900,1/27/2020,8900,G0O1Y9eO,44000,more than downpayment,more than downpayment,0,3900
G0V6rgOU,25000,8/25/2017,10000,,25000,more than downpayment,,10000,15000
G0V6rgOU,20000,9/13/2017,10000,G0V6rgOU,45000,more than downpayment,more than downpayment,0,20000
G15AUI5I,9900,12/9/2019,9900,,9900,equal to downpayment,,9900,0
g1ezUI2G,8900,7/31/2019,8900,,8900,equal to downpayment,,8900,0
g1ezUI2G,3900,9/3/2019,8900,g1ezUI2G,12800,more than downpayment,equal to downpayment,0,3900
g1ezUI2G,3900,10/2/2019,8900,g1ezUI2G,16700,more than downpayment,more than downpayment,0,3900
g1ezUI2G,3900,11/4/2019,8900,g1ezUI2G,20600,more than downpayment,more than downpayment,0,3900
g1ezUI2G,3900,12/5/2019,8900,g1ezUI2G,24500,more than downpayment,more than downpayment,0,3900
g1ezUI2G,3900,1/6/2020,8900,g1ezUI2G,28400,more than downpayment,more than downpayment,0,3900
g1XCktde,10500,8/21/2017,10000,,10500,more than downpayment,,10000,500
g1XCktde,3000,9/26/2017,10000,g1XCktde,13500,more than downpayment,more than downpayment,0,3000
g1XCktde,3000,10/31/2017,10000,g1XCktde,16500,more than downpayment,more than downpayment,0,3000
g1XCktde,3000,12/14/2017,10000,g1XCktde,19500,more than downpayment,more than downpayment,0,3000
g1XCktde,3000,1/26/2018,10000,g1XCktde,22500,more than downpayment,more than downpayment,0,3000
g1XCktde,3000,2/25/2018,10000,g1XCktde,25500,more than downpayment,more than downpayment,0,3000
g1XCktde,3000,3/26/2018,10000,g1XCktde,28500,more than downpayment,more than downpayment,0,3000
g1XCktde,3000,5/10/2018,10000,g1XCktde,31500,more than downpayment,more than downpayment,0,3000
g1XCktde,3000,5/26/2018,10000,g1XCktde,34500,more than downpayment,more than downpayment,0,3000
g1XCktde,3000,6/24/2018,10000,g1XCktde,37500,more than downpayment,more than downpayment,0,3000
g1XCktde,3000,7/30/2018,10000,g1XCktde,40500,more than downpayment,more than downpayment,0,3000
g1XCktde,3000,8/25/2018,10000,g1XCktde,43500,more than downpayment,more than downpayment,0,3000
g1XCktde,2000,9/23/2018,10000,g1XCktde,45500,more than downpayment,more than downpayment,0,2000
g1XCktde,2000,10/22/2018,10000,g1XCktde,47500,more than downpayment,more than downpayment,0,2000
g1XCktde,1500,12/22/2018,10000,g1XCktde,49000,more than downpayment,more than downpayment,0,1500
g1XCktde,1000,2/4/2019,10000,g1XCktde,50000,more than downpayment,more than downpayment,0,1000
g2COozaK,2500,8/6/2019,8900,,2500,less than downpayment,,2500,0
g2COozaK,9900,8/16/2019,8900,g2COozaK,12400,more than downpayment,less than downpayment,6400,3500
g2COozaK,3900,9/30/2019,8900,g2COozaK,16300,more than downpayment,more than downpayment,0,3900
g2COozaK,3900,11/4/2019,8900,g2COozaK,20200,more than downpayment,more than downpayment,0,3900
g2COozaK,3900,12/2/2019,8900,g2COozaK,24100,more than downpayment,more than downpayment,0,3900
g2COozaK,3900,1/4/2020,8900,g2COozaK,28000,more than downpayment,more than downpayment,0,3900
g2COozaK,3900,2/6/2020,8900,g2COozaK,31900,more than downpayment,more than downpayment,0,3900
g2Taa1jN,8900,2/14/2019,8900,,8900,equal to downpayment,,8900,0
g2Taa1jN,3900,3/22/2019,8900,g2Taa1jN,12800,more than downpayment,equal to downpayment,0,3900
g2Taa1jN,3900,4/24/2019,8900,g2Taa1jN,16700,more than downpayment,more than downpayment,0,3900
g3NgkUy7,8900,7/19/2019,8900,,8900,equal to downpayment,,8900,0
g3NgkUy7,8900,8/27/2019,8900,g3NgkUy7,17800,more than downpayment,equal to downpayment,0,8900
g3NgkUy7,7800,11/28/2019,8900,g3NgkUy7,25600,more than downpayment,more than downpayment,0,7800
g3NgkUy7,3900,1/24/2020,8900,g3NgkUy7,29500,more than downpayment,more than downpayment,0,3900
g3XngnSC,10000,1/8/2019,10000,,10000,equal to downpayment,,10000,0
g3XngnSC,3900,2/15/2019,10000,g3XngnSC,13900,more than downpayment,equal to downpayment,0,3900
g3XngnSC,1650,3/16/2019,10000,g3XngnSC,15550,more than downpayment,more than downpayment,0,1650
g3XngnSC,2350,3/20/2019,10000,g3XngnSC,17900,more than downpayment,more than downpayment,0,2350
g3XngnSC,1100,4/5/2019,10000,g3XngnSC,19000,more than downpayment,more than downpayment,0,1100
g3XngnSC,1000,5/6/2019,10000,g3XngnSC,20000,more than downpayment,more than downpayment,0,1000
g3XngnSC,500,5/7/2019,10000,g3XngnSC,20500,more than downpayment,more than downpayment,0,500
g3XngnSC,500,5/8/2019,10000,g3XngnSC,21000,more than downpayment,more than downpayment,0,500
g3XngnSC,500,5/9/2019,10000,g3XngnSC,21500,more than downpayment,more than downpayment,0,500
g3XngnSC,500,5/10/2019,10000,g3XngnSC,22000,more than downpayment,more than downpayment,0,500
g3XngnSC,500,5/11/2019,10000,g3XngnSC,22500,more than downpayment,more than downpayment,0,500
g3XngnSC,2000,5/12/2019,10000,g3XngnSC,24500,more than downpayment,more than downpayment,0,2000
g3XngnSC,3050,5/15/2019,10000,g3XngnSC,27550,more than downpayment,more than downpayment,0,3050
g3XngnSC,450,5/16/2019,10000,g3XngnSC,28000,more than downpayment,more than downpayment,0,450
g3XngnSC,4500,6/25/2019,10000,g3XngnSC,32500,more than downpayment,more than downpayment,0,4500
g3XngnSC,4550,8/4/2019,10000,g3XngnSC,37050,more than downpayment,more than downpayment,0,4550
g3XngnSC,1000,9/6/2019,10000,g3XngnSC,38050,more than downpayment,more than downpayment,0,1000
g3XngnSC,8000,9/10/2019,10000,g3XngnSC,46050,more than downpayment,more than downpayment,0,8000
g3XngnSC,4500,12/12/2019,10000,g3XngnSC,50550,more than downpayment,more than downpayment,0,4500
g3XngnSC,1000,1/17/2020,10000,g3XngnSC,51550,more than downpayment,more than downpayment,0,1000
g3XngnSC,500,1/18/2020,10000,g3XngnSC,52050,more than downpayment,more than downpayment,0,500
g3XngnSC,1000,1/21/2020,10000,g3XngnSC,53050,more than downpayment,more than downpayment,0,1000
g3XngnSC,500,1/29/2020,10000,g3XngnSC,53550,more than downpayment,more than downpayment,0,500
G4QV2KCR,9900,11/15/2019,9900,,9900,equal to downpayment,,9900,0
G4QV2KCR,3900,1/15/2020,9900,G4QV2KCR,13800,more than downpayment,equal to downpayment,0,3900
G5StGV9e,7500,9/8/2017,10000,,7500,less than downpayment,,7500,0
G5StGV9e,3000,9/14/2017,10000,G5StGV9e,10500,more than downpayment,less than downpayment,2500,500
G5StGV9e,3500,11/2/2017,10000,G5StGV9e,14000,more than downpayment,more than downpayment,0,3500
G5StGV9e,3500,12/10/2017,10000,G5StGV9e,17500,more than downpayment,more than downpayment,0,3500
G5StGV9e,1000,2/2/2018,10000,G5StGV9e,18500,more than downpayment,more than downpayment,0,1000
G5StGV9e,2000,2/22/2018,10000,G5StGV9e,20500,more than downpayment,more than downpayment,0,2000
G5StGV9e,1000,3/15/2018,10000,G5StGV9e,21500,more than downpayment,more than downpayment,0,1000
G5StGV9e,1500,4/11/2018,10000,G5StGV9e,23000,more than downpayment,more than downpayment,0,1500
G5StGV9e,1000,2/22/2019,10000,G5StGV9e,24000,more than downpayment,more than downpayment,0,1000
G5StGV9e,1500,3/26/2019,10000,G5StGV9e,25500,more than downpayment,more than downpayment,0,1500
G5StGV9e,500,4/18/2019,10000,G5StGV9e,26000,more than downpayment,more than downpayment,0,500
G5StGV9e,1000,5/15/2019,10000,G5StGV9e,27000,more than downpayment,more than downpayment,0,1000
G5StGV9e,1000,6/12/2019,10000,G5StGV9e,28000,more than downpayment,more than downpayment,0,1000
G5StGV9e,1000,7/30/2019,10000,G5StGV9e,29000,more than downpayment,more than downpayment,0,1000
G5StGV9e,1000,8/12/2019,10000,G5StGV9e,30000,more than downpayment,more than downpayment,0,1000
G5StGV9e,500,9/27/2019,10000,G5StGV9e,30500,more than downpayment,more than downpayment,0,500
G5StGV9e,500,10/22/2019,10000,G5StGV9e,31000,more than downpayment,more than downpayment,0,500
G5StGV9e,5000,11/15/2019,10000,G5StGV9e,36000,more than downpayment,more than downpayment,0,5000
G5StGV9e,5000,2/3/2020,10000,G5StGV9e,41000,more than downpayment,more than downpayment,0,5000
G6RY3DH5,9900,10/26/2019,9900,,9900,equal to downpayment,,9900,0
G6RY3DH5,4000,1/6/2020,9900,G6RY3DH5,13900,more than downpayment,equal to downpayment,0,4000
G6RY3DH5,3900,1/29/2020,9900,G6RY3DH5,17800,more than downpayment,more than downpayment,0,3900
G6ZIE3DZ,8900,9/26/2019,8900,,8900,equal to downpayment,,8900,0
G6ZIE3DZ,3900,11/4/2019,8900,G6ZIE3DZ,12800,more than downpayment,equal to downpayment,0,3900
G6ZIE3DZ,3900,12/10/2019,8900,G6ZIE3DZ,16700,more than downpayment,more than downpayment,0,3900
G6ZIE3DZ,3900,1/8/2020,8900,G6ZIE3DZ,20600,more than downpayment,more than downpayment,0,3900
G6ZIE3DZ,3900,1/21/2020,8900,G6ZIE3DZ,24500,more than downpayment,more than downpayment,0,3900
G811rArr,10000,8/10/2017,10000,,10000,equal to downpayment,,10000,0
G811rArr,2000,1/1/2018,10000,G811rArr,12000,more than downpayment,equal to downpayment,0,2000
G811rArr,1000,3/22/2018,10000,G811rArr,13000,more than downpayment,more than downpayment,0,1000
G811rArr,1200,4/17/2018,10000,G811rArr,14200,more than downpayment,more than downpayment,0,1200
G811rArr,1000,7/3/2018,10000,G811rArr,15200,more than downpayment,more than downpayment,0,1000
G811rArr,3500,8/20/2018,10000,G811rArr,18700,more than downpayment,more than downpayment,0,3500
G811rArr,1300,9/4/2018,10000,G811rArr,20000,more than downpayment,more than downpayment,0,1300
G811rArr,2500,10/17/2018,10000,G811rArr,22500,more than downpayment,more than downpayment,0,2500
G811rArr,2000,11/9/2018,10000,G811rArr,24500,more than downpayment,more than downpayment,0,2000
G811rArr,1000,1/21/2019,10000,G811rArr,25500,more than downpayment,more than downpayment,0,1000
G811rArr,1500,3/1/2019,10000,G811rArr,27000,more than downpayment,more than downpayment,0,1500
G811rArr,1000,3/22/2019,10000,G811rArr,28000,more than downpayment,more than downpayment,0,1000
G811rArr,1000,4/8/2019,10000,G811rArr,29000,more than downpayment,more than downpayment,0,1000
G811rArr,1500,5/13/2019,10000,G811rArr,30500,more than downpayment,more than downpayment,0,1500
G811rArr,1500,6/20/2019,10000,G811rArr,32000,more than downpayment,more than downpayment,0,1500
G8N4YZIW,9900,7/22/2019,9900,,9900,equal to downpayment,,9900,0
G8N4YZIW,10000,8/6/2019,9900,G8N4YZIW,19900,more than downpayment,equal to downpayment,0,10000
G8N4YZIW,1000,10/5/2019,9900,G8N4YZIW,20900,more than downpayment,more than downpayment,0,1000
G8N4YZIW,150,10/13/2019,9900,G8N4YZIW,21050,more than downpayment,more than downpayment,0,150
G8N4YZIW,1000,10/25/2019,9900,G8N4YZIW,22050,more than downpayment,more than downpayment,0,1000
G8N4YZIW,130,12/17/2019,9900,G8N4YZIW,22180,more than downpayment,more than downpayment,0,130
G8N4YZIW,2220,1/30/2020,9900,G8N4YZIW,24400,more than downpayment,more than downpayment,0,2220
G8N4YZIW,5000,2/3/2020,9900,G8N4YZIW,29400,more than downpayment,more than downpayment,0,5000
G8N4YZIW,1000,2/4/2020,9900,G8N4YZIW,30400,more than downpayment,more than downpayment,0,1000
GBAI9GKF,9900,8/23/2019,9900,,9900,equal to downpayment,,9900,0
GBAI9GKF,3900,10/24/2019,9900,GBAI9GKF,13800,more than downpayment,equal to downpayment,0,3900
GBAI9GKF,3900,11/11/2019,9900,GBAI9GKF,17700,more than downpayment,more than downpayment,0,3900
GBAI9GKF,3900,12/13/2019,9900,GBAI9GKF,21600,more than downpayment,more than downpayment,0,3900
GBAI9GKF,3900,1/6/2020,9900,GBAI9GKF,25500,more than downpayment,more than downpayment,0,3900
GBAI9GKF,3900,2/6/2020,9900,GBAI9GKF,29400,more than downpayment,more than downpayment,0,3900
gbCbDC35,9000,5/20/2019,8900,,9000,more than downpayment,,8900,100
gbCbDC35,4000,7/22/2019,8900,gbCbDC35,13000,more than downpayment,more than downpayment,0,4000
gbCbDC35,4000,8/25/2019,8900,gbCbDC35,17000,more than downpayment,more than downpayment,0,4000
gbCbDC35,200,9/17/2019,8900,gbCbDC35,17200,more than downpayment,more than downpayment,0,200
gbCbDC35,300,9/19/2019,8900,gbCbDC35,17500,more than downpayment,more than downpayment,0,300
gbCbDC35,3500,9/25/2019,8900,gbCbDC35,21000,more than downpayment,more than downpayment,0,3500
gbCbDC35,4000,10/22/2019,8900,gbCbDC35,25000,more than downpayment,more than downpayment,0,4000
gbCbDC35,4000,11/26/2019,8900,gbCbDC35,29000,more than downpayment,more than downpayment,0,4000
gbCbDC35,4000,12/24/2019,8900,gbCbDC35,33000,more than downpayment,more than downpayment,0,4000
gbCbDC35,3900,1/27/2020,8900,gbCbDC35,36900,more than downpayment,more than downpayment,0,3900
GbQRqiBJ,8900,2/5/2019,8900,,8900,equal to downpayment,,8900,0
GbQRqiBJ,3900,3/31/2019,8900,GbQRqiBJ,12800,more than downpayment,equal to downpayment,0,3900
GbQRqiBJ,7800,6/27/2019,8900,GbQRqiBJ,20600,more than downpayment,more than downpayment,0,7800
GbQRqiBJ,3900,7/23/2019,8900,GbQRqiBJ,24500,more than downpayment,more than downpayment,0,3900
GbQRqiBJ,3900,8/5/2019,8900,GbQRqiBJ,28400,more than downpayment,more than downpayment,0,3900
GbQRqiBJ,7800,10/27/2019,8900,GbQRqiBJ,36200,more than downpayment,more than downpayment,0,7800
GbQRqiBJ,7800,11/29/2019,8900,GbQRqiBJ,44000,more than downpayment,more than downpayment,0,7800
GbQRqiBJ,3900,12/30/2019,8900,GbQRqiBJ,47900,more than downpayment,more than downpayment,0,3900
GbsUreez,9900,6/5/2019,8900,,9900,more than downpayment,,8900,1000
GbsUreez,3900,7/25/2019,8900,GbsUreez,13800,more than downpayment,more than downpayment,0,3900
GbsUreez,3900,8/29/2019,8900,GbsUreez,17700,more than downpayment,more than downpayment,0,3900
GbsUreez,3900,11/1/2019,8900,GbsUreez,21600,more than downpayment,more than downpayment,0,3900
GbsUreez,3900,11/29/2019,8900,GbsUreez,25500,more than downpayment,more than downpayment,0,3900
GbsUreez,3900,12/21/2019,8900,GbsUreez,29400,more than downpayment,more than downpayment,0,3900
GbsUreez,3900,1/29/2020,8900,GbsUreez,33300,more than downpayment,more than downpayment,0,3900
GbUatWy9,9000,12/27/2018,8900,,9000,more than downpayment,,8900,100
GbUatWy9,4000,2/23/2019,8900,GbUatWy9,13000,more than downpayment,more than downpayment,0,4000
GbUatWy9,4000,3/24/2019,8900,GbUatWy9,17000,more than downpayment,more than downpayment,0,4000
GbUatWy9,5000,4/25/2019,8900,GbUatWy9,22000,more than downpayment,more than downpayment,0,5000
GbUatWy9,4000,5/27/2019,8900,GbUatWy9,26000,more than downpayment,more than downpayment,0,4000
GbUatWy9,4000,6/25/2019,8900,GbUatWy9,30000,more than downpayment,more than downpayment,0,4000
GbUatWy9,4000,7/28/2019,8900,GbUatWy9,34000,more than downpayment,more than downpayment,0,4000
GbUatWy9,4000,8/30/2019,8900,GbUatWy9,38000,more than downpayment,more than downpayment,0,4000
GbUatWy9,4000,9/29/2019,8900,GbUatWy9,42000,more than downpayment,more than downpayment,0,4000
GbUatWy9,4000,10/30/2019,8900,GbUatWy9,46000,more than downpayment,more than downpayment,0,4000
GbUatWy9,4000,11/27/2019,8900,GbUatWy9,50000,more than downpayment,more than downpayment,0,4000
GbUatWy9,4000,12/30/2019,8900,GbUatWy9,54000,more than downpayment,more than downpayment,0,4000
GbUatWy9,4000,1/29/2020,8900,GbUatWy9,58000,more than downpayment,more than downpayment,0,4000
GBVOO5KP,9900,10/1/2019,9900,,9900,equal to downpayment,,9900,0
GC5M5ILD,8900,9/18/2019,8900,,8900,equal to downpayment,,8900,0
GC5M5ILD,3900,10/14/2019,8900,GC5M5ILD,12800,more than downpayment,equal to downpayment,0,3900
GC5M5ILD,3900,11/26/2019,8900,GC5M5ILD,16700,more than downpayment,more than downpayment,0,3900
GC5M5ILD,3900,1/2/2020,8900,GC5M5ILD,20600,more than downpayment,more than downpayment,0,3900
GC5M5ILD,3900,2/5/2020,8900,GC5M5ILD,24500,more than downpayment,more than downpayment,0,3900
GcaJrq5v,8900,3/12/2019,8900,,8900,equal to downpayment,,8900,0
GcaJrq5v,5000,4/9/2019,8900,GcaJrq5v,13900,more than downpayment,equal to downpayment,0,5000
GcaJrq5v,3900,6/19/2019,8900,GcaJrq5v,17800,more than downpayment,more than downpayment,0,3900
GcaJrq5v,3900,7/5/2019,8900,GcaJrq5v,21700,more than downpayment,more than downpayment,0,3900
GcaJrq5v,3900,8/12/2019,8900,GcaJrq5v,25600,more than downpayment,more than downpayment,0,3900
GcaJrq5v,3900,9/4/2019,8900,GcaJrq5v,29500,more than downpayment,more than downpayment,0,3900
GcaJrq5v,3900,10/14/2019,8900,GcaJrq5v,33400,more than downpayment,more than downpayment,0,3900
GcaJrq5v,3900,11/8/2019,8900,GcaJrq5v,37300,more than downpayment,more than downpayment,0,3900
GcaJrq5v,3900,12/3/2019,8900,GcaJrq5v,41200,more than downpayment,more than downpayment,0,3900
GcaJrq5v,3900,1/13/2020,8900,GcaJrq5v,45100,more than downpayment,more than downpayment,0,3900
GcaJrq5v,3900,2/6/2020,8900,GcaJrq5v,49000,more than downpayment,more than downpayment,0,3900
gCiLelH7,8900,7/19/2019,8900,,8900,equal to downpayment,,8900,0
gCiLelH7,3900,9/3/2019,8900,gCiLelH7,12800,more than downpayment,equal to downpayment,0,3900
gCiLelH7,3900,9/30/2019,8900,gCiLelH7,16700,more than downpayment,more than downpayment,0,3900
gCiLelH7,3900,11/4/2019,8900,gCiLelH7,20600,more than downpayment,more than downpayment,0,3900
gCiLelH7,3900,12/5/2019,8900,gCiLelH7,24500,more than downpayment,more than downpayment,0,3900
gCiLelH7,3900,2/5/2020,8900,gCiLelH7,28400,more than downpayment,more than downpayment,0,3900
GCM5VDjV,9900,12/4/2018,9900,,9900,equal to downpayment,,9900,0
GCM5VDjV,4500,2/7/2019,9900,GCM5VDjV,14400,more than downpayment,equal to downpayment,0,4500
GCPA8D8A,8900,8/28/2019,8900,,8900,equal to downpayment,,8900,0
GCPA8D8A,3900,11/27/2019,8900,GCPA8D8A,12800,more than downpayment,equal to downpayment,0,3900
GCPA8D8A,3900,1/3/2020,8900,GCPA8D8A,16700,more than downpayment,more than downpayment,0,3900
GCPA8D8A,5000,2/4/2020,8900,GCPA8D8A,21700,more than downpayment,more than downpayment,0,5000
GCR644YE,8900,5/17/2019,8900,,8900,equal to downpayment,,8900,0
GCR644YE,11700,7/1/2019,8900,GCR644YE,20600,more than downpayment,equal to downpayment,0,11700
GCR644YE,3900,9/2/2019,8900,GCR644YE,24500,more than downpayment,more than downpayment,0,3900
GCR644YE,3900,10/17/2019,8900,GCR644YE,28400,more than downpayment,more than downpayment,0,3900
GCR644YE,3900,11/4/2019,8900,GCR644YE,32300,more than downpayment,more than downpayment,0,3900
GCR644YE,3900,12/27/2019,8900,GCR644YE,36200,more than downpayment,more than downpayment,0,3900
GCR644YE,3900,1/23/2020,8900,GCR644YE,40100,more than downpayment,more than downpayment,0,3900
GCZ3RGVW,9900,9/30/2019,9900,,9900,equal to downpayment,,9900,0
GCZ3RGVW,3900,11/22/2019,9900,GCZ3RGVW,13800,more than downpayment,equal to downpayment,0,3900
GCZ3RGVW,3900,12/23/2019,9900,GCZ3RGVW,17700,more than downpayment,more than downpayment,0,3900
GCZ3RGVW,4000,1/22/2020,9900,GCZ3RGVW,21700,more than downpayment,more than downpayment,0,4000
GDFATBNU,5000,12/17/2019,4999,,5000,more than downpayment,,4999,1
GE1UUGJX,23400,8/16/2019,8900,,23400,more than downpayment,,8900,14500
GE1UUGJX,7300,9/23/2019,8900,GE1UUGJX,30700,more than downpayment,more than downpayment,0,7300
GE1UUGJX,7300,10/21/2019,8900,GE1UUGJX,38000,more than downpayment,more than downpayment,0,7300
GE1UUGJX,7300,11/23/2019,8900,GE1UUGJX,45300,more than downpayment,more than downpayment,0,7300
GE1UUGJX,7300,12/25/2019,8900,GE1UUGJX,52600,more than downpayment,more than downpayment,0,7300
GE1UUGJX,7300,1/22/2020,8900,GE1UUGJX,59900,more than downpayment,more than downpayment,0,7300
GE4xizMB,16000,11/29/2018,9900,,16000,more than downpayment,,9900,6100
GE4xizMB,4500,1/25/2019,9900,GE4xizMB,20500,more than downpayment,more than downpayment,0,4500
GE4xizMB,3000,3/25/2019,9900,GE4xizMB,23500,more than downpayment,more than downpayment,0,3000
GE4xizMB,3000,5/8/2019,9900,GE4xizMB,26500,more than downpayment,more than downpayment,0,3000
GE4xizMB,800,5/21/2019,9900,GE4xizMB,27300,more than downpayment,more than downpayment,0,800
GE4xizMB,2000,5/27/2019,9900,GE4xizMB,29300,more than downpayment,more than downpayment,0,2000
GE4xizMB,1000,6/17/2019,9900,GE4xizMB,30300,more than downpayment,more than downpayment,0,1000
GE4xizMB,1000,6/19/2019,9900,GE4xizMB,31300,more than downpayment,more than downpayment,0,1000
GE4xizMB,1200,7/8/2019,9900,GE4xizMB,32500,more than downpayment,more than downpayment,0,1200
GE4xizMB,1500,8/5/2019,9900,GE4xizMB,34000,more than downpayment,more than downpayment,0,1500
GE4xizMB,1000,8/9/2019,9900,GE4xizMB,35000,more than downpayment,more than downpayment,0,1000
GE4xizMB,4300,11/1/2019,9900,GE4xizMB,39300,more than downpayment,more than downpayment,0,4300
GE4xizMB,5000,11/24/2019,9900,GE4xizMB,44300,more than downpayment,more than downpayment,0,5000
GE4xizMB,5000,1/2/2020,9900,GE4xizMB,49300,more than downpayment,more than downpayment,0,5000
GE4xizMB,1000,2/6/2020,9900,GE4xizMB,50300,more than downpayment,more than downpayment,0,1000
GF5C6WJ3,9900,12/30/2019,9900,,9900,equal to downpayment,,9900,0
GFf0OLAA,10000,1/14/2018,10000,,10000,equal to downpayment,,10000,0
GFf0OLAA,4500,2/24/2018,10000,GFf0OLAA,14500,more than downpayment,equal to downpayment,0,4500
GFf0OLAA,4500,3/24/2018,10000,GFf0OLAA,19000,more than downpayment,more than downpayment,0,4500
GFf0OLAA,4500,4/23/2018,10000,GFf0OLAA,23500,more than downpayment,more than downpayment,0,4500
GFf0OLAA,4500,5/25/2018,10000,GFf0OLAA,28000,more than downpayment,more than downpayment,0,4500
GFf0OLAA,4500,6/24/2018,10000,GFf0OLAA,32500,more than downpayment,more than downpayment,0,4500
GFf0OLAA,4500,7/25/2018,10000,GFf0OLAA,37000,more than downpayment,more than downpayment,0,4500
GFf0OLAA,4500,8/26/2018,10000,GFf0OLAA,41500,more than downpayment,more than downpayment,0,4500
GFf0OLAA,4500,9/25/2018,10000,GFf0OLAA,46000,more than downpayment,more than downpayment,0,4500
GFf0OLAA,4500,10/27/2018,10000,GFf0OLAA,50500,more than downpayment,more than downpayment,0,4500
GFf0OLAA,4500,11/25/2018,10000,GFf0OLAA,55000,more than downpayment,more than downpayment,0,4500
GFf0OLAA,4500,12/24/2018,10000,GFf0OLAA,59500,more than downpayment,more than downpayment,0,4500
GFf0OLAA,4500,1/26/2019,10000,GFf0OLAA,64000,more than downpayment,more than downpayment,0,4500
gFvOWb1J,9900,7/6/2019,9900,,9900,equal to downpayment,,9900,0
gFvOWb1J,3900,8/26/2019,9900,gFvOWb1J,13800,more than downpayment,equal to downpayment,0,3900
gFvOWb1J,2000,11/19/2019,9900,gFvOWb1J,15800,more than downpayment,more than downpayment,0,2000
gFvOWb1J,9700,12/11/2019,9900,gFvOWb1J,25500,more than downpayment,more than downpayment,0,9700
gFvOWb1J,3900,1/28/2020,9900,gFvOWb1J,29400,more than downpayment,more than downpayment,0,3900
gfZXroYy,9900,6/14/2019,9900,,9900,equal to downpayment,,9900,0
gfZXroYy,3900,7/25/2019,9900,gfZXroYy,13800,more than downpayment,equal to downpayment,0,3900
gfZXroYy,3900,9/7/2019,9900,gfZXroYy,17700,more than downpayment,more than downpayment,0,3900
gfZXroYy,3900,10/8/2019,9900,gfZXroYy,21600,more than downpayment,more than downpayment,0,3900
gfZXroYy,3900,11/8/2019,9900,gfZXroYy,25500,more than downpayment,more than downpayment,0,3900
gfZXroYy,3900,12/5/2019,9900,gfZXroYy,29400,more than downpayment,more than downpayment,0,3900
gfZXroYy,3900,1/3/2020,9900,gfZXroYy,33300,more than downpayment,more than downpayment,0,3900
gfZXroYy,3900,2/6/2020,9900,gfZXroYy,37200,more than downpayment,more than downpayment,0,3900
ggJnRANJ,8900,1/10/2019,8900,,8900,equal to downpayment,,8900,0
ggJnRANJ,3900,2/25/2019,8900,ggJnRANJ,12800,more than downpayment,equal to downpayment,0,3900
ggJnRANJ,3900,3/25/2019,8900,ggJnRANJ,16700,more than downpayment,more than downpayment,0,3900
ggJnRANJ,3900,4/25/2019,8900,ggJnRANJ,20600,more than downpayment,more than downpayment,0,3900
ggJnRANJ,3900,5/25/2019,8900,ggJnRANJ,24500,more than downpayment,more than downpayment,0,3900
ggJnRANJ,3900,6/25/2019,8900,ggJnRANJ,28400,more than downpayment,more than downpayment,0,3900
ggJnRANJ,3900,7/25/2019,8900,ggJnRANJ,32300,more than downpayment,more than downpayment,0,3900
ggJnRANJ,3900,8/25/2019,8900,ggJnRANJ,36200,more than downpayment,more than downpayment,0,3900
ggJnRANJ,3900,9/25/2019,8900,ggJnRANJ,40100,more than downpayment,more than downpayment,0,3900
ggJnRANJ,3900,11/10/2019,8900,ggJnRANJ,44000,more than downpayment,more than downpayment,0,3900
ggJnRANJ,3900,12/2/2019,8900,ggJnRANJ,47900,more than downpayment,more than downpayment,0,3900
ggJnRANJ,3900,1/2/2020,8900,ggJnRANJ,51800,more than downpayment,more than downpayment,0,3900
ggJnRANJ,3900,2/4/2020,8900,ggJnRANJ,55700,more than downpayment,more than downpayment,0,3900
GH6FEXV9,10000,6/27/2019,8900,,10000,more than downpayment,,8900,1100
GH6FEXV9,3900,8/4/2019,8900,GH6FEXV9,13900,more than downpayment,more than downpayment,0,3900
GH6FEXV9,3900,9/4/2019,8900,GH6FEXV9,17800,more than downpayment,more than downpayment,0,3900
GH6FEXV9,3900,10/3/2019,8900,GH6FEXV9,21700,more than downpayment,more than downpayment,0,3900
GH6FEXV9,3900,11/9/2019,8900,GH6FEXV9,25600,more than downpayment,more than downpayment,0,3900
GH6FEXV9,3900,12/1/2019,8900,GH6FEXV9,29500,more than downpayment,more than downpayment,0,3900
GH6FEXV9,3900,1/4/2020,8900,GH6FEXV9,33400,more than downpayment,more than downpayment,0,3900
GH6FEXV9,3000,2/5/2020,8900,GH6FEXV9,36400,more than downpayment,more than downpayment,0,3000
GIgLkmS0,9900,6/21/2019,9900,,9900,equal to downpayment,,9900,0
GIgLkmS0,3900,8/7/2019,9900,GIgLkmS0,13800,more than downpayment,equal to downpayment,0,3900
GIgLkmS0,3900,9/7/2019,9900,GIgLkmS0,17700,more than downpayment,more than downpayment,0,3900
GIgLkmS0,3900,10/7/2019,9900,GIgLkmS0,21600,more than downpayment,more than downpayment,0,3900
GIgLkmS0,3900,11/4/2019,9900,GIgLkmS0,25500,more than downpayment,more than downpayment,0,3900
GIgLkmS0,3900,12/6/2019,9900,GIgLkmS0,29400,more than downpayment,more than downpayment,0,3900
GIgLkmS0,3900,1/6/2020,9900,GIgLkmS0,33300,more than downpayment,more than downpayment,0,3900
GIgLkmS0,3900,2/6/2020,9900,GIgLkmS0,37200,more than downpayment,more than downpayment,0,3900
GIK36N6H,8900,1/25/2020,8900,,8900,equal to downpayment,,8900,0
GILaTc3S,10000,11/13/2018,8900,,10000,more than downpayment,,8900,1100
GILaTc3S,5000,12/11/2018,8900,GILaTc3S,15000,more than downpayment,more than downpayment,0,5000
GILaTc3S,5000,1/7/2019,8900,GILaTc3S,20000,more than downpayment,more than downpayment,0,5000
GILaTc3S,5000,1/22/2019,8900,GILaTc3S,25000,more than downpayment,more than downpayment,0,5000
GILaTc3S,5000,2/9/2019,8900,GILaTc3S,30000,more than downpayment,more than downpayment,0,5000
GILaTc3S,1500,2/22/2019,8900,GILaTc3S,31500,more than downpayment,more than downpayment,0,1500
GILaTc3S,3500,2/24/2019,8900,GILaTc3S,35000,more than downpayment,more than downpayment,0,3500
GILaTc3S,5000,3/20/2019,8900,GILaTc3S,40000,more than downpayment,more than downpayment,0,5000
GILaTc3S,5000,4/17/2019,8900,GILaTc3S,45000,more than downpayment,more than downpayment,0,5000
GILaTc3S,5000,5/24/2019,8900,GILaTc3S,50000,more than downpayment,more than downpayment,0,5000
GILaTc3S,5000,6/19/2019,8900,GILaTc3S,55000,more than downpayment,more than downpayment,0,5000
GILaTc3S,5000,7/20/2019,8900,GILaTc3S,60000,more than downpayment,more than downpayment,0,5000
GILaTc3S,5000,8/16/2019,8900,GILaTc3S,65000,more than downpayment,more than downpayment,0,5000
GILaTc3S,5000,9/13/2019,8900,GILaTc3S,70000,more than downpayment,more than downpayment,0,5000
GILaTc3S,5000,10/10/2019,8900,GILaTc3S,75000,more than downpayment,more than downpayment,0,5000
GILaTc3S,3900,11/21/2019,8900,GILaTc3S,78900,more than downpayment,more than downpayment,0,3900
GILaTc3S,1100,11/23/2019,8900,GILaTc3S,80000,more than downpayment,more than downpayment,0,1100
GILaTc3S,5000,12/18/2019,8900,GILaTc3S,85000,more than downpayment,more than downpayment,0,5000
GILaTc3S,5000,1/23/2020,8900,GILaTc3S,90000,more than downpayment,more than downpayment,0,5000
GIZBDNM6,9900,11/23/2019,8900,,9900,more than downpayment,,8900,1000
GIZBDNM6,2900,2/7/2020,8900,GIZBDNM6,12800,more than downpayment,more than downpayment,0,2900
GIZYS4iS,9900,11/29/2019,9900,,9900,equal to downpayment,,9900,0
GJf3QSIt,10000,3/19/2019,10000,,10000,equal to downpayment,,10000,0
GJf3QSIt,4500,5/11/2019,10000,GJf3QSIt,14500,more than downpayment,equal to downpayment,0,4500
GJf3QSIt,4500,6/14/2019,10000,GJf3QSIt,19000,more than downpayment,more than downpayment,0,4500
GJf3QSIt,4500,7/16/2019,10000,GJf3QSIt,23500,more than downpayment,more than downpayment,0,4500
GJf3QSIt,2000,8/21/2019,10000,GJf3QSIt,25500,more than downpayment,more than downpayment,0,2000
GJf3QSIt,2500,8/27/2019,10000,GJf3QSIt,28000,more than downpayment,more than downpayment,0,2500
GJf3QSIt,3500,12/20/2019,10000,GJf3QSIt,31500,more than downpayment,more than downpayment,0,3500
GJf3QSIt,4000,2/4/2020,10000,GJf3QSIt,35500,more than downpayment,more than downpayment,0,4000
GJw9gEqx,8900,10/4/2019,8900,,8900,equal to downpayment,,8900,0
GJw9gEqx,4000,11/4/2019,8900,GJw9gEqx,12900,more than downpayment,equal to downpayment,0,4000
GJw9gEqx,3900,12/6/2019,8900,GJw9gEqx,16800,more than downpayment,more than downpayment,0,3900
GJw9gEqx,3900,2/4/2020,8900,GJw9gEqx,20700,more than downpayment,more than downpayment,0,3900
gk997fAc,10000,7/1/2019,9900,,10000,more than downpayment,,9900,100
gk997fAc,4000,8/13/2019,9900,gk997fAc,14000,more than downpayment,more than downpayment,0,4000
gk997fAc,4000,9/9/2019,9900,gk997fAc,18000,more than downpayment,more than downpayment,0,4000
gk997fAc,4000,10/11/2019,9900,gk997fAc,22000,more than downpayment,more than downpayment,0,4000
gk997fAc,4000,11/2/2019,9900,gk997fAc,26000,more than downpayment,more than downpayment,0,4000
gk997fAc,4000,12/13/2019,9900,gk997fAc,30000,more than downpayment,more than downpayment,0,4000
gk997fAc,4000,1/7/2020,9900,gk997fAc,34000,more than downpayment,more than downpayment,0,4000
GKKKO2SC,9900,10/4/2019,9900,,9900,equal to downpayment,,9900,0
GKKKO2SC,4000,11/14/2019,9900,GKKKO2SC,13900,more than downpayment,equal to downpayment,0,4000
GKKKO2SC,3900,12/13/2019,9900,GKKKO2SC,17800,more than downpayment,more than downpayment,0,3900
GKKKO2SC,3900,1/9/2020,9900,GKKKO2SC,21700,more than downpayment,more than downpayment,0,3900
gKOhAPbR,10000,4/24/2019,8900,,10000,more than downpayment,,8900,1100
gKOhAPbR,19000,5/30/2019,8900,gKOhAPbR,29000,more than downpayment,more than downpayment,0,19000
gKOhAPbR,4000,10/2/2019,8900,gKOhAPbR,33000,more than downpayment,more than downpayment,0,4000
gKOhAPbR,7000,12/23/2019,8900,gKOhAPbR,40000,more than downpayment,more than downpayment,0,7000
gKOhAPbR,500,1/17/2020,8900,gKOhAPbR,40500,more than downpayment,more than downpayment,0,500
gKOhAPbR,3900,2/9/2020,8900,gKOhAPbR,44400,more than downpayment,more than downpayment,0,3900
GL5LDXZ7,9900,10/3/2019,9900,,9900,equal to downpayment,,9900,0
GL5LDXZ7,3900,11/14/2019,9900,GL5LDXZ7,13800,more than downpayment,equal to downpayment,0,3900
GL5LDXZ7,3900,12/11/2019,9900,GL5LDXZ7,17700,more than downpayment,more than downpayment,0,3900
GL5LDXZ7,3900,1/8/2020,9900,GL5LDXZ7,21600,more than downpayment,more than downpayment,0,3900
GL5LDXZ7,3900,2/9/2020,9900,GL5LDXZ7,25500,more than downpayment,more than downpayment,0,3900
GLeYotuk,9900,6/6/2019,8900,,9900,more than downpayment,,8900,1000
GLeYotuk,3900,7/25/2019,8900,GLeYotuk,13800,more than downpayment,more than downpayment,0,3900
GLeYotuk,3900,8/27/2019,8900,GLeYotuk,17700,more than downpayment,more than downpayment,0,3900
GLeYotuk,3900,9/25/2019,8900,GLeYotuk,21600,more than downpayment,more than downpayment,0,3900
GLeYotuk,3900,10/30/2019,8900,GLeYotuk,25500,more than downpayment,more than downpayment,0,3900
GLeYotuk,2000,11/26/2019,8900,GLeYotuk,27500,more than downpayment,more than downpayment,0,2000
GLeYotuk,1800,12/4/2019,8900,GLeYotuk,29300,more than downpayment,more than downpayment,0,1800
GLeYotuk,3000,12/27/2019,8900,GLeYotuk,32300,more than downpayment,more than downpayment,0,3000
GLeYotuk,3400,2/6/2020,8900,GLeYotuk,35700,more than downpayment,more than downpayment,0,3400
GLTWHHQI,9900,12/23/2019,9900,,9900,equal to downpayment,,9900,0
GLTWHHQI,3900,2/4/2020,9900,GLTWHHQI,13800,more than downpayment,equal to downpayment,0,3900
GLYYP3LN,8900,1/27/2020,8900,,8900,equal to downpayment,,8900,0
gm8ojLva,10000,12/13/2018,10000,,10000,equal to downpayment,,10000,0
gm8ojLva,4500,1/25/2019,10000,gm8ojLva,14500,more than downpayment,equal to downpayment,0,4500
gm8ojLva,4500,2/28/2019,10000,gm8ojLva,19000,more than downpayment,more than downpayment,0,4500
gm8ojLva,4500,3/25/2019,10000,gm8ojLva,23500,more than downpayment,more than downpayment,0,4500
gm8ojLva,4500,5/3/2019,10000,gm8ojLva,28000,more than downpayment,more than downpayment,0,4500
gm8ojLva,4500,5/28/2019,10000,gm8ojLva,32500,more than downpayment,more than downpayment,0,4500
gm8ojLva,4500,7/1/2019,10000,gm8ojLva,37000,more than downpayment,more than downpayment,0,4500
gm8ojLva,4500,8/9/2019,10000,gm8ojLva,41500,more than downpayment,more than downpayment,0,4500
gm8ojLva,4500,9/17/2019,10000,gm8ojLva,46000,more than downpayment,more than downpayment,0,4500
gm8ojLva,4500,10/18/2019,10000,gm8ojLva,50500,more than downpayment,more than downpayment,0,4500
gm8ojLva,4500,11/7/2019,10000,gm8ojLva,55000,more than downpayment,more than downpayment,0,4500
gm8ojLva,4500,12/10/2019,10000,gm8ojLva,59500,more than downpayment,more than downpayment,0,4500
gm8ojLva,2950,1/27/2020,10000,gm8ojLva,62450,more than downpayment,more than downpayment,0,2950
GMJ1UXCL,9900,1/18/2020,9900,,9900,equal to downpayment,,9900,0
Gnh1LV4s,26250,6/14/2019,26250,,26250,equal to downpayment,,26250,0
Gnh1LV4s,28650,6/15/2019,26250,Gnh1LV4s,54900,more than downpayment,equal to downpayment,0,28650
Gnh1LV4s,3900,7/22/2019,26250,Gnh1LV4s,58800,more than downpayment,more than downpayment,0,3900
Gnh1LV4s,27000,8/27/2019,26250,Gnh1LV4s,85800,more than downpayment,more than downpayment,0,27000
Gnh1LV4s,20200,10/1/2019,26250,Gnh1LV4s,106000,more than downpayment,more than downpayment,0,20200
Gnh1LV4s,25000,11/4/2019,26250,Gnh1LV4s,131000,more than downpayment,more than downpayment,0,25000
Gnh1LV4s,27100,11/27/2019,26250,Gnh1LV4s,158100,more than downpayment,more than downpayment,0,27100
Gnh1LV4s,400,12/6/2019,26250,Gnh1LV4s,158500,more than downpayment,more than downpayment,0,400
GOCZ4PEN,9900,1/28/2020,9900,,9900,equal to downpayment,,9900,0
goh0nrqn,8900,5/10/2019,8900,,8900,equal to downpayment,,8900,0
goh0nrqn,3900,6/7/2019,8900,goh0nrqn,12800,more than downpayment,equal to downpayment,0,3900
goh0nrqn,3900,7/29/2019,8900,goh0nrqn,16700,more than downpayment,more than downpayment,0,3900
goh0nrqn,3000,9/10/2019,8900,goh0nrqn,19700,more than downpayment,more than downpayment,0,3000
goh0nrqn,5000,10/25/2019,8900,goh0nrqn,24700,more than downpayment,more than downpayment,0,5000
goh0nrqn,3900,12/5/2019,8900,goh0nrqn,28600,more than downpayment,more than downpayment,0,3900
goh0nrqn,6900,12/22/2019,8900,goh0nrqn,35500,more than downpayment,more than downpayment,0,6900
goh0nrqn,700,1/6/2020,8900,goh0nrqn,36200,more than downpayment,more than downpayment,0,700
GPJMTWBL,9900,10/14/2019,9900,,9900,equal to downpayment,,9900,0
GPJMTWBL,2050,12/30/2019,9900,GPJMTWBL,11950,more than downpayment,equal to downpayment,0,2050
GPJMTWBL,1000,1/6/2020,9900,GPJMTWBL,12950,more than downpayment,more than downpayment,0,1000
GPJMTWBL,1000,1/7/2020,9900,GPJMTWBL,13950,more than downpayment,more than downpayment,0,1000
GPJMTWBL,1000,1/22/2020,9900,GPJMTWBL,14950,more than downpayment,more than downpayment,0,1000
GPJMTWBL,1100,1/23/2020,9900,GPJMTWBL,16050,more than downpayment,more than downpayment,0,1100
GPJMTWBL,1000,1/24/2020,9900,GPJMTWBL,17050,more than downpayment,more than downpayment,0,1000
GPJMTWBL,440,1/26/2020,9900,GPJMTWBL,17490,more than downpayment,more than downpayment,0,440
GPJMTWBL,270,1/28/2020,9900,GPJMTWBL,17760,more than downpayment,more than downpayment,0,270
GPQVKJEZ,1600,10/15/2019,7900,,1600,less than downpayment,,1600,0
Gq7QiX3c,8900,1/25/2019,8900,,8900,equal to downpayment,,8900,0
Gq7QiX3c,3900,3/23/2019,8900,Gq7QiX3c,12800,more than downpayment,equal to downpayment,0,3900
Gq7QiX3c,2000,5/3/2019,8900,Gq7QiX3c,14800,more than downpayment,more than downpayment,0,2000
Gq7QiX3c,3000,5/13/2019,8900,Gq7QiX3c,17800,more than downpayment,more than downpayment,0,3000
Gq7QiX3c,2200,5/31/2019,8900,Gq7QiX3c,20000,more than downpayment,more than downpayment,0,2200
Gq7QiX3c,2000,6/15/2019,8900,Gq7QiX3c,22000,more than downpayment,more than downpayment,0,2000
Gq7QiX3c,1000,9/3/2019,8900,Gq7QiX3c,23000,more than downpayment,more than downpayment,0,1000
Gq7QiX3c,500,10/23/2019,8900,Gq7QiX3c,23500,more than downpayment,more than downpayment,0,500
GQR1J15F,5000,1/1/2020,9900,,5000,less than downpayment,,5000,0
GQR1J15F,2000,1/2/2020,9900,GQR1J15F,7000,less than downpayment,less than downpayment,2000,0
GQR1J15F,2900,1/4/2020,9900,GQR1J15F,9900,equal to downpayment,less than downpayment,2900,0
GR4YLANU,9900,11/8/2019,9900,,9900,equal to downpayment,,9900,0
GR4YLANU,6000,1/25/2020,9900,GR4YLANU,15900,more than downpayment,equal to downpayment,0,6000
GR4YLANU,1800,1/27/2020,9900,GR4YLANU,17700,more than downpayment,more than downpayment,0,1800
Gr5zuAk8,9900,7/12/2019,9900,,9900,equal to downpayment,,9900,0
Gr5zuAk8,3900,12/30/2019,9900,Gr5zuAk8,13800,more than downpayment,equal to downpayment,0,3900
gRKzedQ5,10000,5/20/2019,8900,,10000,more than downpayment,,8900,1100
gRKzedQ5,10900,7/10/2019,8900,gRKzedQ5,20900,more than downpayment,more than downpayment,0,10900
gRKzedQ5,8000,8/13/2019,8900,gRKzedQ5,28900,more than downpayment,more than downpayment,0,8000
gRKzedQ5,10000,9/3/2019,8900,gRKzedQ5,38900,more than downpayment,more than downpayment,0,10000
gRKzedQ5,10000,9/19/2019,8900,gRKzedQ5,48900,more than downpayment,more than downpayment,0,10000
gRKzedQ5,10000,10/7/2019,8900,gRKzedQ5,58900,more than downpayment,more than downpayment,0,10000
gRKzedQ5,10000,10/24/2019,8900,gRKzedQ5,68900,more than downpayment,more than downpayment,0,10000
gRKzedQ5,10000,11/14/2019,8900,gRKzedQ5,78900,more than downpayment,more than downpayment,0,10000
gRKzedQ5,10000,11/28/2019,8900,gRKzedQ5,88900,more than downpayment,more than downpayment,0,10000
gRKzedQ5,10000,12/19/2019,8900,gRKzedQ5,98900,more than downpayment,more than downpayment,0,10000
gRKzedQ5,10000,1/16/2020,8900,gRKzedQ5,108900,more than downpayment,more than downpayment,0,10000
gRKzedQ5,17000,1/24/2020,8900,gRKzedQ5,125900,more than downpayment,more than downpayment,0,17000
GRQ7A5AS,9900,12/24/2019,9900,,9900,equal to downpayment,,9900,0
GS2JgsRm,27500,7/12/2019,26250,,27500,more than downpayment,,26250,1250
GS2JgsRm,26250,8/26/2019,26250,GS2JgsRm,53750,more than downpayment,more than downpayment,0,26250
GS2JgsRm,25500,11/21/2019,26250,GS2JgsRm,79250,more than downpayment,more than downpayment,0,25500
GS2JgsRm,5500,12/17/2019,26250,GS2JgsRm,84750,more than downpayment,more than downpayment,0,5500
GS2JgsRm,10000,12/28/2019,26250,GS2JgsRm,94750,more than downpayment,more than downpayment,0,10000
GS2JgsRm,10500,1/17/2020,26250,GS2JgsRm,105250,more than downpayment,more than downpayment,0,10500
GT2BRNLX,9990,11/12/2019,9900,,9990,more than downpayment,,9900,90
GT2BRNLX,4000,1/21/2020,9900,GT2BRNLX,13990,more than downpayment,more than downpayment,0,4000
GT2BRNLX,3500,1/31/2020,9900,GT2BRNLX,17490,more than downpayment,more than downpayment,0,3500
Gt3SO6ig,10000,7/8/2017,10000,,10000,equal to downpayment,,10000,0
Gt3SO6ig,3000,9/14/2017,10000,Gt3SO6ig,13000,more than downpayment,equal to downpayment,0,3000
Gt3SO6ig,3500,10/12/2017,10000,Gt3SO6ig,16500,more than downpayment,more than downpayment,0,3500
Gt3SO6ig,3500,11/14/2017,10000,Gt3SO6ig,20000,more than downpayment,more than downpayment,0,3500
Gt3SO6ig,3500,12/18/2017,10000,Gt3SO6ig,23500,more than downpayment,more than downpayment,0,3500
Gt3SO6ig,3500,1/9/2018,10000,Gt3SO6ig,27000,more than downpayment,more than downpayment,0,3500
Gt3SO6ig,3500,3/2/2018,10000,Gt3SO6ig,30500,more than downpayment,more than downpayment,0,3500
Gt3SO6ig,3500,4/13/2018,10000,Gt3SO6ig,34000,more than downpayment,more than downpayment,0,3500
Gt3SO6ig,3500,5/2/2018,10000,Gt3SO6ig,37500,more than downpayment,more than downpayment,0,3500
Gt3SO6ig,4000,6/4/2018,10000,Gt3SO6ig,41500,more than downpayment,more than downpayment,0,4000
Gt3SO6ig,3500,8/20/2018,10000,Gt3SO6ig,45000,more than downpayment,more than downpayment,0,3500
GT76Y9NJ,10000,12/20/2019,9900,,10000,more than downpayment,,9900,100
GT76Y9NJ,3900,2/8/2020,9900,GT76Y9NJ,13900,more than downpayment,more than downpayment,0,3900
gtNbsQVB,10000,8/3/2018,10000,,10000,equal to downpayment,,10000,0
gtNbsQVB,10000,8/30/2018,10000,gtNbsQVB,20000,more than downpayment,equal to downpayment,0,10000
gtNbsQVB,10000,9/28/2018,10000,gtNbsQVB,30000,more than downpayment,more than downpayment,0,10000
gtNbsQVB,10000,10/19/2018,10000,gtNbsQVB,40000,more than downpayment,more than downpayment,0,10000
gtNbsQVB,5000,11/15/2018,10000,gtNbsQVB,45000,more than downpayment,more than downpayment,0,5000
gtNbsQVB,12000,12/17/2018,10000,gtNbsQVB,57000,more than downpayment,more than downpayment,0,12000
gtNbsQVB,9000,2/5/2019,10000,gtNbsQVB,66000,more than downpayment,more than downpayment,0,9000
Gu5qhPk6,9900,7/9/2019,9900,,9900,equal to downpayment,,9900,0
Gu5qhPk6,3900,8/10/2019,9900,Gu5qhPk6,13800,more than downpayment,equal to downpayment,0,3900
Gu5qhPk6,3900,9/13/2019,9900,Gu5qhPk6,17700,more than downpayment,more than downpayment,0,3900
Gu5qhPk6,3900,10/13/2019,9900,Gu5qhPk6,21600,more than downpayment,more than downpayment,0,3900
Gu5qhPk6,3900,11/10/2019,9900,Gu5qhPk6,25500,more than downpayment,more than downpayment,0,3900
Gu5qhPk6,3900,12/6/2019,9900,Gu5qhPk6,29400,more than downpayment,more than downpayment,0,3900
Gu5qhPk6,3900,1/15/2020,9900,Gu5qhPk6,33300,more than downpayment,more than downpayment,0,3900
Gu5qhPk6,3900,2/9/2020,9900,Gu5qhPk6,37200,more than downpayment,more than downpayment,0,3900
Gu8Khfi6,8900,1/22/2019,8900,,8900,equal to downpayment,,8900,0
Gu8Khfi6,12000,6/27/2019,8900,Gu8Khfi6,20900,more than downpayment,equal to downpayment,0,12000
Gu8Khfi6,3600,7/12/2019,8900,Gu8Khfi6,24500,more than downpayment,more than downpayment,0,3600
Gu8Khfi6,4000,8/12/2019,8900,Gu8Khfi6,28500,more than downpayment,more than downpayment,0,4000
GUAV9KRQ,2500,7/29/2019,8900,,2500,less than downpayment,,2500,0
gUwCIBsn,8900,3/6/2019,8900,,8900,equal to downpayment,,8900,0
gUwCIBsn,4000,4/16/2019,8900,gUwCIBsn,12900,more than downpayment,equal to downpayment,0,4000
gUwCIBsn,4000,6/24/2019,8900,gUwCIBsn,16900,more than downpayment,more than downpayment,0,4000
gUwCIBsn,7000,10/18/2019,8900,gUwCIBsn,23900,more than downpayment,more than downpayment,0,7000
gUwCIBsn,8000,11/25/2019,8900,gUwCIBsn,31900,more than downpayment,more than downpayment,0,8000
gUwCIBsn,6000,1/13/2020,8900,gUwCIBsn,37900,more than downpayment,more than downpayment,0,6000
GUWEVW31,9900,9/19/2019,9900,,9900,equal to downpayment,,9900,0
GUWEVW31,2000,11/26/2019,9900,GUWEVW31,11900,more than downpayment,equal to downpayment,0,2000
GUWEVW31,5600,12/10/2019,9900,GUWEVW31,17500,more than downpayment,more than downpayment,0,5600
GUWEVW31,200,12/14/2019,9900,GUWEVW31,17700,more than downpayment,more than downpayment,0,200
GUWEVW31,3900,1/10/2020,9900,GUWEVW31,21600,more than downpayment,more than downpayment,0,3900
gvMEWVyo,8900,2/9/2019,8900,,8900,equal to downpayment,,8900,0
gvMEWVyo,3900,3/14/2019,8900,gvMEWVyo,12800,more than downpayment,equal to downpayment,0,3900
gvMEWVyo,3900,4/15/2019,8900,gvMEWVyo,16700,more than downpayment,more than downpayment,0,3900
gvMEWVyo,3900,5/15/2019,8900,gvMEWVyo,20600,more than downpayment,more than downpayment,0,3900
gvMEWVyo,3900,6/15/2019,8900,gvMEWVyo,24500,more than downpayment,more than downpayment,0,3900
gvMEWVyo,3900,7/15/2019,8900,gvMEWVyo,28400,more than downpayment,more than downpayment,0,3900
gvMEWVyo,3900,8/15/2019,8900,gvMEWVyo,32300,more than downpayment,more than downpayment,0,3900
gvMEWVyo,3900,9/15/2019,8900,gvMEWVyo,36200,more than downpayment,more than downpayment,0,3900
gvMEWVyo,3900,10/16/2019,8900,gvMEWVyo,40100,more than downpayment,more than downpayment,0,3900
gvMEWVyo,3900,12/2/2019,8900,gvMEWVyo,44000,more than downpayment,more than downpayment,0,3900
gvMEWVyo,3900,12/25/2019,8900,gvMEWVyo,47900,more than downpayment,more than downpayment,0,3900
gvMEWVyo,3900,1/15/2020,8900,gvMEWVyo,51800,more than downpayment,more than downpayment,0,3900
GVPqiZhK,9900,7/5/2019,9900,,9900,equal to downpayment,,9900,0
GVPqiZhK,4500,8/10/2019,9900,GVPqiZhK,14400,more than downpayment,equal to downpayment,0,4500
GVPqiZhK,3900,8/27/2019,9900,GVPqiZhK,18300,more than downpayment,more than downpayment,0,3900
GVPqiZhK,3900,9/21/2019,9900,GVPqiZhK,22200,more than downpayment,more than downpayment,0,3900
GVPqiZhK,450,11/16/2019,9900,GVPqiZhK,22650,more than downpayment,more than downpayment,0,450
GVPqiZhK,3900,11/27/2019,9900,GVPqiZhK,26550,more than downpayment,more than downpayment,0,3900
GVPqiZhK,3900,12/27/2019,9900,GVPqiZhK,30450,more than downpayment,more than downpayment,0,3900
GVPqiZhK,2850,1/29/2020,9900,GVPqiZhK,33300,more than downpayment,more than downpayment,0,2850
GVWS2XXW,9900,8/7/2019,9900,,9900,equal to downpayment,,9900,0
GVWS2XXW,3900,10/5/2019,9900,GVWS2XXW,13800,more than downpayment,equal to downpayment,0,3900
GVWS2XXW,3900,11/5/2019,9900,GVWS2XXW,17700,more than downpayment,more than downpayment,0,3900
GVWS2XXW,3900,12/6/2019,9900,GVWS2XXW,21600,more than downpayment,more than downpayment,0,3900
GVWS2XXW,3900,1/7/2020,9900,GVWS2XXW,25500,more than downpayment,more than downpayment,0,3900
GVWS2XXW,3900,2/6/2020,9900,GVWS2XXW,29400,more than downpayment,more than downpayment,0,3900
GvxCRL3q,10000,9/18/2017,10000,,10000,equal to downpayment,,10000,0
GvxCRL3q,3500,11/6/2017,10000,GvxCRL3q,13500,more than downpayment,equal to downpayment,0,3500
GvxCRL3q,4775,12/13/2017,10000,GvxCRL3q,18275,more than downpayment,more than downpayment,0,4775
GvxCRL3q,3500,1/8/2018,10000,GvxCRL3q,21775,more than downpayment,more than downpayment,0,3500
GvxCRL3q,3500,2/16/2018,10000,GvxCRL3q,25275,more than downpayment,more than downpayment,0,3500
GvxCRL3q,3500,3/23/2018,10000,GvxCRL3q,28775,more than downpayment,more than downpayment,0,3500
GvxCRL3q,3500,4/16/2018,10000,GvxCRL3q,32275,more than downpayment,more than downpayment,0,3500
GvxCRL3q,3500,5/12/2018,10000,GvxCRL3q,35775,more than downpayment,more than downpayment,0,3500
GvxCRL3q,3500,6/17/2018,10000,GvxCRL3q,39275,more than downpayment,more than downpayment,0,3500
GvxCRL3q,3500,7/12/2018,10000,GvxCRL3q,42775,more than downpayment,more than downpayment,0,3500
GvxCRL3q,3500,8/4/2018,10000,GvxCRL3q,46275,more than downpayment,more than downpayment,0,3500
GvxCRL3q,2500,9/10/2018,10000,GvxCRL3q,48775,more than downpayment,more than downpayment,0,2500
GvxCRL3q,2000,11/16/2018,10000,GvxCRL3q,50775,more than downpayment,more than downpayment,0,2000
GvxCRL3q,625,2/13/2019,10000,GvxCRL3q,51400,more than downpayment,more than downpayment,0,625
GvxCRL3q,600,9/4/2019,10000,GvxCRL3q,52000,more than downpayment,more than downpayment,0,600
gWd00GtN,2000,6/27/2019,1999,,2000,more than downpayment,,1999,1
gWd00GtN,2000,8/28/2019,1999,gWd00GtN,4000,more than downpayment,more than downpayment,0,2000
gWd00GtN,2000,9/24/2019,1999,gWd00GtN,6000,more than downpayment,more than downpayment,0,2000
gWd00GtN,2000,10/31/2019,1999,gWd00GtN,8000,more than downpayment,more than downpayment,0,2000
gWd00GtN,4000,11/29/2019,1999,gWd00GtN,12000,more than downpayment,more than downpayment,0,4000
gWd00GtN,2000,1/24/2020,1999,gWd00GtN,14000,more than downpayment,more than downpayment,0,2000
GWNP56A3,9900,1/3/2020,9900,,9900,equal to downpayment,,9900,0
GYLHBY9U,1594,10/14/2019,9900,,1594,less than downpayment,,1594,0
GYLHBY9U,8306,10/17/2019,9900,GYLHBY9U,9900,equal to downpayment,less than downpayment,8306,0
GYLHBY9U,5000,12/10/2019,9900,GYLHBY9U,14900,more than downpayment,equal to downpayment,0,5000
GYLHBY9U,5000,1/23/2020,9900,GYLHBY9U,19900,more than downpayment,more than downpayment,0,5000
GyVYXrvN,10000,1/28/2018,10000,,10000,equal to downpayment,,10000,0
GyVYXrvN,2000,2/10/2018,10000,GyVYXrvN,12000,more than downpayment,equal to downpayment,0,2000
GyVYXrvN,2500,2/17/2018,10000,GyVYXrvN,14500,more than downpayment,more than downpayment,0,2500
GyVYXrvN,2000,2/24/2018,10000,GyVYXrvN,16500,more than downpayment,more than downpayment,0,2000
GyVYXrvN,2000,3/3/2018,10000,GyVYXrvN,18500,more than downpayment,more than downpayment,0,2000
GyVYXrvN,1500,3/10/2018,10000,GyVYXrvN,20000,more than downpayment,more than downpayment,0,1500
GyVYXrvN,2500,3/17/2018,10000,GyVYXrvN,22500,more than downpayment,more than downpayment,0,2500
GyVYXrvN,2500,3/24/2018,10000,GyVYXrvN,25000,more than downpayment,more than downpayment,0,2500
GyVYXrvN,2500,3/31/2018,10000,GyVYXrvN,27500,more than downpayment,more than downpayment,0,2500
GyVYXrvN,1500,4/28/2018,10000,GyVYXrvN,29000,more than downpayment,more than downpayment,0,1500
GyVYXrvN,3000,5/13/2018,10000,GyVYXrvN,32000,more than downpayment,more than downpayment,0,3000
GyVYXrvN,2000,5/19/2018,10000,GyVYXrvN,34000,more than downpayment,more than downpayment,0,2000
GyVYXrvN,3000,6/16/2018,10000,GyVYXrvN,37000,more than downpayment,more than downpayment,0,3000
GyVYXrvN,1500,6/25/2018,10000,GyVYXrvN,38500,more than downpayment,more than downpayment,0,1500
GyVYXrvN,2500,7/12/2018,10000,GyVYXrvN,41000,more than downpayment,more than downpayment,0,2500
GyVYXrvN,2000,7/15/2018,10000,GyVYXrvN,43000,more than downpayment,more than downpayment,0,2000
GyVYXrvN,4500,7/25/2018,10000,GyVYXrvN,47500,more than downpayment,more than downpayment,0,4500
GyVYXrvN,2500,7/28/2018,10000,GyVYXrvN,50000,more than downpayment,more than downpayment,0,2500
GyVYXrvN,2000,9/2/2018,10000,GyVYXrvN,52000,more than downpayment,more than downpayment,0,2000
GyVYXrvN,5000,9/7/2018,10000,GyVYXrvN,57000,more than downpayment,more than downpayment,0,5000
GyVYXrvN,7000,9/20/2018,10000,GyVYXrvN,64000,more than downpayment,more than downpayment,0,7000
gYZ2oSMQ,8900,7/17/2019,8900,,8900,equal to downpayment,,8900,0
gYZ2oSMQ,3900,9/4/2019,8900,gYZ2oSMQ,12800,more than downpayment,equal to downpayment,0,3900
gYZ2oSMQ,3900,10/11/2019,8900,gYZ2oSMQ,16700,more than downpayment,more than downpayment,0,3900
gYZ2oSMQ,3900,11/1/2019,8900,gYZ2oSMQ,20600,more than downpayment,more than downpayment,0,3900
gYZ2oSMQ,7800,12/28/2019,8900,gYZ2oSMQ,28400,more than downpayment,more than downpayment,0,7800
gzLEE3KV,9900,7/5/2019,9900,,9900,equal to downpayment,,9900,0
gzLEE3KV,3900,8/30/2019,9900,gzLEE3KV,13800,more than downpayment,equal to downpayment,0,3900
gzLEE3KV,3900,9/6/2019,9900,gzLEE3KV,17700,more than downpayment,more than downpayment,0,3900
gzLEE3KV,3900,10/11/2019,9900,gzLEE3KV,21600,more than downpayment,more than downpayment,0,3900
gzLEE3KV,3900,1/17/2020,9900,gzLEE3KV,25500,more than downpayment,more than downpayment,0,3900
gzLEE3KV,3900,1/28/2020,9900,gzLEE3KV,29400,more than downpayment,more than downpayment,0,3900
gzLEE3KV,3900,2/5/2020,9900,gzLEE3KV,33300,more than downpayment,more than downpayment,0,3900
GzMwEhSR,8900,1/28/2020,8900,,8900,equal to downpayment,,8900,0
GZO1FIZP,1000,8/17/2019,9900,,1000,less than downpayment,,1000,0
GZO1FIZP,1500,8/23/2019,9900,GZO1FIZP,2500,less than downpayment,less than downpayment,1500,0
GZO1FIZP,7400,11/11/2019,9900,GZO1FIZP,9900,equal to downpayment,less than downpayment,7400,0
GZO1FIZP,2000,2/5/2020,9900,GZO1FIZP,11900,more than downpayment,equal to downpayment,0,2000
H1CTH3E7,9900,12/31/2019,9900,,9900,equal to downpayment,,9900,0
h1poCbda,9900,7/11/2019,9900,,9900,equal to downpayment,,9900,0
h1poCbda,3900,10/24/2019,9900,h1poCbda,13800,more than downpayment,equal to downpayment,0,3900
h1poCbda,3900,11/25/2019,9900,h1poCbda,17700,more than downpayment,more than downpayment,0,3900
h1poCbda,3900,12/30/2019,9900,h1poCbda,21600,more than downpayment,more than downpayment,0,3900
h1poCbda,3900,1/25/2020,9900,h1poCbda,25500,more than downpayment,more than downpayment,0,3900
h27UlohY,9900,7/10/2019,9900,,9900,equal to downpayment,,9900,0
h27UlohY,3900,8/23/2019,9900,h27UlohY,13800,more than downpayment,equal to downpayment,0,3900
h27UlohY,4000,9/21/2019,9900,h27UlohY,17800,more than downpayment,more than downpayment,0,4000
h27UlohY,3900,10/22/2019,9900,h27UlohY,21700,more than downpayment,more than downpayment,0,3900
h27UlohY,7800,11/22/2019,9900,h27UlohY,29500,more than downpayment,more than downpayment,0,7800
h27UlohY,3900,1/21/2020,9900,h27UlohY,33400,more than downpayment,more than downpayment,0,3900
H2UJ1XA1,9900,1/25/2020,9900,,9900,equal to downpayment,,9900,0
H39WPRYF,9900,2/5/2020,9900,,9900,equal to downpayment,,9900,0
h3Pj4oJ3,8900,4/7/2019,8900,,8900,equal to downpayment,,8900,0
h3Pj4oJ3,3900,5/19/2019,8900,h3Pj4oJ3,12800,more than downpayment,equal to downpayment,0,3900
h3Pj4oJ3,1000,6/25/2019,8900,h3Pj4oJ3,13800,more than downpayment,more than downpayment,0,1000
h3Pj4oJ3,2900,7/4/2019,8900,h3Pj4oJ3,16700,more than downpayment,more than downpayment,0,2900
h3Pj4oJ3,3900,8/1/2019,8900,h3Pj4oJ3,20600,more than downpayment,more than downpayment,0,3900
h3Pj4oJ3,3900,8/16/2019,8900,h3Pj4oJ3,24500,more than downpayment,more than downpayment,0,3900
h3Pj4oJ3,3900,9/30/2019,8900,h3Pj4oJ3,28400,more than downpayment,more than downpayment,0,3900
h3Pj4oJ3,3900,11/1/2019,8900,h3Pj4oJ3,32300,more than downpayment,more than downpayment,0,3900
h3Pj4oJ3,3900,12/4/2019,8900,h3Pj4oJ3,36200,more than downpayment,more than downpayment,0,3900
h3Pj4oJ3,3900,1/7/2020,8900,h3Pj4oJ3,40100,more than downpayment,more than downpayment,0,3900
h3Pj4oJ3,3900,1/27/2020,8900,h3Pj4oJ3,44000,more than downpayment,more than downpayment,0,3900
H3zt113x,8900,1/18/2019,9900,,8900,less than downpayment,,8900,0
H3zt113x,3900,3/8/2019,9900,H3zt113x,12800,more than downpayment,less than downpayment,1000,2900
H3zt113x,2900,4/8/2019,9900,H3zt113x,15700,more than downpayment,more than downpayment,0,2900
H3zt113x,1000,4/14/2019,9900,H3zt113x,16700,more than downpayment,more than downpayment,0,1000
H3zt113x,3900,5/10/2019,9900,H3zt113x,20600,more than downpayment,more than downpayment,0,3900
H3zt113x,980,6/10/2019,9900,H3zt113x,21580,more than downpayment,more than downpayment,0,980
H3zt113x,2920,6/20/2019,9900,H3zt113x,24500,more than downpayment,more than downpayment,0,2920
H3zt113x,3900,7/4/2019,9900,H3zt113x,28400,more than downpayment,more than downpayment,0,3900
H3zt113x,2000,8/13/2019,9900,H3zt113x,30400,more than downpayment,more than downpayment,0,2000
H3zt113x,1900,8/20/2019,9900,H3zt113x,32300,more than downpayment,more than downpayment,0,1900
H3zt113x,2968,9/5/2019,9900,H3zt113x,35268,more than downpayment,more than downpayment,0,2968
H3zt113x,932,9/18/2019,9900,H3zt113x,36200,more than downpayment,more than downpayment,0,932
H3zt113x,3900,10/8/2019,9900,H3zt113x,40100,more than downpayment,more than downpayment,0,3900
H3zt113x,4900,11/8/2019,9900,H3zt113x,45000,more than downpayment,more than downpayment,0,4900
H3zt113x,1900,12/10/2019,9900,H3zt113x,46900,more than downpayment,more than downpayment,0,1900
H3zt113x,2000,12/20/2019,9900,H3zt113x,48900,more than downpayment,more than downpayment,0,2000
H3zt113x,2000,1/9/2020,9900,H3zt113x,50900,more than downpayment,more than downpayment,0,2000
H3zt113x,1900,1/20/2020,9900,H3zt113x,52800,more than downpayment,more than downpayment,0,1900
H3zt113x,1000,2/7/2020,9900,H3zt113x,53800,more than downpayment,more than downpayment,0,1000
H4LA5FY7,9900,1/3/2020,9900,,9900,equal to downpayment,,9900,0
H5MAP1NK,8900,10/4/2019,8900,,8900,equal to downpayment,,8900,0
H5MAP1NK,2500,11/28/2019,8900,H5MAP1NK,11400,more than downpayment,equal to downpayment,0,2500
H5MAP1NK,1400,11/29/2019,8900,H5MAP1NK,12800,more than downpayment,more than downpayment,0,1400
H5MAP1NK,2250,12/31/2019,8900,H5MAP1NK,15050,more than downpayment,more than downpayment,0,2250
H5MAP1NK,1650,1/9/2020,8900,H5MAP1NK,16700,more than downpayment,more than downpayment,0,1650
H5MAP1NK,3900,1/27/2020,8900,H5MAP1NK,20600,more than downpayment,more than downpayment,0,3900
H6H27MGV,9900,1/28/2020,9900,,9900,equal to downpayment,,9900,0
H6S4LZLP,8900,5/30/2019,8900,,8900,equal to downpayment,,8900,0
H6S4LZLP,500,6/26/2019,8900,H6S4LZLP,9400,more than downpayment,equal to downpayment,0,500
H6S4LZLP,500,6/27/2019,8900,H6S4LZLP,9900,more than downpayment,more than downpayment,0,500
H6S4LZLP,1600,7/10/2019,8900,H6S4LZLP,11500,more than downpayment,more than downpayment,0,1600
H6S4LZLP,1000,7/16/2019,8900,H6S4LZLP,12500,more than downpayment,more than downpayment,0,1000
H6S4LZLP,500,7/25/2019,8900,H6S4LZLP,13000,more than downpayment,more than downpayment,0,500
H6S4LZLP,800,8/8/2019,8900,H6S4LZLP,13800,more than downpayment,more than downpayment,0,800
H6S4LZLP,1000,8/11/2019,8900,H6S4LZLP,14800,more than downpayment,more than downpayment,0,1000
H6S4LZLP,1900,8/15/2019,8900,H6S4LZLP,16700,more than downpayment,more than downpayment,0,1900
H6S4LZLP,500,9/22/2019,8900,H6S4LZLP,17200,more than downpayment,more than downpayment,0,500
H6S4LZLP,200,9/23/2019,8900,H6S4LZLP,17400,more than downpayment,more than downpayment,0,200
H6S4LZLP,700,9/25/2019,8900,H6S4LZLP,18100,more than downpayment,more than downpayment,0,700
H6S4LZLP,500,9/29/2019,8900,H6S4LZLP,18600,more than downpayment,more than downpayment,0,500
H6S4LZLP,400,10/5/2019,8900,H6S4LZLP,19000,more than downpayment,more than downpayment,0,400
H6S4LZLP,450,10/7/2019,8900,H6S4LZLP,19450,more than downpayment,more than downpayment,0,450
H6S4LZLP,500,10/9/2019,8900,H6S4LZLP,19950,more than downpayment,more than downpayment,0,500
H6S4LZLP,700,10/15/2019,8900,H6S4LZLP,20650,more than downpayment,more than downpayment,0,700
H6S4LZLP,800,11/5/2019,8900,H6S4LZLP,21450,more than downpayment,more than downpayment,0,800
H6S4LZLP,700,11/6/2019,8900,H6S4LZLP,22150,more than downpayment,more than downpayment,0,700
H6S4LZLP,900,11/11/2019,8900,H6S4LZLP,23050,more than downpayment,more than downpayment,0,900
H6S4LZLP,1400,11/20/2019,8900,H6S4LZLP,24450,more than downpayment,more than downpayment,0,1400
H6S4LZLP,1200,11/22/2019,8900,H6S4LZLP,25650,more than downpayment,more than downpayment,0,1200
H6S4LZLP,3000,12/12/2019,8900,H6S4LZLP,28650,more than downpayment,more than downpayment,0,3000
H6usC2wC,8900,2/21/2019,8900,,8900,equal to downpayment,,8900,0
H6usC2wC,3900,3/23/2019,8900,H6usC2wC,12800,more than downpayment,equal to downpayment,0,3900
H6usC2wC,3900,4/26/2019,8900,H6usC2wC,16700,more than downpayment,more than downpayment,0,3900
H6usC2wC,3900,5/25/2019,8900,H6usC2wC,20600,more than downpayment,more than downpayment,0,3900
H6usC2wC,3900,6/25/2019,8900,H6usC2wC,24500,more than downpayment,more than downpayment,0,3900
H6usC2wC,5000,8/21/2019,8900,H6usC2wC,29500,more than downpayment,more than downpayment,0,5000
H6usC2wC,3900,9/27/2019,8900,H6usC2wC,33400,more than downpayment,more than downpayment,0,3900
H6usC2wC,3900,10/26/2019,8900,H6usC2wC,37300,more than downpayment,more than downpayment,0,3900
H6usC2wC,3800,12/3/2019,8900,H6usC2wC,41100,more than downpayment,more than downpayment,0,3800
H6usC2wC,3000,1/7/2020,8900,H6usC2wC,44100,more than downpayment,more than downpayment,0,3000
H6usC2wC,3900,1/22/2020,8900,H6usC2wC,48000,more than downpayment,more than downpayment,0,3900
H72IW7VI,9900,11/1/2019,9900,,9900,equal to downpayment,,9900,0
H72IW7VI,4000,12/11/2019,9900,H72IW7VI,13900,more than downpayment,equal to downpayment,0,4000
H72IW7VI,3900,1/11/2020,9900,H72IW7VI,17800,more than downpayment,more than downpayment,0,3900
H72IW7VI,3900,2/9/2020,9900,H72IW7VI,21700,more than downpayment,more than downpayment,0,3900
H7nooMwj,30000,1/11/2019,10000,,30000,more than downpayment,,10000,20000
H7nooMwj,2000,4/4/2019,10000,H7nooMwj,32000,more than downpayment,more than downpayment,0,2000
H7nooMwj,1000,4/14/2019,10000,H7nooMwj,33000,more than downpayment,more than downpayment,0,1000
H7nooMwj,3500,5/12/2019,10000,H7nooMwj,36500,more than downpayment,more than downpayment,0,3500
H7nooMwj,1000,10/18/2019,10000,H7nooMwj,37500,more than downpayment,more than downpayment,0,1000
H7nooMwj,5000,1/3/2020,10000,H7nooMwj,42500,more than downpayment,more than downpayment,0,5000
H7nooMwj,3000,1/11/2020,10000,H7nooMwj,45500,more than downpayment,more than downpayment,0,3000
H7OYBNWK,9200,6/18/2019,8900,,9200,more than downpayment,,8900,300
H7OYBNWK,700,6/20/2019,8900,H7OYBNWK,9900,more than downpayment,more than downpayment,0,700
H7OYBNWK,3900,7/29/2019,8900,H7OYBNWK,13800,more than downpayment,more than downpayment,0,3900
H7OYBNWK,3900,8/30/2019,8900,H7OYBNWK,17700,more than downpayment,more than downpayment,0,3900
H7OYBNWK,2900,11/7/2019,8900,H7OYBNWK,20600,more than downpayment,more than downpayment,0,2900
H7OYBNWK,3900,11/30/2019,8900,H7OYBNWK,24500,more than downpayment,more than downpayment,0,3900
H7OYBNWK,1000,12/5/2019,8900,H7OYBNWK,25500,more than downpayment,more than downpayment,0,1000
H7OYBNWK,2900,12/25/2019,8900,H7OYBNWK,28400,more than downpayment,more than downpayment,0,2900
H7OYBNWK,3900,1/6/2020,8900,H7OYBNWK,32300,more than downpayment,more than downpayment,0,3900
H9KGV1CK,9900,7/8/2019,9900,,9900,equal to downpayment,,9900,0
H9KGV1CK,4000,8/17/2019,9900,H9KGV1CK,13900,more than downpayment,equal to downpayment,0,4000
H9KGV1CK,1000,11/7/2019,9900,H9KGV1CK,14900,more than downpayment,more than downpayment,0,1000
H9KGV1CK,1000,12/4/2019,9900,H9KGV1CK,15900,more than downpayment,more than downpayment,0,1000
H9KGV1CK,4000,1/21/2020,9900,H9KGV1CK,19900,more than downpayment,more than downpayment,0,4000
h9wRZkyF,8900,8/20/2019,8900,,8900,equal to downpayment,,8900,0
h9wRZkyF,3900,10/16/2019,8900,h9wRZkyF,12800,more than downpayment,equal to downpayment,0,3900
h9wRZkyF,3900,11/29/2019,8900,h9wRZkyF,16700,more than downpayment,more than downpayment,0,3900
h9wRZkyF,3900,1/14/2020,8900,h9wRZkyF,20600,more than downpayment,more than downpayment,0,3900
h9wRZkyF,1000,1/31/2020,8900,h9wRZkyF,21600,more than downpayment,more than downpayment,0,1000
h9wRZkyF,500,2/7/2020,8900,h9wRZkyF,22100,more than downpayment,more than downpayment,0,500
HARY09oW,8900,12/31/2018,8900,,8900,equal to downpayment,,8900,0
HARY09oW,4000,2/12/2019,8900,HARY09oW,12900,more than downpayment,equal to downpayment,0,4000
HARY09oW,4000,3/9/2019,8900,HARY09oW,16900,more than downpayment,more than downpayment,0,4000
HARY09oW,4000,4/1/2019,8900,HARY09oW,20900,more than downpayment,more than downpayment,0,4000
HARY09oW,4000,5/8/2019,8900,HARY09oW,24900,more than downpayment,more than downpayment,0,4000
HARY09oW,4000,6/10/2019,8900,HARY09oW,28900,more than downpayment,more than downpayment,0,4000
HARY09oW,4000,7/3/2019,8900,HARY09oW,32900,more than downpayment,more than downpayment,0,4000
HARY09oW,4000,8/12/2019,8900,HARY09oW,36900,more than downpayment,more than downpayment,0,4000
HARY09oW,4000,9/4/2019,8900,HARY09oW,40900,more than downpayment,more than downpayment,0,4000
HARY09oW,4000,10/8/2019,8900,HARY09oW,44900,more than downpayment,more than downpayment,0,4000
HARY09oW,4000,11/8/2019,8900,HARY09oW,48900,more than downpayment,more than downpayment,0,4000
HARY09oW,4000,12/9/2019,8900,HARY09oW,52900,more than downpayment,more than downpayment,0,4000
HARY09oW,4000,1/7/2020,8900,HARY09oW,56900,more than downpayment,more than downpayment,0,4000
HARY09oW,4000,2/7/2020,8900,HARY09oW,60900,more than downpayment,more than downpayment,0,4000
HB1A9bjh,8900,7/1/2019,8900,,8900,equal to downpayment,,8900,0
HB1A9bjh,3900,8/5/2019,8900,HB1A9bjh,12800,more than downpayment,equal to downpayment,0,3900
HB1A9bjh,3900,9/2/2019,8900,HB1A9bjh,16700,more than downpayment,more than downpayment,0,3900
HB1A9bjh,3900,10/4/2019,8900,HB1A9bjh,20600,more than downpayment,more than downpayment,0,3900
HB1A9bjh,3900,11/19/2019,8900,HB1A9bjh,24500,more than downpayment,more than downpayment,0,3900
HB1A9bjh,3900,12/26/2019,8900,HB1A9bjh,28400,more than downpayment,more than downpayment,0,3900
HB1A9bjh,3900,1/31/2020,8900,HB1A9bjh,32300,more than downpayment,more than downpayment,0,3900
HB1A9bjh,3900,2/7/2020,8900,HB1A9bjh,36200,more than downpayment,more than downpayment,0,3900
HBCE8QUE,9900,10/10/2019,9900,,9900,equal to downpayment,,9900,0
HBCE8QUE,3900,12/4/2019,9900,HBCE8QUE,13800,more than downpayment,equal to downpayment,0,3900
HBCE8QUE,3900,1/5/2020,9900,HBCE8QUE,17700,more than downpayment,more than downpayment,0,3900
HBCE8QUE,3900,2/5/2020,9900,HBCE8QUE,21600,more than downpayment,more than downpayment,0,3900
HboG4H2r,10000,8/31/2018,10000,,10000,equal to downpayment,,10000,0
HboG4H2r,4500,10/5/2018,10000,HboG4H2r,14500,more than downpayment,equal to downpayment,0,4500
HboG4H2r,4500,11/5/2018,10000,HboG4H2r,19000,more than downpayment,more than downpayment,0,4500
HboG4H2r,4500,12/5/2018,10000,HboG4H2r,23500,more than downpayment,more than downpayment,0,4500
HboG4H2r,4500,1/5/2019,10000,HboG4H2r,28000,more than downpayment,more than downpayment,0,4500
HboG4H2r,4500,2/6/2019,10000,HboG4H2r,32500,more than downpayment,more than downpayment,0,4500
HboG4H2r,4500,3/5/2019,10000,HboG4H2r,37000,more than downpayment,more than downpayment,0,4500
HboG4H2r,4500,4/5/2019,10000,HboG4H2r,41500,more than downpayment,more than downpayment,0,4500
HboG4H2r,4500,5/7/2019,10000,HboG4H2r,46000,more than downpayment,more than downpayment,0,4500
HboG4H2r,4500,6/7/2019,10000,HboG4H2r,50500,more than downpayment,more than downpayment,0,4500
HboG4H2r,4500,7/9/2019,10000,HboG4H2r,55000,more than downpayment,more than downpayment,0,4500
HboG4H2r,4500,8/7/2019,10000,HboG4H2r,59500,more than downpayment,more than downpayment,0,4500
HboG4H2r,4500,9/9/2019,10000,HboG4H2r,64000,more than downpayment,more than downpayment,0,4500
HbPwZ5Hb,8900,2/15/2019,8900,,8900,equal to downpayment,,8900,0
HbPwZ5Hb,3900,4/5/2019,8900,HbPwZ5Hb,12800,more than downpayment,equal to downpayment,0,3900
HbPwZ5Hb,3900,5/6/2019,8900,HbPwZ5Hb,16700,more than downpayment,more than downpayment,0,3900
HbPwZ5Hb,3900,6/5/2019,8900,HbPwZ5Hb,20600,more than downpayment,more than downpayment,0,3900
HbPwZ5Hb,3900,7/4/2019,8900,HbPwZ5Hb,24500,more than downpayment,more than downpayment,0,3900
HbPwZ5Hb,3900,8/5/2019,8900,HbPwZ5Hb,28400,more than downpayment,more than downpayment,0,3900
HbPwZ5Hb,3900,9/4/2019,8900,HbPwZ5Hb,32300,more than downpayment,more than downpayment,0,3900
HbPwZ5Hb,3900,10/5/2019,8900,HbPwZ5Hb,36200,more than downpayment,more than downpayment,0,3900
HbPwZ5Hb,3900,11/5/2019,8900,HbPwZ5Hb,40100,more than downpayment,more than downpayment,0,3900
HbPwZ5Hb,3900,12/5/2019,8900,HbPwZ5Hb,44000,more than downpayment,more than downpayment,0,3900
HbPwZ5Hb,3900,1/5/2020,8900,HbPwZ5Hb,47900,more than downpayment,more than downpayment,0,3900
HbPwZ5Hb,3900,2/5/2020,8900,HbPwZ5Hb,51800,more than downpayment,more than downpayment,0,3900
hbzaGGXf,8900,3/13/2019,8900,,8900,equal to downpayment,,8900,0
hbzaGGXf,3900,4/30/2019,8900,hbzaGGXf,12800,more than downpayment,equal to downpayment,0,3900
hbzaGGXf,3900,6/2/2019,8900,hbzaGGXf,16700,more than downpayment,more than downpayment,0,3900
hbzaGGXf,3900,7/2/2019,8900,hbzaGGXf,20600,more than downpayment,more than downpayment,0,3900
hbzaGGXf,3900,8/3/2019,8900,hbzaGGXf,24500,more than downpayment,more than downpayment,0,3900
hbzaGGXf,3900,9/4/2019,8900,hbzaGGXf,28400,more than downpayment,more than downpayment,0,3900
hbzaGGXf,3900,10/2/2019,8900,hbzaGGXf,32300,more than downpayment,more than downpayment,0,3900
hbzaGGXf,3900,11/2/2019,8900,hbzaGGXf,36200,more than downpayment,more than downpayment,0,3900
hbzaGGXf,3900,12/4/2019,8900,hbzaGGXf,40100,more than downpayment,more than downpayment,0,3900
hbzaGGXf,3900,1/4/2020,8900,hbzaGGXf,44000,more than downpayment,more than downpayment,0,3900
hbzaGGXf,3900,2/4/2020,8900,hbzaGGXf,47900,more than downpayment,more than downpayment,0,3900
hCs9XY5v,9900,6/10/2019,9900,,9900,equal to downpayment,,9900,0
hCs9XY5v,3900,7/23/2019,9900,hCs9XY5v,13800,more than downpayment,equal to downpayment,0,3900
hCs9XY5v,3900,8/22/2019,9900,hCs9XY5v,17700,more than downpayment,more than downpayment,0,3900
hCs9XY5v,3900,9/19/2019,9900,hCs9XY5v,21600,more than downpayment,more than downpayment,0,3900
hCs9XY5v,3900,11/6/2019,9900,hCs9XY5v,25500,more than downpayment,more than downpayment,0,3900
hCs9XY5v,3900,12/4/2019,9900,hCs9XY5v,29400,more than downpayment,more than downpayment,0,3900
hCs9XY5v,3900,1/9/2020,9900,hCs9XY5v,33300,more than downpayment,more than downpayment,0,3900
hCs9XY5v,3900,1/25/2020,9900,hCs9XY5v,37200,more than downpayment,more than downpayment,0,3900
HCSWmpGp,8900,5/26/2019,8900,,8900,equal to downpayment,,8900,0
HCSWmpGp,4000,6/24/2019,8900,HCSWmpGp,12900,more than downpayment,equal to downpayment,0,4000
HCSWmpGp,3900,7/11/2019,8900,HCSWmpGp,16800,more than downpayment,more than downpayment,0,3900
HCSWmpGp,3900,8/17/2019,8900,HCSWmpGp,20700,more than downpayment,more than downpayment,0,3900
HCSWmpGp,3900,9/11/2019,8900,HCSWmpGp,24600,more than downpayment,more than downpayment,0,3900
HCSWmpGp,3900,10/11/2019,8900,HCSWmpGp,28500,more than downpayment,more than downpayment,0,3900
HCSWmpGp,3900,11/22/2019,8900,HCSWmpGp,32400,more than downpayment,more than downpayment,0,3900
HCSWmpGp,3900,12/19/2019,8900,HCSWmpGp,36300,more than downpayment,more than downpayment,0,3900
HCSWmpGp,3900,1/16/2020,8900,HCSWmpGp,40200,more than downpayment,more than downpayment,0,3900
HEaQAPG5,9900,1/21/2019,9900,,9900,equal to downpayment,,9900,0
HEaQAPG5,4500,2/25/2019,9900,HEaQAPG5,14400,more than downpayment,equal to downpayment,0,4500
HEaQAPG5,4500,3/24/2019,9900,HEaQAPG5,18900,more than downpayment,more than downpayment,0,4500
HEaQAPG5,4500,4/25/2019,9900,HEaQAPG5,23400,more than downpayment,more than downpayment,0,4500
HEaQAPG5,4500,5/25/2019,9900,HEaQAPG5,27900,more than downpayment,more than downpayment,0,4500
HEaQAPG5,4500,6/25/2019,9900,HEaQAPG5,32400,more than downpayment,more than downpayment,0,4500
HEaQAPG5,3900,7/25/2019,9900,HEaQAPG5,36300,more than downpayment,more than downpayment,0,3900
HEaQAPG5,1040,8/5/2019,9900,HEaQAPG5,37340,more than downpayment,more than downpayment,0,1040
HEaQAPG5,4500,8/29/2019,9900,HEaQAPG5,41840,more than downpayment,more than downpayment,0,4500
HEaQAPG5,4500,9/25/2019,9900,HEaQAPG5,46340,more than downpayment,more than downpayment,0,4500
HEaQAPG5,4500,10/31/2019,9900,HEaQAPG5,50840,more than downpayment,more than downpayment,0,4500
HEaQAPG5,4500,11/25/2019,9900,HEaQAPG5,55340,more than downpayment,more than downpayment,0,4500
HEaQAPG5,4500,1/2/2020,9900,HEaQAPG5,59840,more than downpayment,more than downpayment,0,4500
HEaQAPG5,4500,1/29/2020,9900,HEaQAPG5,64340,more than downpayment,more than downpayment,0,4500
hepoaIAN,10000,12/4/2017,10000,,10000,equal to downpayment,,10000,0
hepoaIAN,40000,1/23/2018,10000,hepoaIAN,50000,more than downpayment,equal to downpayment,0,40000
hepoaIAN,2500,1/26/2018,10000,hepoaIAN,52500,more than downpayment,more than downpayment,0,2500
HEUVJN4G,1594,10/14/2019,1594,,1594,equal to downpayment,,1594,0
HEUVJN4G,3100,12/23/2019,1594,HEUVJN4G,4694,more than downpayment,equal to downpayment,0,3100
HEUVJN4G,3100,1/22/2020,1594,HEUVJN4G,7794,more than downpayment,more than downpayment,0,3100
HeyZpbNw,10000,11/6/2018,10000,,10000,equal to downpayment,,10000,0
HeyZpbNw,4500,12/17/2018,10000,HeyZpbNw,14500,more than downpayment,equal to downpayment,0,4500
HeyZpbNw,4300,1/21/2019,10000,HeyZpbNw,18800,more than downpayment,more than downpayment,0,4300
HeyZpbNw,200,1/28/2019,10000,HeyZpbNw,19000,more than downpayment,more than downpayment,0,200
HeyZpbNw,4500,2/15/2019,10000,HeyZpbNw,23500,more than downpayment,more than downpayment,0,4500
HeyZpbNw,4500,3/16/2019,10000,HeyZpbNw,28000,more than downpayment,more than downpayment,0,4500
HeyZpbNw,4500,5/3/2019,10000,HeyZpbNw,32500,more than downpayment,more than downpayment,0,4500
HeyZpbNw,4500,5/18/2019,10000,HeyZpbNw,37000,more than downpayment,more than downpayment,0,4500
HeyZpbNw,4500,7/4/2019,10000,HeyZpbNw,41500,more than downpayment,more than downpayment,0,4500
HeyZpbNw,4500,8/21/2019,10000,HeyZpbNw,46000,more than downpayment,more than downpayment,0,4500
HeyZpbNw,2000,10/17/2019,10000,HeyZpbNw,48000,more than downpayment,more than downpayment,0,2000
HeyZpbNw,2000,11/14/2019,10000,HeyZpbNw,50000,more than downpayment,more than downpayment,0,2000
HfaBzkaz,10000,3/25/2019,8900,,10000,more than downpayment,,8900,1100
HfaBzkaz,10000,4/24/2019,8900,HfaBzkaz,20000,more than downpayment,more than downpayment,0,10000
HfaBzkaz,10000,5/25/2019,8900,HfaBzkaz,30000,more than downpayment,more than downpayment,0,10000
HfaBzkaz,10000,6/25/2019,8900,HfaBzkaz,40000,more than downpayment,more than downpayment,0,10000
HfaBzkaz,10000,7/25/2019,8900,HfaBzkaz,50000,more than downpayment,more than downpayment,0,10000
HfaBzkaz,4000,8/26/2019,8900,HfaBzkaz,54000,more than downpayment,more than downpayment,0,4000
HfaBzkaz,3900,9/25/2019,8900,HfaBzkaz,57900,more than downpayment,more than downpayment,0,3900
HfaBzkaz,3900,11/25/2019,8900,HfaBzkaz,61800,more than downpayment,more than downpayment,0,3900
HfaBzkaz,3900,12/24/2019,8900,HfaBzkaz,65700,more than downpayment,more than downpayment,0,3900
HfaBzkaz,4000,1/25/2020,8900,HfaBzkaz,69700,more than downpayment,more than downpayment,0,4000
hFcTi41m,10000,9/23/2017,10000,,10000,equal to downpayment,,10000,0
hFcTi41m,10000,11/15/2017,10000,hFcTi41m,20000,more than downpayment,equal to downpayment,0,10000
hFcTi41m,10000,12/26/2017,10000,hFcTi41m,30000,more than downpayment,more than downpayment,0,10000
hFcTi41m,5000,3/1/2018,10000,hFcTi41m,35000,more than downpayment,more than downpayment,0,5000
hFcTi41m,4900,4/24/2018,10000,hFcTi41m,39900,more than downpayment,more than downpayment,0,4900
hFcTi41m,5100,5/22/2018,10000,hFcTi41m,45000,more than downpayment,more than downpayment,0,5100
HFGGDU73,9900,1/16/2020,9900,,9900,equal to downpayment,,9900,0
Hfvb60ad,8900,2/19/2019,8900,,8900,equal to downpayment,,8900,0
Hfvb60ad,4000,3/24/2019,8900,Hfvb60ad,12900,more than downpayment,equal to downpayment,0,4000
Hfvb60ad,4000,4/24/2019,8900,Hfvb60ad,16900,more than downpayment,more than downpayment,0,4000
Hfvb60ad,4000,5/22/2019,8900,Hfvb60ad,20900,more than downpayment,more than downpayment,0,4000
Hfvb60ad,4000,6/25/2019,8900,Hfvb60ad,24900,more than downpayment,more than downpayment,0,4000
Hfvb60ad,4000,7/24/2019,8900,Hfvb60ad,28900,more than downpayment,more than downpayment,0,4000
Hfvb60ad,3900,8/25/2019,8900,Hfvb60ad,32800,more than downpayment,more than downpayment,0,3900
Hfvb60ad,3900,9/25/2019,8900,Hfvb60ad,36700,more than downpayment,more than downpayment,0,3900
Hfvb60ad,4000,10/25/2019,8900,Hfvb60ad,40700,more than downpayment,more than downpayment,0,4000
Hfvb60ad,3900,11/25/2019,8900,Hfvb60ad,44600,more than downpayment,more than downpayment,0,3900
Hfvb60ad,3900,12/26/2019,8900,Hfvb60ad,48500,more than downpayment,more than downpayment,0,3900
Hfvb60ad,3900,1/26/2020,8900,Hfvb60ad,52400,more than downpayment,more than downpayment,0,3900
hg54z5tQ,10500,12/5/2017,10000,,10500,more than downpayment,,10000,500
hg54z5tQ,4500,1/23/2018,10000,hg54z5tQ,15000,more than downpayment,more than downpayment,0,4500
hg54z5tQ,3000,2/20/2018,10000,hg54z5tQ,18000,more than downpayment,more than downpayment,0,3000
hg54z5tQ,1500,2/25/2018,10000,hg54z5tQ,19500,more than downpayment,more than downpayment,0,1500
hg54z5tQ,4500,3/23/2018,10000,hg54z5tQ,24000,more than downpayment,more than downpayment,0,4500
hg54z5tQ,4000,4/12/2018,10000,hg54z5tQ,28000,more than downpayment,more than downpayment,0,4000
hg54z5tQ,500,4/25/2018,10000,hg54z5tQ,28500,more than downpayment,more than downpayment,0,500
hg54z5tQ,3000,5/9/2018,10000,hg54z5tQ,31500,more than downpayment,more than downpayment,0,3000
hg54z5tQ,1500,5/21/2018,10000,hg54z5tQ,33000,more than downpayment,more than downpayment,0,1500
hg54z5tQ,4567,3/12/2019,10000,hg54z5tQ,37567,more than downpayment,more than downpayment,0,4567
hg54z5tQ,3050,4/22/2019,10000,hg54z5tQ,40617,more than downpayment,more than downpayment,0,3050
HGk2faEu,8900,3/18/2019,8900,,8900,equal to downpayment,,8900,0
HGN1DSDZ,13800,10/17/2019,9900,,13800,more than downpayment,,9900,3900
HGN1DSDZ,7800,1/24/2020,9900,HGN1DSDZ,21600,more than downpayment,more than downpayment,0,7800
HGPUK2IL,8900,1/24/2020,8900,,8900,equal to downpayment,,8900,0
HH23IKM4,9900,11/11/2019,9900,,9900,equal to downpayment,,9900,0
HH23IKM4,8000,2/6/2020,9900,HH23IKM4,17900,more than downpayment,equal to downpayment,0,8000
HH3yKRCY,10000,8/16/2017,10000,,10000,equal to downpayment,,10000,0
HH3yKRCY,3500,9/19/2017,10000,HH3yKRCY,13500,more than downpayment,equal to downpayment,0,3500
HH3yKRCY,3500,10/10/2017,10000,HH3yKRCY,17000,more than downpayment,more than downpayment,0,3500
HH3yKRCY,3500,10/31/2017,10000,HH3yKRCY,20500,more than downpayment,more than downpayment,0,3500
HH3yKRCY,3500,11/14/2017,10000,HH3yKRCY,24000,more than downpayment,more than downpayment,0,3500
HH3yKRCY,3500,12/10/2017,10000,HH3yKRCY,27500,more than downpayment,more than downpayment,0,3500
HH3yKRCY,3500,1/9/2018,10000,HH3yKRCY,31000,more than downpayment,more than downpayment,0,3500
HH3yKRCY,3500,3/7/2018,10000,HH3yKRCY,34500,more than downpayment,more than downpayment,0,3500
HH3yKRCY,3500,4/13/2018,10000,HH3yKRCY,38000,more than downpayment,more than downpayment,0,3500
HH3yKRCY,3500,5/9/2018,10000,HH3yKRCY,41500,more than downpayment,more than downpayment,0,3500
HH3yKRCY,3500,6/4/2018,10000,HH3yKRCY,45000,more than downpayment,more than downpayment,0,3500
HH3yKRCY,3500,6/22/2018,10000,HH3yKRCY,48500,more than downpayment,more than downpayment,0,3500
HH3yKRCY,3500,8/20/2018,10000,HH3yKRCY,52000,more than downpayment,more than downpayment,0,3500
HhrYeemW,10000,11/12/2018,10000,,10000,equal to downpayment,,10000,0
HhrYeemW,4500,12/14/2018,10000,HhrYeemW,14500,more than downpayment,equal to downpayment,0,4500
HhrYeemW,4500,1/23/2019,10000,HhrYeemW,19000,more than downpayment,more than downpayment,0,4500
HhrYeemW,4500,2/22/2019,10000,HhrYeemW,23500,more than downpayment,more than downpayment,0,4500
HhrYeemW,4500,3/22/2019,10000,HhrYeemW,28000,more than downpayment,more than downpayment,0,4500
HhrYeemW,4500,4/25/2019,10000,HhrYeemW,32500,more than downpayment,more than downpayment,0,4500
HhrYeemW,4500,5/24/2019,10000,HhrYeemW,37000,more than downpayment,more than downpayment,0,4500
HhrYeemW,4500,7/1/2019,10000,HhrYeemW,41500,more than downpayment,more than downpayment,0,4500
HhrYeemW,4500,7/31/2019,10000,HhrYeemW,46000,more than downpayment,more than downpayment,0,4500
HhrYeemW,4500,10/31/2019,10000,HhrYeemW,50500,more than downpayment,more than downpayment,0,4500
HhrYeemW,9000,12/3/2019,10000,HhrYeemW,59500,more than downpayment,more than downpayment,0,9000
hIfgGg0a,10000,7/6/2017,10000,,10000,equal to downpayment,,10000,0
hIfgGg0a,10000,8/22/2017,10000,hIfgGg0a,20000,more than downpayment,equal to downpayment,0,10000
hIfgGg0a,4500,12/6/2017,10000,hIfgGg0a,24500,more than downpayment,more than downpayment,0,4500
hIfgGg0a,6000,2/15/2018,10000,hIfgGg0a,30500,more than downpayment,more than downpayment,0,6000
hIfgGg0a,4500,4/18/2018,10000,hIfgGg0a,35000,more than downpayment,more than downpayment,0,4500
hIfgGg0a,4500,5/18/2018,10000,hIfgGg0a,39500,more than downpayment,more than downpayment,0,4500
hIfgGg0a,4000,9/12/2018,10000,hIfgGg0a,43500,more than downpayment,more than downpayment,0,4000
hIfgGg0a,1500,10/31/2018,10000,hIfgGg0a,45000,more than downpayment,more than downpayment,0,1500
hIH0LNys,10000,11/16/2018,10000,,10000,equal to downpayment,,10000,0
hIH0LNys,4500,12/4/2018,10000,hIH0LNys,14500,more than downpayment,equal to downpayment,0,4500
hIH0LNys,4500,12/31/2018,10000,hIH0LNys,19000,more than downpayment,more than downpayment,0,4500
hIH0LNys,4500,2/14/2019,10000,hIH0LNys,23500,more than downpayment,more than downpayment,0,4500
hIH0LNys,5500,4/2/2019,10000,hIH0LNys,29000,more than downpayment,more than downpayment,0,5500
hIH0LNys,5500,5/2/2019,10000,hIH0LNys,34500,more than downpayment,more than downpayment,0,5500
hIH0LNys,5500,6/3/2019,10000,hIH0LNys,40000,more than downpayment,more than downpayment,0,5500
hIH0LNys,4500,8/2/2019,10000,hIH0LNys,44500,more than downpayment,more than downpayment,0,4500
hIH0LNys,5000,9/4/2019,10000,hIH0LNys,49500,more than downpayment,more than downpayment,0,5000
hIH0LNys,5000,10/3/2019,10000,hIH0LNys,54500,more than downpayment,more than downpayment,0,5000
hIH0LNys,5000,11/4/2019,10000,hIH0LNys,59500,more than downpayment,more than downpayment,0,5000
hIH0LNys,2000,1/3/2020,10000,hIH0LNys,61500,more than downpayment,more than downpayment,0,2000
hIHZmxEG,6000,10/5/2017,10000,,6000,less than downpayment,,6000,0
hIHZmxEG,4000,10/10/2017,10000,hIHZmxEG,10000,equal to downpayment,less than downpayment,4000,0
hIHZmxEG,2500,1/28/2018,10000,hIHZmxEG,12500,more than downpayment,equal to downpayment,0,2500
hIHZmxEG,3000,5/16/2018,10000,hIHZmxEG,15500,more than downpayment,more than downpayment,0,3000
hIHZmxEG,1100,5/25/2018,10000,hIHZmxEG,16600,more than downpayment,more than downpayment,0,1100
hIHZmxEG,1000,6/26/2018,10000,hIHZmxEG,17600,more than downpayment,more than downpayment,0,1000
hIHZmxEG,5000,6/30/2018,10000,hIHZmxEG,22600,more than downpayment,more than downpayment,0,5000
hIHZmxEG,500,7/24/2018,10000,hIHZmxEG,23100,more than downpayment,more than downpayment,0,500
hIHZmxEG,500,7/25/2018,10000,hIHZmxEG,23600,more than downpayment,more than downpayment,0,500
hIHZmxEG,500,7/29/2018,10000,hIHZmxEG,24100,more than downpayment,more than downpayment,0,500
hIHZmxEG,300,8/3/2018,10000,hIHZmxEG,24400,more than downpayment,more than downpayment,0,300
hIHZmxEG,200,8/5/2018,10000,hIHZmxEG,24600,more than downpayment,more than downpayment,0,200
hIHZmxEG,2000,8/20/2018,10000,hIHZmxEG,26600,more than downpayment,more than downpayment,0,2000
hIHZmxEG,400,8/28/2018,10000,hIHZmxEG,27000,more than downpayment,more than downpayment,0,400
hIHZmxEG,300,9/3/2018,10000,hIHZmxEG,27300,more than downpayment,more than downpayment,0,300
hIHZmxEG,15000,11/12/2018,10000,hIHZmxEG,42300,more than downpayment,more than downpayment,0,15000
hIHZmxEG,10200,12/10/2018,10000,hIHZmxEG,52500,more than downpayment,more than downpayment,0,10200
hIHZmxEG,5000,12/24/2018,10000,hIHZmxEG,57500,more than downpayment,more than downpayment,0,5000
hIHZmxEG,4000,1/9/2019,10000,hIHZmxEG,61500,more than downpayment,more than downpayment,0,4000
hIHZmxEG,1500,1/12/2019,10000,hIHZmxEG,63000,more than downpayment,more than downpayment,0,1500
hIHZmxEG,1000,1/14/2019,10000,hIHZmxEG,64000,more than downpayment,more than downpayment,0,1000
HIY8DTua,36000,3/26/2019,9900,,36000,more than downpayment,,9900,26100
hjjggUzn,20000,12/20/2018,9900,,20000,more than downpayment,,9900,10100
hjjggUzn,10000,1/9/2019,9900,hjjggUzn,30000,more than downpayment,more than downpayment,0,10000
hjjggUzn,10000,2/20/2019,9900,hjjggUzn,40000,more than downpayment,more than downpayment,0,10000
hjjggUzn,10000,3/22/2019,9900,hjjggUzn,50000,more than downpayment,more than downpayment,0,10000
hjjggUzn,10000,4/10/2019,9900,hjjggUzn,60000,more than downpayment,more than downpayment,0,10000
hjjggUzn,10000,5/22/2019,9900,hjjggUzn,70000,more than downpayment,more than downpayment,0,10000
hjjggUzn,7400,6/28/2019,9900,hjjggUzn,77400,more than downpayment,more than downpayment,0,7400
HJVNLEUW,10000,1/28/2020,9900,,10000,more than downpayment,,9900,100
hkX53cMb,10000,9/19/2018,10000,,10000,equal to downpayment,,10000,0
hkX53cMb,4500,10/25/2018,10000,hkX53cMb,14500,more than downpayment,equal to downpayment,0,4500
hkX53cMb,3800,10/30/2018,10000,hkX53cMb,18300,more than downpayment,more than downpayment,0,3800
hkX53cMb,41000,11/9/2018,10000,hkX53cMb,59300,more than downpayment,more than downpayment,0,41000
hl58b7L7,8900,3/1/2019,8900,,8900,equal to downpayment,,8900,0
hl58b7L7,3900,4/5/2019,8900,hl58b7L7,12800,more than downpayment,equal to downpayment,0,3900
hl58b7L7,3900,5/7/2019,8900,hl58b7L7,16700,more than downpayment,more than downpayment,0,3900
hl58b7L7,3900,6/7/2019,8900,hl58b7L7,20600,more than downpayment,more than downpayment,0,3900
hl58b7L7,3900,7/11/2019,8900,hl58b7L7,24500,more than downpayment,more than downpayment,0,3900
hl58b7L7,3900,8/8/2019,8900,hl58b7L7,28400,more than downpayment,more than downpayment,0,3900
hl58b7L7,3900,9/4/2019,8900,hl58b7L7,32300,more than downpayment,more than downpayment,0,3900
hl58b7L7,3900,10/6/2019,8900,hl58b7L7,36200,more than downpayment,more than downpayment,0,3900
hl58b7L7,3900,11/25/2019,8900,hl58b7L7,40100,more than downpayment,more than downpayment,0,3900
hl58b7L7,3900,2/6/2020,8900,hl58b7L7,44000,more than downpayment,more than downpayment,0,3900
hLEBQehe,9900,12/21/2018,9900,,9900,equal to downpayment,,9900,0
hMwX4JH0,10000,3/7/2019,10000,,10000,equal to downpayment,,10000,0
hMwX4JH0,4500,4/14/2019,10000,hMwX4JH0,14500,more than downpayment,equal to downpayment,0,4500
hMwX4JH0,4500,5/12/2019,10000,hMwX4JH0,19000,more than downpayment,more than downpayment,0,4500
hMwX4JH0,4500,6/14/2019,10000,hMwX4JH0,23500,more than downpayment,more than downpayment,0,4500
hMwX4JH0,4500,7/16/2019,10000,hMwX4JH0,28000,more than downpayment,more than downpayment,0,4500
hMwX4JH0,4500,8/16/2019,10000,hMwX4JH0,32500,more than downpayment,more than downpayment,0,4500
hMwX4JH0,4500,9/16/2019,10000,hMwX4JH0,37000,more than downpayment,more than downpayment,0,4500
hMwX4JH0,4500,10/21/2019,10000,hMwX4JH0,41500,more than downpayment,more than downpayment,0,4500
hMwX4JH0,4500,11/17/2019,10000,hMwX4JH0,46000,more than downpayment,more than downpayment,0,4500
hMwX4JH0,4500,12/26/2019,10000,hMwX4JH0,50500,more than downpayment,more than downpayment,0,4500
hMwX4JH0,4500,1/20/2020,10000,hMwX4JH0,55000,more than downpayment,more than downpayment,0,4500
hNo1unzi,9900,6/14/2019,9900,,9900,equal to downpayment,,9900,0
hNo1unzi,4000,8/22/2019,9900,hNo1unzi,13900,more than downpayment,equal to downpayment,0,4000
hNo1unzi,3900,9/25/2019,9900,hNo1unzi,17800,more than downpayment,more than downpayment,0,3900
hNo1unzi,3900,10/25/2019,9900,hNo1unzi,21700,more than downpayment,more than downpayment,0,3900
hNo1unzi,3900,11/25/2019,9900,hNo1unzi,25600,more than downpayment,more than downpayment,0,3900
hNo1unzi,3900,12/25/2019,9900,hNo1unzi,29500,more than downpayment,more than downpayment,0,3900
hNo1unzi,3900,1/25/2020,9900,hNo1unzi,33400,more than downpayment,more than downpayment,0,3900
HNQKSE86,9000,12/20/2019,8900,,9000,more than downpayment,,8900,100
HOA6XC43,9900,7/29/2019,9900,,9900,equal to downpayment,,9900,0
HOA6XC43,3900,9/16/2019,9900,HOA6XC43,13800,more than downpayment,equal to downpayment,0,3900
HOA6XC43,3900,10/23/2019,9900,HOA6XC43,17700,more than downpayment,more than downpayment,0,3900
HOA6XC43,3900,11/25/2019,9900,HOA6XC43,21600,more than downpayment,more than downpayment,0,3900
HOA6XC43,3900,1/8/2020,9900,HOA6XC43,25500,more than downpayment,more than downpayment,0,3900
HOA6XC43,3900,2/4/2020,9900,HOA6XC43,29400,more than downpayment,more than downpayment,0,3900
HPjtGa3U,9900,7/10/2019,9900,,9900,equal to downpayment,,9900,0
HPjtGa3U,3900,9/26/2019,9900,HPjtGa3U,13800,more than downpayment,equal to downpayment,0,3900
HPjtGa3U,3900,10/30/2019,9900,HPjtGa3U,17700,more than downpayment,more than downpayment,0,3900
HPjtGa3U,3900,12/3/2019,9900,HPjtGa3U,21600,more than downpayment,more than downpayment,0,3900
HPjtGa3U,3900,12/27/2019,9900,HPjtGa3U,25500,more than downpayment,more than downpayment,0,3900
HPjtGa3U,3900,1/30/2020,9900,HPjtGa3U,29400,more than downpayment,more than downpayment,0,3900
Hq93i58p,9900,11/5/2018,9900,,9900,equal to downpayment,,9900,0
Hq93i58p,4500,12/4/2018,9900,Hq93i58p,14400,more than downpayment,equal to downpayment,0,4500
Hq93i58p,4500,12/31/2018,9900,Hq93i58p,18900,more than downpayment,more than downpayment,0,4500
Hq93i58p,4500,2/6/2019,9900,Hq93i58p,23400,more than downpayment,more than downpayment,0,4500
Hq93i58p,4500,3/11/2019,9900,Hq93i58p,27900,more than downpayment,more than downpayment,0,4500
Hq93i58p,4500,4/11/2019,9900,Hq93i58p,32400,more than downpayment,more than downpayment,0,4500
Hq93i58p,4500,5/14/2019,9900,Hq93i58p,36900,more than downpayment,more than downpayment,0,4500
Hq93i58p,4500,6/13/2019,9900,Hq93i58p,41400,more than downpayment,more than downpayment,0,4500
Hq93i58p,4500,7/14/2019,9900,Hq93i58p,45900,more than downpayment,more than downpayment,0,4500
Hq93i58p,4500,8/14/2019,9900,Hq93i58p,50400,more than downpayment,more than downpayment,0,4500
Hq93i58p,4500,9/15/2019,9900,Hq93i58p,54900,more than downpayment,more than downpayment,0,4500
Hq93i58p,4500,10/14/2019,9900,Hq93i58p,59400,more than downpayment,more than downpayment,0,4500
Hq93i58p,4500,11/15/2019,9900,Hq93i58p,63900,more than downpayment,more than downpayment,0,4500
Hq93i58p,4500,12/16/2019,9900,Hq93i58p,68400,more than downpayment,more than downpayment,0,4500
Hq93i58p,4500,1/15/2020,9900,Hq93i58p,72900,more than downpayment,more than downpayment,0,4500
HQEB5VDM,1594,10/14/2019,1594,,1594,equal to downpayment,,1594,0
HQEB5VDM,3100,12/18/2019,1594,HQEB5VDM,4694,more than downpayment,equal to downpayment,0,3100
HQORAY33,9900,12/30/2019,9900,,9900,equal to downpayment,,9900,0
HQORAY33,3100,2/5/2020,9900,HQORAY33,13000,more than downpayment,equal to downpayment,0,3100
HRu6sOjI,9900,11/28/2018,9900,,9900,equal to downpayment,,9900,0
HRu6sOjI,4500,2/4/2019,9900,HRu6sOjI,14400,more than downpayment,equal to downpayment,0,4500
HRu6sOjI,4500,2/27/2019,9900,HRu6sOjI,18900,more than downpayment,more than downpayment,0,4500
HRu6sOjI,4500,3/25/2019,9900,HRu6sOjI,23400,more than downpayment,more than downpayment,0,4500
HRu6sOjI,4500,4/30/2019,9900,HRu6sOjI,27900,more than downpayment,more than downpayment,0,4500
HRu6sOjI,4500,5/30/2019,9900,HRu6sOjI,32400,more than downpayment,more than downpayment,0,4500
HRu6sOjI,4500,6/27/2019,9900,HRu6sOjI,36900,more than downpayment,more than downpayment,0,4500
HRu6sOjI,4500,7/31/2019,9900,HRu6sOjI,41400,more than downpayment,more than downpayment,0,4500
HRu6sOjI,4500,8/27/2019,9900,HRu6sOjI,45900,more than downpayment,more than downpayment,0,4500
HRu6sOjI,4500,9/26/2019,9900,HRu6sOjI,50400,more than downpayment,more than downpayment,0,4500
HRu6sOjI,4500,11/7/2019,9900,HRu6sOjI,54900,more than downpayment,more than downpayment,0,4500
HRu6sOjI,4500,12/10/2019,9900,HRu6sOjI,59400,more than downpayment,more than downpayment,0,4500
HRu6sOjI,4500,1/10/2020,9900,HRu6sOjI,63900,more than downpayment,more than downpayment,0,4500
hSdg2H24,29500,7/11/2019,26250,,29500,more than downpayment,,26250,3250
hSdg2H24,20000,9/3/2019,26250,hSdg2H24,49500,more than downpayment,more than downpayment,0,20000
hSdg2H24,40000,10/3/2019,26250,hSdg2H24,89500,more than downpayment,more than downpayment,0,40000
hSdg2H24,17000,11/13/2019,26250,hSdg2H24,106500,more than downpayment,more than downpayment,0,17000
HSEBQC7J,29000,11/15/2019,9900,,29000,more than downpayment,,9900,19100
HSH973MK,24000,12/27/2019,8900,,24000,more than downpayment,,8900,15100
HT53GQLQ,8900,8/6/2019,8900,,8900,equal to downpayment,,8900,0
HT53GQLQ,3900,10/4/2019,8900,HT53GQLQ,12800,more than downpayment,equal to downpayment,0,3900
HT53GQLQ,3900,11/11/2019,8900,HT53GQLQ,16700,more than downpayment,more than downpayment,0,3900
HT53GQLQ,3900,12/20/2019,8900,HT53GQLQ,20600,more than downpayment,more than downpayment,0,3900
HT53GQLQ,3900,1/6/2020,8900,HT53GQLQ,24500,more than downpayment,more than downpayment,0,3900
HT53GQLQ,3900,2/3/2020,8900,HT53GQLQ,28400,more than downpayment,more than downpayment,0,3900
HTK54gK3,10000,4/18/2019,10000,,10000,equal to downpayment,,10000,0
HTK54gK3,4500,5/23/2019,10000,HTK54gK3,14500,more than downpayment,equal to downpayment,0,4500
HTK54gK3,4500,6/22/2019,10000,HTK54gK3,19000,more than downpayment,more than downpayment,0,4500
HTK54gK3,4500,7/25/2019,10000,HTK54gK3,23500,more than downpayment,more than downpayment,0,4500
HTK54gK3,4500,8/26/2019,10000,HTK54gK3,28000,more than downpayment,more than downpayment,0,4500
HTK54gK3,4500,9/26/2019,10000,HTK54gK3,32500,more than downpayment,more than downpayment,0,4500
HTK54gK3,4500,11/1/2019,10000,HTK54gK3,37000,more than downpayment,more than downpayment,0,4500
HTK54gK3,4500,12/1/2019,10000,HTK54gK3,41500,more than downpayment,more than downpayment,0,4500
HTK54gK3,4500,12/28/2019,10000,HTK54gK3,46000,more than downpayment,more than downpayment,0,4500
HTK54gK3,4500,1/28/2020,10000,HTK54gK3,50500,more than downpayment,more than downpayment,0,4500
htLNPOiw,10000,11/28/2018,10000,,10000,equal to downpayment,,10000,0
htLNPOiw,4500,1/5/2019,10000,htLNPOiw,14500,more than downpayment,equal to downpayment,0,4500
htLNPOiw,4500,2/5/2019,10000,htLNPOiw,19000,more than downpayment,more than downpayment,0,4500
htLNPOiw,4500,3/5/2019,10000,htLNPOiw,23500,more than downpayment,more than downpayment,0,4500
htLNPOiw,4500,4/5/2019,10000,htLNPOiw,28000,more than downpayment,more than downpayment,0,4500
htLNPOiw,4500,5/6/2019,10000,htLNPOiw,32500,more than downpayment,more than downpayment,0,4500
htLNPOiw,4500,6/27/2019,10000,htLNPOiw,37000,more than downpayment,more than downpayment,0,4500
htLNPOiw,4500,7/7/2019,10000,htLNPOiw,41500,more than downpayment,more than downpayment,0,4500
HU4HRFKJ,8900,8/7/2019,8900,,8900,equal to downpayment,,8900,0
HU4HRFKJ,3900,10/24/2019,8900,HU4HRFKJ,12800,more than downpayment,equal to downpayment,0,3900
HU4HRFKJ,5000,12/27/2019,8900,HU4HRFKJ,17800,more than downpayment,more than downpayment,0,5000
HU4HRFKJ,3000,1/22/2020,8900,HU4HRFKJ,20800,more than downpayment,more than downpayment,0,3000
HU4HRFKJ,2500,1/31/2020,8900,HU4HRFKJ,23300,more than downpayment,more than downpayment,0,2500
hu8fJ0YF,8900,12/17/2018,0,,8900,more than downpayment,,0,8900
hu8fJ0YF,3900,2/14/2019,0,hu8fJ0YF,12800,more than downpayment,more than downpayment,0,3900
hu8fJ0YF,3900,3/4/2019,0,hu8fJ0YF,16700,more than downpayment,more than downpayment,0,3900
hu8fJ0YF,6000,4/3/2019,0,hu8fJ0YF,22700,more than downpayment,more than downpayment,0,6000
hu8fJ0YF,6000,5/3/2019,0,hu8fJ0YF,28700,more than downpayment,more than downpayment,0,6000
hu8fJ0YF,4000,7/5/2019,0,hu8fJ0YF,32700,more than downpayment,more than downpayment,0,4000
hu8fJ0YF,4000,8/8/2019,0,hu8fJ0YF,36700,more than downpayment,more than downpayment,0,4000
hu8fJ0YF,4000,9/10/2019,0,hu8fJ0YF,40700,more than downpayment,more than downpayment,0,4000
hu8fJ0YF,4000,10/7/2019,0,hu8fJ0YF,44700,more than downpayment,more than downpayment,0,4000
hu8fJ0YF,4000,11/6/2019,0,hu8fJ0YF,48700,more than downpayment,more than downpayment,0,4000
hv953FH1,8900,4/13/2019,8900,,8900,equal to downpayment,,8900,0
hv953FH1,3900,5/26/2019,8900,hv953FH1,12800,more than downpayment,equal to downpayment,0,3900
hv953FH1,3900,7/17/2019,8900,hv953FH1,16700,more than downpayment,more than downpayment,0,3900
hv953FH1,3900,8/3/2019,8900,hv953FH1,20600,more than downpayment,more than downpayment,0,3900
hv953FH1,3900,10/2/2019,8900,hv953FH1,24500,more than downpayment,more than downpayment,0,3900
hv953FH1,3900,10/11/2019,8900,hv953FH1,28400,more than downpayment,more than downpayment,0,3900
hv953FH1,3900,11/19/2019,8900,hv953FH1,32300,more than downpayment,more than downpayment,0,3900
hv953FH1,3900,12/6/2019,8900,hv953FH1,36200,more than downpayment,more than downpayment,0,3900
hv953FH1,3900,1/3/2020,8900,hv953FH1,40100,more than downpayment,more than downpayment,0,3900
hv953FH1,3900,2/5/2020,8900,hv953FH1,44000,more than downpayment,more than downpayment,0,3900
HVOBCFJY,9900,8/5/2019,9900,,9900,equal to downpayment,,9900,0
HVOBCFJY,3000,10/20/2019,9900,HVOBCFJY,12900,more than downpayment,equal to downpayment,0,3000
HVOBCFJY,4800,11/20/2019,9900,HVOBCFJY,17700,more than downpayment,more than downpayment,0,4800
HVT4PuZj,10000,9/20/2017,10000,,10000,equal to downpayment,,10000,0
HVT4PuZj,5000,12/11/2017,10000,HVT4PuZj,15000,more than downpayment,equal to downpayment,0,5000
HVT4PuZj,5000,1/12/2018,10000,HVT4PuZj,20000,more than downpayment,more than downpayment,0,5000
HVT4PuZj,5000,2/13/2018,10000,HVT4PuZj,25000,more than downpayment,more than downpayment,0,5000
HVT4PuZj,5000,2/20/2018,10000,HVT4PuZj,30000,more than downpayment,more than downpayment,0,5000
HVT4PuZj,5000,3/9/2018,10000,HVT4PuZj,35000,more than downpayment,more than downpayment,0,5000
HVT4PuZj,5000,4/14/2018,10000,HVT4PuZj,40000,more than downpayment,more than downpayment,0,5000
HVT4PuZj,5000,5/15/2018,10000,HVT4PuZj,45000,more than downpayment,more than downpayment,0,5000
HVT4PuZj,5000,6/13/2018,10000,HVT4PuZj,50000,more than downpayment,more than downpayment,0,5000
HVZDLRWB,9000,12/31/2019,8900,,9000,more than downpayment,,8900,100
HVZDLRWB,11000,2/7/2020,8900,HVZDLRWB,20000,more than downpayment,more than downpayment,0,11000
HWD4SZ7N,9900,9/9/2019,9900,,9900,equal to downpayment,,9900,0
HWD4SZ7N,3900,12/24/2019,9900,HWD4SZ7N,13800,more than downpayment,equal to downpayment,0,3900
HWD4SZ7N,3900,1/27/2020,9900,HWD4SZ7N,17700,more than downpayment,more than downpayment,0,3900
hWLsDQhk,8900,7/31/2019,8900,,8900,equal to downpayment,,8900,0
hWLsDQhk,3900,9/2/2019,8900,hWLsDQhk,12800,more than downpayment,equal to downpayment,0,3900
hWLsDQhk,3900,10/3/2019,8900,hWLsDQhk,16700,more than downpayment,more than downpayment,0,3900
hWLsDQhk,3900,11/8/2019,8900,hWLsDQhk,20600,more than downpayment,more than downpayment,0,3900
hWLsDQhk,3900,11/30/2019,8900,hWLsDQhk,24500,more than downpayment,more than downpayment,0,3900
hWLsDQhk,3900,12/20/2019,8900,hWLsDQhk,28400,more than downpayment,more than downpayment,0,3900
hWLsDQhk,3900,1/20/2020,8900,hWLsDQhk,32300,more than downpayment,more than downpayment,0,3900
hWLsDQhk,3900,2/6/2020,8900,hWLsDQhk,36200,more than downpayment,more than downpayment,0,3900
hWvb0ZuE,25000,8/1/2019,23400,,25000,more than downpayment,,23400,1600
hWvb0ZuE,5000,8/2/2019,23400,hWvb0ZuE,30000,more than downpayment,more than downpayment,0,5000
hWvb0ZuE,4490,8/15/2019,23400,hWvb0ZuE,34490,more than downpayment,more than downpayment,0,4490
hWvb0ZuE,5000,9/30/2019,23400,hWvb0ZuE,39490,more than downpayment,more than downpayment,0,5000
hWvb0ZuE,5000,10/17/2019,23400,hWvb0ZuE,44490,more than downpayment,more than downpayment,0,5000
hWvb0ZuE,5000,11/13/2019,23400,hWvb0ZuE,49490,more than downpayment,more than downpayment,0,5000
hWvb0ZuE,5000,11/19/2019,23400,hWvb0ZuE,54490,more than downpayment,more than downpayment,0,5000
hWvb0ZuE,10000,12/3/2019,23400,hWvb0ZuE,64490,more than downpayment,more than downpayment,0,10000
HXSFSVWW,6000,8/26/2019,8900,,6000,less than downpayment,,6000,0
HXSFSVWW,1900,8/31/2019,8900,HXSFSVWW,7900,less than downpayment,less than downpayment,1900,0
HXSFSVWW,2000,9/3/2019,8900,HXSFSVWW,9900,more than downpayment,less than downpayment,1000,1000
HXSFSVWW,2000,10/17/2019,8900,HXSFSVWW,11900,more than downpayment,more than downpayment,0,2000
HXSFSVWW,2000,10/19/2019,8900,HXSFSVWW,13900,more than downpayment,more than downpayment,0,2000
HXSFSVWW,2000,10/22/2019,8900,HXSFSVWW,15900,more than downpayment,more than downpayment,0,2000
HXSFSVWW,2000,10/26/2019,8900,HXSFSVWW,17900,more than downpayment,more than downpayment,0,2000
HXSFSVWW,2500,12/24/2019,8900,HXSFSVWW,20400,more than downpayment,more than downpayment,0,2500
HXSFSVWW,1000,12/25/2019,8900,HXSFSVWW,21400,more than downpayment,more than downpayment,0,1000
HXSFSVWW,1400,12/26/2019,8900,HXSFSVWW,22800,more than downpayment,more than downpayment,0,1400
HXSFSVWW,1700,1/27/2020,8900,HXSFSVWW,24500,more than downpayment,more than downpayment,0,1700
hXUMqODA,10000,8/14/2018,10000,,10000,equal to downpayment,,10000,0
hXUMqODA,4500,9/24/2018,10000,hXUMqODA,14500,more than downpayment,equal to downpayment,0,4500
hXUMqODA,4500,10/25/2018,10000,hXUMqODA,19000,more than downpayment,more than downpayment,0,4500
hXUMqODA,4500,11/25/2018,10000,hXUMqODA,23500,more than downpayment,more than downpayment,0,4500
hXUMqODA,4500,12/28/2018,10000,hXUMqODA,28000,more than downpayment,more than downpayment,0,4500
hXUMqODA,4500,1/25/2019,10000,hXUMqODA,32500,more than downpayment,more than downpayment,0,4500
hXUMqODA,4500,2/25/2019,10000,hXUMqODA,37000,more than downpayment,more than downpayment,0,4500
hXUMqODA,4500,3/28/2019,10000,hXUMqODA,41500,more than downpayment,more than downpayment,0,4500
hXUMqODA,4500,4/26/2019,10000,hXUMqODA,46000,more than downpayment,more than downpayment,0,4500
hXUMqODA,4500,5/25/2019,10000,hXUMqODA,50500,more than downpayment,more than downpayment,0,4500
hXUMqODA,4500,6/26/2019,10000,hXUMqODA,55000,more than downpayment,more than downpayment,0,4500
hXUMqODA,4500,8/1/2019,10000,hXUMqODA,59500,more than downpayment,more than downpayment,0,4500
hXUMqODA,4500,8/26/2019,10000,hXUMqODA,64000,more than downpayment,more than downpayment,0,4500
hxX92Q9N,10000,10/3/2018,10000,,10000,equal to downpayment,,10000,0
hxX92Q9N,4500,11/6/2018,10000,hxX92Q9N,14500,more than downpayment,equal to downpayment,0,4500
hxX92Q9N,4500,12/5/2018,10000,hxX92Q9N,19000,more than downpayment,more than downpayment,0,4500
hxX92Q9N,4500,1/7/2019,10000,hxX92Q9N,23500,more than downpayment,more than downpayment,0,4500
hxX92Q9N,4500,2/5/2019,10000,hxX92Q9N,28000,more than downpayment,more than downpayment,0,4500
hxX92Q9N,4500,3/5/2019,10000,hxX92Q9N,32500,more than downpayment,more than downpayment,0,4500
hxX92Q9N,4500,4/8/2019,10000,hxX92Q9N,37000,more than downpayment,more than downpayment,0,4500
hxX92Q9N,4500,5/18/2019,10000,hxX92Q9N,41500,more than downpayment,more than downpayment,0,4500
hxX92Q9N,4500,6/6/2019,10000,hxX92Q9N,46000,more than downpayment,more than downpayment,0,4500
hxX92Q9N,4500,7/8/2019,10000,hxX92Q9N,50500,more than downpayment,more than downpayment,0,4500
hxX92Q9N,4500,8/6/2019,10000,hxX92Q9N,55000,more than downpayment,more than downpayment,0,4500
hxX92Q9N,4500,9/6/2019,10000,hxX92Q9N,59500,more than downpayment,more than downpayment,0,4500
hxX92Q9N,4500,10/7/2019,10000,hxX92Q9N,64000,more than downpayment,more than downpayment,0,4500
Hy1cud2R,10000,2/7/2019,8900,,10000,more than downpayment,,8900,1100
Hy1cud2R,3900,3/24/2019,8900,Hy1cud2R,13900,more than downpayment,more than downpayment,0,3900
Hy1cud2R,3900,4/24/2019,8900,Hy1cud2R,17800,more than downpayment,more than downpayment,0,3900
Hy1cud2R,3900,5/22/2019,8900,Hy1cud2R,21700,more than downpayment,more than downpayment,0,3900
Hy1cud2R,3900,6/26/2019,8900,Hy1cud2R,25600,more than downpayment,more than downpayment,0,3900
Hy1cud2R,3900,7/19/2019,8900,Hy1cud2R,29500,more than downpayment,more than downpayment,0,3900
Hy1cud2R,3900,8/24/2019,8900,Hy1cud2R,33400,more than downpayment,more than downpayment,0,3900
Hy1cud2R,3900,9/23/2019,8900,Hy1cud2R,37300,more than downpayment,more than downpayment,0,3900
Hy1cud2R,3900,10/25/2019,8900,Hy1cud2R,41200,more than downpayment,more than downpayment,0,3900
Hy1cud2R,3900,11/25/2019,8900,Hy1cud2R,45100,more than downpayment,more than downpayment,0,3900
Hy1cud2R,3900,12/26/2019,8900,Hy1cud2R,49000,more than downpayment,more than downpayment,0,3900
Hy1cud2R,3900,1/27/2020,8900,Hy1cud2R,52900,more than downpayment,more than downpayment,0,3900
Hy1cud2R,3900,2/3/2020,8900,Hy1cud2R,56800,more than downpayment,more than downpayment,0,3900
hYiOwiUy,9900,12/17/2018,9900,,9900,equal to downpayment,,9900,0
hYiOwiUy,4500,1/21/2019,9900,hYiOwiUy,14400,more than downpayment,equal to downpayment,0,4500
hYiOwiUy,4500,3/1/2019,9900,hYiOwiUy,18900,more than downpayment,more than downpayment,0,4500
hYiOwiUy,4500,3/25/2019,9900,hYiOwiUy,23400,more than downpayment,more than downpayment,0,4500
hYiOwiUy,4500,4/29/2019,9900,hYiOwiUy,27900,more than downpayment,more than downpayment,0,4500
hYiOwiUy,4500,5/24/2019,9900,hYiOwiUy,32400,more than downpayment,more than downpayment,0,4500
hYiOwiUy,4500,6/28/2019,9900,hYiOwiUy,36900,more than downpayment,more than downpayment,0,4500
hYiOwiUy,4500,7/26/2019,9900,hYiOwiUy,41400,more than downpayment,more than downpayment,0,4500
hYiOwiUy,4500,8/27/2019,9900,hYiOwiUy,45900,more than downpayment,more than downpayment,0,4500
hYiOwiUy,4500,9/26/2019,9900,hYiOwiUy,50400,more than downpayment,more than downpayment,0,4500
hYiOwiUy,4500,10/26/2019,9900,hYiOwiUy,54900,more than downpayment,more than downpayment,0,4500
hYiOwiUy,4500,11/26/2019,9900,hYiOwiUy,59400,more than downpayment,more than downpayment,0,4500
hYiOwiUy,4500,1/13/2020,9900,hYiOwiUy,63900,more than downpayment,more than downpayment,0,4500
Hz4hAlFU,9900,8/23/2019,9900,,9900,equal to downpayment,,9900,0
i3F4rd7F,8900,3/5/2019,8900,,8900,equal to downpayment,,8900,0
i3F4rd7F,3900,4/7/2019,8900,i3F4rd7F,12800,more than downpayment,equal to downpayment,0,3900
i3F4rd7F,3999,5/2/2019,8900,i3F4rd7F,16799,more than downpayment,more than downpayment,0,3999
i3F4rd7F,3900,6/6/2019,8900,i3F4rd7F,20699,more than downpayment,more than downpayment,0,3900
i3F4rd7F,3900,7/9/2019,8900,i3F4rd7F,24599,more than downpayment,more than downpayment,0,3900
i3F4rd7F,3900,9/27/2019,8900,i3F4rd7F,28499,more than downpayment,more than downpayment,0,3900
i3F4rd7F,4000,11/1/2019,8900,i3F4rd7F,32499,more than downpayment,more than downpayment,0,4000
i4osYzsP,8900,4/11/2019,9900,,8900,less than downpayment,,8900,0
i4osYzsP,1000,7/4/2019,9900,i4osYzsP,9900,equal to downpayment,less than downpayment,1000,0
i4osYzsP,4000,7/24/2019,9900,i4osYzsP,13900,more than downpayment,equal to downpayment,0,4000
i4osYzsP,4000,8/5/2019,9900,i4osYzsP,17900,more than downpayment,more than downpayment,0,4000
i4osYzsP,3900,9/4/2019,9900,i4osYzsP,21800,more than downpayment,more than downpayment,0,3900
i4osYzsP,3900,10/4/2019,9900,i4osYzsP,25700,more than downpayment,more than downpayment,0,3900
i4osYzsP,3900,11/4/2019,9900,i4osYzsP,29600,more than downpayment,more than downpayment,0,3900
i4osYzsP,3900,12/3/2019,9900,i4osYzsP,33500,more than downpayment,more than downpayment,0,3900
i4osYzsP,3900,12/31/2019,9900,i4osYzsP,37400,more than downpayment,more than downpayment,0,3900
i4osYzsP,3900,2/5/2020,9900,i4osYzsP,41300,more than downpayment,more than downpayment,0,3900
i5ZkK4lf,9900,11/1/2018,9900,,9900,equal to downpayment,,9900,0
i5ZkK4lf,4500,12/20/2018,9900,i5ZkK4lf,14400,more than downpayment,equal to downpayment,0,4500
i5ZkK4lf,4500,1/21/2019,9900,i5ZkK4lf,18900,more than downpayment,more than downpayment,0,4500
i5ZkK4lf,4500,2/23/2019,9900,i5ZkK4lf,23400,more than downpayment,more than downpayment,0,4500
i5ZkK4lf,4500,3/25/2019,9900,i5ZkK4lf,27900,more than downpayment,more than downpayment,0,4500
i5ZkK4lf,4500,4/26/2019,9900,i5ZkK4lf,32400,more than downpayment,more than downpayment,0,4500
i5ZkK4lf,4500,5/28/2019,9900,i5ZkK4lf,36900,more than downpayment,more than downpayment,0,4500
i5ZkK4lf,4500,6/27/2019,9900,i5ZkK4lf,41400,more than downpayment,more than downpayment,0,4500
i5ZkK4lf,4500,7/25/2019,9900,i5ZkK4lf,45900,more than downpayment,more than downpayment,0,4500
i5ZkK4lf,4500,9/13/2019,9900,i5ZkK4lf,50400,more than downpayment,more than downpayment,0,4500
i5ZkK4lf,4500,10/7/2019,9900,i5ZkK4lf,54900,more than downpayment,more than downpayment,0,4500
i5ZkK4lf,4500,11/1/2019,9900,i5ZkK4lf,59400,more than downpayment,more than downpayment,0,4500
i5ZkK4lf,4500,12/15/2019,9900,i5ZkK4lf,63900,more than downpayment,more than downpayment,0,4500
i6DcovcJ,8900,3/26/2019,8900,,8900,equal to downpayment,,8900,0
i6DcovcJ,3900,5/15/2019,8900,i6DcovcJ,12800,more than downpayment,equal to downpayment,0,3900
i6DcovcJ,1000,6/27/2019,8900,i6DcovcJ,13800,more than downpayment,more than downpayment,0,1000
i6DcovcJ,2000,7/29/2019,8900,i6DcovcJ,15800,more than downpayment,more than downpayment,0,2000
i6DcovcJ,4900,8/9/2019,8900,i6DcovcJ,20700,more than downpayment,more than downpayment,0,4900
i6DcovcJ,1900,8/27/2019,8900,i6DcovcJ,22600,more than downpayment,more than downpayment,0,1900
i6DcovcJ,2000,9/9/2019,8900,i6DcovcJ,24600,more than downpayment,more than downpayment,0,2000
i6DcovcJ,3900,11/4/2019,8900,i6DcovcJ,28500,more than downpayment,more than downpayment,0,3900
i6DcovcJ,7650,12/16/2019,8900,i6DcovcJ,36150,more than downpayment,more than downpayment,0,7650
i6DcovcJ,3900,1/2/2020,8900,i6DcovcJ,40050,more than downpayment,more than downpayment,0,3900
i6DcovcJ,50,1/21/2020,8900,i6DcovcJ,40100,more than downpayment,more than downpayment,0,50
I6J11KMX,8900,11/14/2019,9900,,8900,less than downpayment,,8900,0
I6J11KMX,3900,12/30/2019,9900,I6J11KMX,12800,more than downpayment,less than downpayment,1000,2900
I6J11KMX,4900,2/6/2020,9900,I6J11KMX,17700,more than downpayment,more than downpayment,0,4900
I6M6XJGB,9900,11/8/2019,9900,,9900,equal to downpayment,,9900,0
I6M6XJGB,3900,12/4/2019,9900,I6M6XJGB,13800,more than downpayment,equal to downpayment,0,3900
I6M6XJGB,3900,1/5/2020,9900,I6M6XJGB,17700,more than downpayment,more than downpayment,0,3900
I6M6XJGB,3900,2/3/2020,9900,I6M6XJGB,21600,more than downpayment,more than downpayment,0,3900
I7A5DF4L,9900,9/23/2019,9900,,9900,equal to downpayment,,9900,0
I7A5DF4L,7800,11/25/2019,9900,I7A5DF4L,17700,more than downpayment,equal to downpayment,0,7800
I7A5DF4L,3900,1/10/2020,9900,I7A5DF4L,21600,more than downpayment,more than downpayment,0,3900
I7BXVHEG,9900,11/29/2019,9900,,9900,equal to downpayment,,9900,0
I7JR1UX7,8900,11/28/2019,8900,,8900,equal to downpayment,,8900,0
I865HQJ1,8900,5/14/2019,8900,,8900,equal to downpayment,,8900,0
I865HQJ1,3500,7/15/2019,8900,I865HQJ1,12400,more than downpayment,equal to downpayment,0,3500
I865HQJ1,3500,8/8/2019,8900,I865HQJ1,15900,more than downpayment,more than downpayment,0,3500
I93DYCSX,8900,1/29/2020,8900,,8900,equal to downpayment,,8900,0
i9I0yBqn,50000,12/17/2018,8900,,50000,more than downpayment,,8900,41100
i9I0yBqn,2530,1/24/2019,8900,i9I0yBqn,52530,more than downpayment,more than downpayment,0,2530
i9I0yBqn,2530,3/17/2019,8900,i9I0yBqn,55060,more than downpayment,more than downpayment,0,2530
i9I0yBqn,15000,2/4/2020,8900,i9I0yBqn,70060,more than downpayment,more than downpayment,0,15000
IA7L83AK,9900,12/14/2019,9900,,9900,equal to downpayment,,9900,0
IAACirEF,8900,11/23/2018,8900,,8900,equal to downpayment,,8900,0
IAACirEF,3900,12/25/2018,8900,IAACirEF,12800,more than downpayment,equal to downpayment,0,3900
IAACirEF,3900,1/26/2019,8900,IAACirEF,16700,more than downpayment,more than downpayment,0,3900
IAACirEF,3900,2/27/2019,8900,IAACirEF,20600,more than downpayment,more than downpayment,0,3900
IAACirEF,3900,3/26/2019,8900,IAACirEF,24500,more than downpayment,more than downpayment,0,3900
IAACirEF,3900,4/29/2019,8900,IAACirEF,28400,more than downpayment,more than downpayment,0,3900
IAACirEF,3900,5/28/2019,8900,IAACirEF,32300,more than downpayment,more than downpayment,0,3900
IAACirEF,3900,6/28/2019,8900,IAACirEF,36200,more than downpayment,more than downpayment,0,3900
IAACirEF,3000,7/30/2019,8900,IAACirEF,39200,more than downpayment,more than downpayment,0,3000
IAACirEF,900,7/31/2019,8900,IAACirEF,40100,more than downpayment,more than downpayment,0,900
IAACirEF,3900,9/3/2019,8900,IAACirEF,44000,more than downpayment,more than downpayment,0,3900
IAACirEF,2900,10/3/2019,8900,IAACirEF,46900,more than downpayment,more than downpayment,0,2900
IAACirEF,1000,10/16/2019,8900,IAACirEF,47900,more than downpayment,more than downpayment,0,1000
IAACirEF,2900,11/1/2019,8900,IAACirEF,50800,more than downpayment,more than downpayment,0,2900
IAACirEF,1000,11/2/2019,8900,IAACirEF,51800,more than downpayment,more than downpayment,0,1000
IAACirEF,1000,12/2/2019,8900,IAACirEF,52800,more than downpayment,more than downpayment,0,1000
IAACirEF,2900,12/5/2019,8900,IAACirEF,55700,more than downpayment,more than downpayment,0,2900
IAACirEF,1600,1/9/2020,8900,IAACirEF,57300,more than downpayment,more than downpayment,0,1600
IAACirEF,2300,1/15/2020,8900,IAACirEF,59600,more than downpayment,more than downpayment,0,2300
IAACirEF,3900,1/24/2020,8900,IAACirEF,63500,more than downpayment,more than downpayment,0,3900
IARCGpHy,10000,8/31/2019,9900,,10000,more than downpayment,,9900,100
IARCGpHy,3800,11/30/2019,9900,IARCGpHy,13800,more than downpayment,more than downpayment,0,3800
IARCGpHy,4000,1/3/2020,9900,IARCGpHy,17800,more than downpayment,more than downpayment,0,4000
IARCGpHy,3800,1/28/2020,9900,IARCGpHy,21600,more than downpayment,more than downpayment,0,3800
IB5L2A81,8900,11/4/2019,8900,,8900,equal to downpayment,,8900,0
IB5L2A81,3900,12/5/2019,8900,IB5L2A81,12800,more than downpayment,equal to downpayment,0,3900
IB5L2A81,3900,1/5/2020,8900,IB5L2A81,16700,more than downpayment,more than downpayment,0,3900
IB5L2A81,3900,2/5/2020,8900,IB5L2A81,20600,more than downpayment,more than downpayment,0,3900
ibngd7oC,10000,12/3/2018,9900,,10000,more than downpayment,,9900,100
iBPouXLX,8900,5/2/2019,8900,,8900,equal to downpayment,,8900,0
iBPouXLX,3900,5/24/2019,8900,iBPouXLX,12800,more than downpayment,equal to downpayment,0,3900
iBPouXLX,3900,6/24/2019,8900,iBPouXLX,16700,more than downpayment,more than downpayment,0,3900
iBPouXLX,3900,7/25/2019,8900,iBPouXLX,20600,more than downpayment,more than downpayment,0,3900
iBPouXLX,3900,8/24/2019,8900,iBPouXLX,24500,more than downpayment,more than downpayment,0,3900
iBPouXLX,3900,9/24/2019,8900,iBPouXLX,28400,more than downpayment,more than downpayment,0,3900
iBPouXLX,3900,10/23/2019,8900,iBPouXLX,32300,more than downpayment,more than downpayment,0,3900
iBPouXLX,3900,11/25/2019,8900,iBPouXLX,36200,more than downpayment,more than downpayment,0,3900
iBPouXLX,3900,12/24/2019,8900,iBPouXLX,40100,more than downpayment,more than downpayment,0,3900
iBPouXLX,3900,1/25/2020,8900,iBPouXLX,44000,more than downpayment,more than downpayment,0,3900
iD8WJLCk,10000,7/13/2017,10000,,10000,equal to downpayment,,10000,0
iD8WJLCk,5000,1/19/2018,10000,iD8WJLCk,15000,more than downpayment,equal to downpayment,0,5000
iD8WJLCk,4000,2/8/2018,10000,iD8WJLCk,19000,more than downpayment,more than downpayment,0,4000
iD8WJLCk,4000,3/7/2018,10000,iD8WJLCk,23000,more than downpayment,more than downpayment,0,4000
iD8WJLCk,4000,3/28/2018,10000,iD8WJLCk,27000,more than downpayment,more than downpayment,0,4000
iD8WJLCk,4000,4/4/2018,10000,iD8WJLCk,31000,more than downpayment,more than downpayment,0,4000
iD8WJLCk,8000,4/11/2018,10000,iD8WJLCk,39000,more than downpayment,more than downpayment,0,8000
iD8WJLCk,5500,5/29/2018,10000,iD8WJLCk,44500,more than downpayment,more than downpayment,0,5500
iD8WJLCk,500,7/3/2018,10000,iD8WJLCk,45000,more than downpayment,more than downpayment,0,500
IdKyduiO,10000,8/31/2018,10000,,10000,equal to downpayment,,10000,0
IdKyduiO,4600,10/2/2018,10000,IdKyduiO,14600,more than downpayment,equal to downpayment,0,4600
IdKyduiO,3000,10/28/2018,10000,IdKyduiO,17600,more than downpayment,more than downpayment,0,3000
IdKyduiO,1550,11/3/2018,10000,IdKyduiO,19150,more than downpayment,more than downpayment,0,1550
IdKyduiO,4500,12/14/2018,10000,IdKyduiO,23650,more than downpayment,more than downpayment,0,4500
IdKyduiO,370,2/11/2019,10000,IdKyduiO,24020,more than downpayment,more than downpayment,0,370
IdKyduiO,1000,3/5/2019,10000,IdKyduiO,25020,more than downpayment,more than downpayment,0,1000
IdKyduiO,3000,3/25/2019,10000,IdKyduiO,28020,more than downpayment,more than downpayment,0,3000
IdVqY6xA,7500,5/24/2017,7500,,7500,equal to downpayment,,7500,0
IdVqY6xA,3000,7/1/2017,7500,IdVqY6xA,10500,more than downpayment,equal to downpayment,0,3000
IdVqY6xA,3000,7/27/2017,7500,IdVqY6xA,13500,more than downpayment,more than downpayment,0,3000
IdVqY6xA,3000,8/24/2017,7500,IdVqY6xA,16500,more than downpayment,more than downpayment,0,3000
IdVqY6xA,3000,10/3/2017,7500,IdVqY6xA,19500,more than downpayment,more than downpayment,0,3000
IdVqY6xA,3000,11/29/2017,7500,IdVqY6xA,22500,more than downpayment,more than downpayment,0,3000
IdVqY6xA,3000,1/25/2018,7500,IdVqY6xA,25500,more than downpayment,more than downpayment,0,3000
IdVqY6xA,12000,2/25/2018,7500,IdVqY6xA,37500,more than downpayment,more than downpayment,0,12000
IDWYDA7F,26250,1/17/2020,26250,,26250,equal to downpayment,,26250,0
IE8KUDJG,9900,11/9/2019,9900,,9900,equal to downpayment,,9900,0
IE8KUDJG,3900,12/26/2019,9900,IE8KUDJG,13800,more than downpayment,equal to downpayment,0,3900
IE8KUDJG,3900,1/27/2020,9900,IE8KUDJG,17700,more than downpayment,more than downpayment,0,3900
IEiqdmt6,9900,6/29/2019,26250,,9900,less than downpayment,,9900,0
IEiqdmt6,17350,7/2/2019,26250,IEiqdmt6,27250,more than downpayment,less than downpayment,16350,1000
IEiqdmt6,26250,8/18/2019,26250,IEiqdmt6,53500,more than downpayment,more than downpayment,0,26250
IEiqdmt6,50500,9/20/2019,26250,IEiqdmt6,104000,more than downpayment,more than downpayment,0,50500
IEiqdmt6,2000,11/26/2019,26250,IEiqdmt6,106000,more than downpayment,more than downpayment,0,2000
IemEHaHb,8900,4/2/2019,8900,,8900,equal to downpayment,,8900,0
IemEHaHb,5000,5/6/2019,8900,IemEHaHb,13900,more than downpayment,equal to downpayment,0,5000
IemEHaHb,5000,6/6/2019,8900,IemEHaHb,18900,more than downpayment,more than downpayment,0,5000
IemEHaHb,2000,7/10/2019,8900,IemEHaHb,20900,more than downpayment,more than downpayment,0,2000
IemEHaHb,1000,7/18/2019,8900,IemEHaHb,21900,more than downpayment,more than downpayment,0,1000
IemEHaHb,1200,7/24/2019,8900,IemEHaHb,23100,more than downpayment,more than downpayment,0,1200
IemEHaHb,2000,8/29/2019,8900,IemEHaHb,25100,more than downpayment,more than downpayment,0,2000
IemEHaHb,1000,8/31/2019,8900,IemEHaHb,26100,more than downpayment,more than downpayment,0,1000
IemEHaHb,2000,9/20/2019,8900,IemEHaHb,28100,more than downpayment,more than downpayment,0,2000
IemEHaHb,2000,9/25/2019,8900,IemEHaHb,30100,more than downpayment,more than downpayment,0,2000
IemEHaHb,4000,10/15/2019,8900,IemEHaHb,34100,more than downpayment,more than downpayment,0,4000
IemEHaHb,4000,11/22/2019,8900,IemEHaHb,38100,more than downpayment,more than downpayment,0,4000
IemEHaHb,2000,12/24/2019,8900,IemEHaHb,40100,more than downpayment,more than downpayment,0,2000
IENSGSJ6,9900,7/15/2019,9900,,9900,equal to downpayment,,9900,0
IENSGSJ6,4000,9/2/2019,9900,IENSGSJ6,13900,more than downpayment,equal to downpayment,0,4000
IENSGSJ6,4000,10/3/2019,9900,IENSGSJ6,17900,more than downpayment,more than downpayment,0,4000
IENSGSJ6,4000,11/4/2019,9900,IENSGSJ6,21900,more than downpayment,more than downpayment,0,4000
IENSGSJ6,4000,11/22/2019,9900,IENSGSJ6,25900,more than downpayment,more than downpayment,0,4000
IENSGSJ6,4000,12/19/2019,9900,IENSGSJ6,29900,more than downpayment,more than downpayment,0,4000
IENSGSJ6,4000,1/22/2020,9900,IENSGSJ6,33900,more than downpayment,more than downpayment,0,4000
IFA9R3FI,8900,10/14/2019,8900,,8900,equal to downpayment,,8900,0
IFA9R3FI,3900,11/21/2019,8900,IFA9R3FI,12800,more than downpayment,equal to downpayment,0,3900
IFA9R3FI,3900,12/25/2019,8900,IFA9R3FI,16700,more than downpayment,more than downpayment,0,3900
IFA9R3FI,3900,1/24/2020,8900,IFA9R3FI,20600,more than downpayment,more than downpayment,0,3900
Ig6g0JiW,8900,5/13/2019,8900,,8900,equal to downpayment,,8900,0
Ig6g0JiW,3900,7/4/2019,8900,Ig6g0JiW,12800,more than downpayment,equal to downpayment,0,3900
Ig6g0JiW,2500,8/1/2019,8900,Ig6g0JiW,15300,more than downpayment,more than downpayment,0,2500
Ig6g0JiW,1400,8/4/2019,8900,Ig6g0JiW,16700,more than downpayment,more than downpayment,0,1400
Ig6g0JiW,3900,9/6/2019,8900,Ig6g0JiW,20600,more than downpayment,more than downpayment,0,3900
Ig6g0JiW,1200,10/5/2019,8900,Ig6g0JiW,21800,more than downpayment,more than downpayment,0,1200
Ig6g0JiW,2700,10/6/2019,8900,Ig6g0JiW,24500,more than downpayment,more than downpayment,0,2700
Ig6g0JiW,3900,11/4/2019,8900,Ig6g0JiW,28400,more than downpayment,more than downpayment,0,3900
Ig6g0JiW,3900,12/9/2019,8900,Ig6g0JiW,32300,more than downpayment,more than downpayment,0,3900
Ig6g0JiW,3900,1/6/2020,8900,Ig6g0JiW,36200,more than downpayment,more than downpayment,0,3900
Ig6g0JiW,1900,2/6/2020,8900,Ig6g0JiW,38100,more than downpayment,more than downpayment,0,1900
Igm1Xce9,5000,11/24/2018,10000,,5000,less than downpayment,,5000,0
Igm1Xce9,5000,11/28/2018,10000,Igm1Xce9,10000,equal to downpayment,less than downpayment,5000,0
Igm1Xce9,4500,1/3/2019,10000,Igm1Xce9,14500,more than downpayment,equal to downpayment,0,4500
Igm1Xce9,4500,2/5/2019,10000,Igm1Xce9,19000,more than downpayment,more than downpayment,0,4500
Igm1Xce9,4500,3/6/2019,10000,Igm1Xce9,23500,more than downpayment,more than downpayment,0,4500
Igm1Xce9,4500,4/4/2019,10000,Igm1Xce9,28000,more than downpayment,more than downpayment,0,4500
Igm1Xce9,4500,5/6/2019,10000,Igm1Xce9,32500,more than downpayment,more than downpayment,0,4500
Igm1Xce9,4500,6/10/2019,10000,Igm1Xce9,37000,more than downpayment,more than downpayment,0,4500
Igm1Xce9,4500,7/12/2019,10000,Igm1Xce9,41500,more than downpayment,more than downpayment,0,4500
Igm1Xce9,4500,10/5/2019,10000,Igm1Xce9,46000,more than downpayment,more than downpayment,0,4500
IGTB1F8G,9900,1/18/2020,9900,,9900,equal to downpayment,,9900,0
IHH7JFSX,9900,2/6/2020,9900,,9900,equal to downpayment,,9900,0
IHj9JebN,8900,5/21/2019,8900,,8900,equal to downpayment,,8900,0
IHj9JebN,1300,5/22/2019,8900,IHj9JebN,10200,more than downpayment,equal to downpayment,0,1300
IHj9JebN,2600,6/29/2019,8900,IHj9JebN,12800,more than downpayment,more than downpayment,0,2600
IHj9JebN,1950,7/27/2019,8900,IHj9JebN,14750,more than downpayment,more than downpayment,0,1950
IHj9JebN,1950,8/5/2019,8900,IHj9JebN,16700,more than downpayment,more than downpayment,0,1950
IHj9JebN,1300,9/1/2019,8900,IHj9JebN,18000,more than downpayment,more than downpayment,0,1300
IHj9JebN,2600,9/5/2019,8900,IHj9JebN,20600,more than downpayment,more than downpayment,0,2600
IHj9JebN,3900,9/27/2019,8900,IHj9JebN,24500,more than downpayment,more than downpayment,0,3900
IHj9JebN,1330,11/5/2019,8900,IHj9JebN,25830,more than downpayment,more than downpayment,0,1330
IHj9JebN,1300,11/8/2019,8900,IHj9JebN,27130,more than downpayment,more than downpayment,0,1300
IHj9JebN,1300,11/25/2019,8900,IHj9JebN,28430,more than downpayment,more than downpayment,0,1300
IHj9JebN,3900,12/4/2019,8900,IHj9JebN,32330,more than downpayment,more than downpayment,0,3900
IHj9JebN,650,12/18/2019,8900,IHj9JebN,32980,more than downpayment,more than downpayment,0,650
IHj9JebN,1300,12/30/2019,8900,IHj9JebN,34280,more than downpayment,more than downpayment,0,1300
IHj9JebN,3000,1/28/2020,8900,IHj9JebN,37280,more than downpayment,more than downpayment,0,3000
IhW18iKr,8900,11/21/2018,8900,,8900,equal to downpayment,,8900,0
IhW18iKr,3800,12/20/2018,8900,IhW18iKr,12700,more than downpayment,equal to downpayment,0,3800
IhW18iKr,100,12/23/2018,8900,IhW18iKr,12800,more than downpayment,more than downpayment,0,100
IhW18iKr,3900,1/18/2019,8900,IhW18iKr,16700,more than downpayment,more than downpayment,0,3900
IhW18iKr,3900,2/26/2019,8900,IhW18iKr,20600,more than downpayment,more than downpayment,0,3900
IhW18iKr,3900,3/31/2019,8900,IhW18iKr,24500,more than downpayment,more than downpayment,0,3900
IhW18iKr,3900,4/25/2019,8900,IhW18iKr,28400,more than downpayment,more than downpayment,0,3900
IhW18iKr,3900,6/3/2019,8900,IhW18iKr,32300,more than downpayment,more than downpayment,0,3900
IhW18iKr,3900,7/4/2019,8900,IhW18iKr,36200,more than downpayment,more than downpayment,0,3900
IhW18iKr,3900,8/4/2019,8900,IhW18iKr,40100,more than downpayment,more than downpayment,0,3900
IhW18iKr,3900,9/4/2019,8900,IhW18iKr,44000,more than downpayment,more than downpayment,0,3900
IhW18iKr,3900,10/6/2019,8900,IhW18iKr,47900,more than downpayment,more than downpayment,0,3900
IhW18iKr,3900,11/6/2019,8900,IhW18iKr,51800,more than downpayment,more than downpayment,0,3900
IhW18iKr,3900,12/11/2019,8900,IhW18iKr,55700,more than downpayment,more than downpayment,0,3900
IhW18iKr,3900,1/3/2020,8900,IhW18iKr,59600,more than downpayment,more than downpayment,0,3900
IIJ4UWF8,9900,1/16/2020,9900,,9900,equal to downpayment,,9900,0
IJgRXOpK,8900,1/14/2019,8900,,8900,equal to downpayment,,8900,0
IJgRXOpK,3900,2/25/2019,8900,IJgRXOpK,12800,more than downpayment,equal to downpayment,0,3900
IJgRXOpK,3900,3/25/2019,8900,IJgRXOpK,16700,more than downpayment,more than downpayment,0,3900
IJgRXOpK,3900,4/25/2019,8900,IJgRXOpK,20600,more than downpayment,more than downpayment,0,3900
IJgRXOpK,3900,5/25/2019,8900,IJgRXOpK,24500,more than downpayment,more than downpayment,0,3900
IJgRXOpK,3900,6/28/2019,8900,IJgRXOpK,28400,more than downpayment,more than downpayment,0,3900
IJgRXOpK,3900,8/8/2019,8900,IJgRXOpK,32300,more than downpayment,more than downpayment,0,3900
IJgRXOpK,3900,9/10/2019,8900,IJgRXOpK,36200,more than downpayment,more than downpayment,0,3900
IJgRXOpK,3900,10/10/2019,8900,IJgRXOpK,40100,more than downpayment,more than downpayment,0,3900
IJgRXOpK,3900,10/28/2019,8900,IJgRXOpK,44000,more than downpayment,more than downpayment,0,3900
IJgRXOpK,3900,11/26/2019,8900,IJgRXOpK,47900,more than downpayment,more than downpayment,0,3900
IJgRXOpK,3900,1/2/2020,8900,IJgRXOpK,51800,more than downpayment,more than downpayment,0,3900
IJJX1IS9,9900,6/6/2019,9900,,9900,equal to downpayment,,9900,0
IJJX1IS9,3500,7/3/2019,9900,IJJX1IS9,13400,more than downpayment,equal to downpayment,0,3500
IJJX1IS9,3900,7/9/2019,9900,IJJX1IS9,17300,more than downpayment,more than downpayment,0,3900
IJJX1IS9,3900,8/6/2019,9900,IJJX1IS9,21200,more than downpayment,more than downpayment,0,3900
IJJX1IS9,3900,9/14/2019,9900,IJJX1IS9,25100,more than downpayment,more than downpayment,0,3900
IJJX1IS9,3900,10/25/2019,9900,IJJX1IS9,29000,more than downpayment,more than downpayment,0,3900
IJJX1IS9,3900,11/25/2019,9900,IJJX1IS9,32900,more than downpayment,more than downpayment,0,3900
IJJX1IS9,3900,12/20/2019,9900,IJJX1IS9,36800,more than downpayment,more than downpayment,0,3900
IJJX1IS9,3900,1/21/2020,9900,IJJX1IS9,40700,more than downpayment,more than downpayment,0,3900
iKAJn87P,16700,5/30/2019,8900,,16700,more than downpayment,,8900,7800
iKAJn87P,10000,6/29/2019,8900,iKAJn87P,26700,more than downpayment,more than downpayment,0,10000
iKAJn87P,7800,8/24/2019,8900,iKAJn87P,34500,more than downpayment,more than downpayment,0,7800
iKAJn87P,10000,12/5/2019,8900,iKAJn87P,44500,more than downpayment,more than downpayment,0,10000
IkczktQc,8900,2/5/2019,10000,,8900,less than downpayment,,8900,0
IkczktQc,1100,2/8/2019,10000,IkczktQc,10000,equal to downpayment,less than downpayment,1100,0
IkczktQc,4500,3/25/2019,10000,IkczktQc,14500,more than downpayment,equal to downpayment,0,4500
IkczktQc,4500,5/7/2019,10000,IkczktQc,19000,more than downpayment,more than downpayment,0,4500
IkczktQc,4500,6/21/2019,10000,IkczktQc,23500,more than downpayment,more than downpayment,0,4500
IkczktQc,2500,7/27/2019,10000,IkczktQc,26000,more than downpayment,more than downpayment,0,2500
IkczktQc,1500,8/5/2019,10000,IkczktQc,27500,more than downpayment,more than downpayment,0,1500
IkczktQc,2000,8/15/2019,10000,IkczktQc,29500,more than downpayment,more than downpayment,0,2000
IkczktQc,2000,8/26/2019,10000,IkczktQc,31500,more than downpayment,more than downpayment,0,2000
IkczktQc,2000,9/20/2019,10000,IkczktQc,33500,more than downpayment,more than downpayment,0,2000
IkczktQc,3000,9/29/2019,10000,IkczktQc,36500,more than downpayment,more than downpayment,0,3000
IkczktQc,400,10/1/2019,10000,IkczktQc,36900,more than downpayment,more than downpayment,0,400
IkczktQc,2000,11/1/2019,10000,IkczktQc,38900,more than downpayment,more than downpayment,0,2000
IkczktQc,2000,11/27/2019,10000,IkczktQc,40900,more than downpayment,more than downpayment,0,2000
IkczktQc,2000,12/31/2019,10000,IkczktQc,42900,more than downpayment,more than downpayment,0,2000
IkczktQc,2000,1/23/2020,10000,IkczktQc,44900,more than downpayment,more than downpayment,0,2000
IKFW3CMC,2000,2/3/2020,7900,,2000,less than downpayment,,2000,0
IKFW3CMC,1100,2/4/2020,7900,IKFW3CMC,3100,less than downpayment,less than downpayment,1100,0
IKNHFERP,9900,11/6/2019,9900,,9900,equal to downpayment,,9900,0
IKNHFERP,3900,12/24/2019,9900,IKNHFERP,13800,more than downpayment,equal to downpayment,0,3900
IKNHFERP,3900,1/30/2020,9900,IKNHFERP,17700,more than downpayment,more than downpayment,0,3900
iKWrwgoN,8900,5/16/2019,8900,,8900,equal to downpayment,,8900,0
iKWrwgoN,3900,6/25/2019,8900,iKWrwgoN,12800,more than downpayment,equal to downpayment,0,3900
iKWrwgoN,3900,8/1/2019,8900,iKWrwgoN,16700,more than downpayment,more than downpayment,0,3900
iKWrwgoN,3900,9/6/2019,8900,iKWrwgoN,20600,more than downpayment,more than downpayment,0,3900
iKWrwgoN,1000,9/20/2019,8900,iKWrwgoN,21600,more than downpayment,more than downpayment,0,1000
iKWrwgoN,2650,10/5/2019,8900,iKWrwgoN,24250,more than downpayment,more than downpayment,0,2650
iKWrwgoN,250,10/17/2019,8900,iKWrwgoN,24500,more than downpayment,more than downpayment,0,250
ILRTJOXM,5000,12/18/2019,4999,,5000,more than downpayment,,4999,1
ImKic5Ah,8900,2/7/2019,8900,,8900,equal to downpayment,,8900,0
IN3MUYUT,9900,8/1/2019,9900,,9900,equal to downpayment,,9900,0
INHFV5A3,5000,9/20/2019,9900,,5000,less than downpayment,,5000,0
INHFV5A3,4900,9/23/2019,9900,INHFV5A3,9900,equal to downpayment,less than downpayment,4900,0
INHFV5A3,3900,11/22/2019,9900,INHFV5A3,13800,more than downpayment,equal to downpayment,0,3900
INHFV5A3,3900,1/1/2020,9900,INHFV5A3,17700,more than downpayment,more than downpayment,0,3900
INHFV5A3,3900,1/23/2020,9900,INHFV5A3,21600,more than downpayment,more than downpayment,0,3900
Ino2Neui,15606,6/8/2019,8900,,15606,more than downpayment,,8900,6706
Ino2Neui,3900,7/24/2019,8900,Ino2Neui,19506,more than downpayment,more than downpayment,0,3900
Ino2Neui,3900,8/24/2019,8900,Ino2Neui,23406,more than downpayment,more than downpayment,0,3900
Ino2Neui,3900,9/26/2019,8900,Ino2Neui,27306,more than downpayment,more than downpayment,0,3900
Ino2Neui,3900,10/27/2019,8900,Ino2Neui,31206,more than downpayment,more than downpayment,0,3900
Ino2Neui,3900,11/27/2019,8900,Ino2Neui,35106,more than downpayment,more than downpayment,0,3900
Ino2Neui,3900,1/4/2020,8900,Ino2Neui,39006,more than downpayment,more than downpayment,0,3900
iNxZSI4u,9900,7/30/2019,8900,,9900,more than downpayment,,8900,1000
iNxZSI4u,3000,8/29/2019,8900,iNxZSI4u,12900,more than downpayment,more than downpayment,0,3000
iNxZSI4u,3900,9/26/2019,8900,iNxZSI4u,16800,more than downpayment,more than downpayment,0,3900
iNxZSI4u,3900,11/4/2019,8900,iNxZSI4u,20700,more than downpayment,more than downpayment,0,3900
iNxZSI4u,3900,11/30/2019,8900,iNxZSI4u,24600,more than downpayment,more than downpayment,0,3900
iNxZSI4u,3900,1/1/2020,8900,iNxZSI4u,28500,more than downpayment,more than downpayment,0,3900
iNxZSI4u,3900,1/30/2020,8900,iNxZSI4u,32400,more than downpayment,more than downpayment,0,3900
IOb5pVez,10000,11/1/2018,9900,,10000,more than downpayment,,9900,100
IOb5pVez,17000,11/11/2018,9900,IOb5pVez,27000,more than downpayment,more than downpayment,0,17000
IOb5pVez,4500,2/28/2019,9900,IOb5pVez,31500,more than downpayment,more than downpayment,0,4500
IOb5pVez,4500,4/5/2019,9900,IOb5pVez,36000,more than downpayment,more than downpayment,0,4500
IOb5pVez,4500,5/29/2019,9900,IOb5pVez,40500,more than downpayment,more than downpayment,0,4500
IOb5pVez,4500,7/2/2019,9900,IOb5pVez,45000,more than downpayment,more than downpayment,0,4500
IOb5pVez,4500,8/17/2019,9900,IOb5pVez,49500,more than downpayment,more than downpayment,0,4500
IOb5pVez,4500,9/5/2019,9900,IOb5pVez,54000,more than downpayment,more than downpayment,0,4500
IOb5pVez,4500,10/10/2019,9900,IOb5pVez,58500,more than downpayment,more than downpayment,0,4500
IOb5pVez,4500,11/29/2019,9900,IOb5pVez,63000,more than downpayment,more than downpayment,0,4500
IOb5pVez,5000,2/3/2020,9900,IOb5pVez,68000,more than downpayment,more than downpayment,0,5000
IOP1GB6C,1600,10/14/2019,1594,,1600,more than downpayment,,1594,6
Iqdh9GtB,8900,7/26/2019,8900,,8900,equal to downpayment,,8900,0
Iqdh9GtB,3900,9/10/2019,8900,Iqdh9GtB,12800,more than downpayment,equal to downpayment,0,3900
Iqdh9GtB,3900,10/14/2019,8900,Iqdh9GtB,16700,more than downpayment,more than downpayment,0,3900
Iqdh9GtB,3900,11/13/2019,8900,Iqdh9GtB,20600,more than downpayment,more than downpayment,0,3900
Iqdh9GtB,10300,12/18/2019,8900,Iqdh9GtB,30900,more than downpayment,more than downpayment,0,10300
IqI5eh4O,14000,9/28/2017,14000,,14000,equal to downpayment,,14000,0
IqI5eh4O,6000,11/4/2017,14000,IqI5eh4O,20000,more than downpayment,equal to downpayment,0,6000
IqI5eh4O,4000,2/12/2018,14000,IqI5eh4O,24000,more than downpayment,more than downpayment,0,4000
IqI5eh4O,6300,3/14/2018,14000,IqI5eh4O,30300,more than downpayment,more than downpayment,0,6300
IqI5eh4O,6300,4/3/2018,14000,IqI5eh4O,36600,more than downpayment,more than downpayment,0,6300
IqI5eh4O,6300,5/4/2018,14000,IqI5eh4O,42900,more than downpayment,more than downpayment,0,6300
IqI5eh4O,6300,6/11/2018,14000,IqI5eh4O,49200,more than downpayment,more than downpayment,0,6300
IqI5eh4O,6300,7/4/2018,14000,IqI5eh4O,55500,more than downpayment,more than downpayment,0,6300
IqI5eh4O,6300,8/9/2018,14000,IqI5eh4O,61800,more than downpayment,more than downpayment,0,6300
IqI5eh4O,4000,8/20/2018,14000,IqI5eh4O,65800,more than downpayment,more than downpayment,0,4000
IqI5eh4O,6300,9/11/2018,14000,IqI5eh4O,72100,more than downpayment,more than downpayment,0,6300
IqI5eh4O,4900,9/18/2018,14000,IqI5eh4O,77000,more than downpayment,more than downpayment,0,4900
iQr7azn8,9900,6/10/2019,9900,,9900,equal to downpayment,,9900,0
iQr7azn8,3500,9/20/2019,9900,iQr7azn8,13400,more than downpayment,equal to downpayment,0,3500
iQr7azn8,400,10/10/2019,9900,iQr7azn8,13800,more than downpayment,more than downpayment,0,400
iQr7azn8,2000,12/9/2019,9900,iQr7azn8,15800,more than downpayment,more than downpayment,0,2000
iQr7azn8,2000,1/10/2020,9900,iQr7azn8,17800,more than downpayment,more than downpayment,0,2000
iQr7azn8,2000,1/29/2020,9900,iQr7azn8,19800,more than downpayment,more than downpayment,0,2000
iQr7azn8,1000,2/3/2020,9900,iQr7azn8,20800,more than downpayment,more than downpayment,0,1000
IR2FC14T,8900,9/23/2019,8900,,8900,equal to downpayment,,8900,0
IR2FC14T,3900,11/9/2019,8900,IR2FC14T,12800,more than downpayment,equal to downpayment,0,3900
IR2FC14T,3900,12/11/2019,8900,IR2FC14T,16700,more than downpayment,more than downpayment,0,3900
IR2FC14T,3900,1/13/2020,8900,IR2FC14T,20600,more than downpayment,more than downpayment,0,3900
irCiwDtN,9900,6/29/2019,8900,,9900,more than downpayment,,8900,1000
irCiwDtN,4000,9/10/2019,8900,irCiwDtN,13900,more than downpayment,more than downpayment,0,4000
irCiwDtN,3900,10/8/2019,8900,irCiwDtN,17800,more than downpayment,more than downpayment,0,3900
irCiwDtN,3900,11/8/2019,8900,irCiwDtN,21700,more than downpayment,more than downpayment,0,3900
irCiwDtN,3900,12/6/2019,8900,irCiwDtN,25600,more than downpayment,more than downpayment,0,3900
irCiwDtN,3900,1/14/2020,8900,irCiwDtN,29500,more than downpayment,more than downpayment,0,3900
irCiwDtN,3900,2/8/2020,8900,irCiwDtN,33400,more than downpayment,more than downpayment,0,3900
IRCWDJIH,10000,12/8/2019,9900,,10000,more than downpayment,,9900,100
IRCWDJIH,3900,2/7/2020,9900,IRCWDJIH,13900,more than downpayment,more than downpayment,0,3900
IRycn1v2,8900,1/17/2019,8900,,8900,equal to downpayment,,8900,0
IRycn1v2,3900,2/5/2019,8900,IRycn1v2,12800,more than downpayment,equal to downpayment,0,3900
IRycn1v2,3900,3/6/2019,8900,IRycn1v2,16700,more than downpayment,more than downpayment,0,3900
IRycn1v2,3900,4/13/2019,8900,IRycn1v2,20600,more than downpayment,more than downpayment,0,3900
IRycn1v2,3900,5/15/2019,8900,IRycn1v2,24500,more than downpayment,more than downpayment,0,3900
IRycn1v2,3900,6/15/2019,8900,IRycn1v2,28400,more than downpayment,more than downpayment,0,3900
IRycn1v2,3900,7/15/2019,8900,IRycn1v2,32300,more than downpayment,more than downpayment,0,3900
IRycn1v2,3900,8/15/2019,8900,IRycn1v2,36200,more than downpayment,more than downpayment,0,3900
IRycn1v2,3900,9/16/2019,8900,IRycn1v2,40100,more than downpayment,more than downpayment,0,3900
IRycn1v2,3900,10/15/2019,8900,IRycn1v2,44000,more than downpayment,more than downpayment,0,3900
IRycn1v2,4900,11/5/2019,8900,IRycn1v2,48900,more than downpayment,more than downpayment,0,4900
IRycn1v2,3900,11/19/2019,8900,IRycn1v2,52800,more than downpayment,more than downpayment,0,3900
IRycn1v2,3900,12/17/2019,8900,IRycn1v2,56700,more than downpayment,more than downpayment,0,3900
IRycn1v2,3900,1/15/2020,8900,IRycn1v2,60600,more than downpayment,more than downpayment,0,3900
IS2OFPCJ,8900,11/19/2018,8900,,8900,equal to downpayment,,8900,0
IS2OFPCJ,4000,12/17/2018,8900,IS2OFPCJ,12900,more than downpayment,equal to downpayment,0,4000
IS2OFPCJ,3900,1/22/2019,8900,IS2OFPCJ,16800,more than downpayment,more than downpayment,0,3900
IS2OFPCJ,3900,2/25/2019,8900,IS2OFPCJ,20700,more than downpayment,more than downpayment,0,3900
IS2OFPCJ,2900,3/25/2019,8900,IS2OFPCJ,23600,more than downpayment,more than downpayment,0,2900
IS2OFPCJ,970,3/26/2019,8900,IS2OFPCJ,24570,more than downpayment,more than downpayment,0,970
IS2OFPCJ,3900,4/22/2019,8900,IS2OFPCJ,28470,more than downpayment,more than downpayment,0,3900
IS2OFPCJ,3900,5/22/2019,8900,IS2OFPCJ,32370,more than downpayment,more than downpayment,0,3900
IS2OFPCJ,4000,7/15/2019,8900,IS2OFPCJ,36370,more than downpayment,more than downpayment,0,4000
IS2OFPCJ,2900,8/27/2019,8900,IS2OFPCJ,39270,more than downpayment,more than downpayment,0,2900
IS2OFPCJ,1000,9/3/2019,8900,IS2OFPCJ,40270,more than downpayment,more than downpayment,0,1000
IS2OFPCJ,2000,9/25/2019,8900,IS2OFPCJ,42270,more than downpayment,more than downpayment,0,2000
IS2OFPCJ,2000,9/30/2019,8900,IS2OFPCJ,44270,more than downpayment,more than downpayment,0,2000
IS2OFPCJ,2000,10/15/2019,8900,IS2OFPCJ,46270,more than downpayment,more than downpayment,0,2000
IS2OFPCJ,1000,10/21/2019,8900,IS2OFPCJ,47270,more than downpayment,more than downpayment,0,1000
IS2OFPCJ,4000,11/21/2019,8900,IS2OFPCJ,51270,more than downpayment,more than downpayment,0,4000
IS2OFPCJ,4000,12/23/2019,8900,IS2OFPCJ,55270,more than downpayment,more than downpayment,0,4000
IS2OFPCJ,4000,1/20/2020,8900,IS2OFPCJ,59270,more than downpayment,more than downpayment,0,4000
ISRB128Y,9900,7/18/2019,9900,,9900,equal to downpayment,,9900,0
ISRB128Y,7800,9/13/2019,9900,ISRB128Y,17700,more than downpayment,equal to downpayment,0,7800
ISRB128Y,1500,11/29/2019,9900,ISRB128Y,19200,more than downpayment,more than downpayment,0,1500
ISRB128Y,10200,12/10/2019,9900,ISRB128Y,29400,more than downpayment,more than downpayment,0,10200
ISXANRYU,7900,1/8/2020,7900,,7900,equal to downpayment,,7900,0
ITAKKMAI,4900,12/16/2019,9900,,4900,less than downpayment,,4900,0
ITAKKMAI,5000,12/25/2019,9900,ITAKKMAI,9900,equal to downpayment,less than downpayment,5000,0
itrEKU0j,100,7/30/2019,8900,,100,less than downpayment,,100,0
iTRIKvEJ,10000,11/6/2018,10000,,10000,equal to downpayment,,10000,0
iTRIKvEJ,4500,12/7/2018,10000,iTRIKvEJ,14500,more than downpayment,equal to downpayment,0,4500
iTRIKvEJ,4500,1/7/2019,10000,iTRIKvEJ,19000,more than downpayment,more than downpayment,0,4500
iTRIKvEJ,4500,2/15/2019,10000,iTRIKvEJ,23500,more than downpayment,more than downpayment,0,4500
iTRIKvEJ,4500,3/6/2019,10000,iTRIKvEJ,28000,more than downpayment,more than downpayment,0,4500
iTRIKvEJ,4500,4/5/2019,10000,iTRIKvEJ,32500,more than downpayment,more than downpayment,0,4500
iTRIKvEJ,4500,5/10/2019,10000,iTRIKvEJ,37000,more than downpayment,more than downpayment,0,4500
iTRIKvEJ,4500,6/10/2019,10000,iTRIKvEJ,41500,more than downpayment,more than downpayment,0,4500
iTRIKvEJ,4500,7/12/2019,10000,iTRIKvEJ,46000,more than downpayment,more than downpayment,0,4500
iTRIKvEJ,4500,8/8/2019,10000,iTRIKvEJ,50500,more than downpayment,more than downpayment,0,4500
iTRIKvEJ,4500,9/7/2019,10000,iTRIKvEJ,55000,more than downpayment,more than downpayment,0,4500
iTRIKvEJ,5000,10/9/2019,10000,iTRIKvEJ,60000,more than downpayment,more than downpayment,0,5000
iTRIKvEJ,4000,1/16/2020,10000,iTRIKvEJ,64000,more than downpayment,more than downpayment,0,4000
IuDni7lX,10000,11/28/2018,10000,,10000,equal to downpayment,,10000,0
IuDni7lX,42000,1/10/2019,10000,IuDni7lX,52000,more than downpayment,equal to downpayment,0,42000
IUJTXDH1,9900,12/15/2019,9900,,9900,equal to downpayment,,9900,0
IVI3O5BG,5000,12/20/2019,4999,,5000,more than downpayment,,4999,1
IVI3O5BG,3100,2/4/2020,4999,IVI3O5BG,8100,more than downpayment,more than downpayment,0,3100
iVsGUoLg,8900,2/13/2019,8900,,8900,equal to downpayment,,8900,0
iVsGUoLg,3900,3/21/2019,8900,iVsGUoLg,12800,more than downpayment,equal to downpayment,0,3900
iVsGUoLg,3900,4/23/2019,8900,iVsGUoLg,16700,more than downpayment,more than downpayment,0,3900
iVsGUoLg,3900,5/25/2019,8900,iVsGUoLg,20600,more than downpayment,more than downpayment,0,3900
iVsGUoLg,3900,6/21/2019,8900,iVsGUoLg,24500,more than downpayment,more than downpayment,0,3900
iVsGUoLg,3900,7/23/2019,8900,iVsGUoLg,28400,more than downpayment,more than downpayment,0,3900
iVsGUoLg,3900,8/21/2019,8900,iVsGUoLg,32300,more than downpayment,more than downpayment,0,3900
iVsGUoLg,3900,9/30/2019,8900,iVsGUoLg,36200,more than downpayment,more than downpayment,0,3900
iVsGUoLg,3900,10/25/2019,8900,iVsGUoLg,40100,more than downpayment,more than downpayment,0,3900
iVsGUoLg,3900,11/21/2019,8900,iVsGUoLg,44000,more than downpayment,more than downpayment,0,3900
iVsGUoLg,3900,12/26/2019,8900,iVsGUoLg,47900,more than downpayment,more than downpayment,0,3900
iVsGUoLg,3900,1/22/2020,8900,iVsGUoLg,51800,more than downpayment,more than downpayment,0,3900
IVUBX8KN,9990,10/14/2019,9900,,9990,more than downpayment,,9900,90
IVUBX8KN,4000,12/15/2019,9900,IVUBX8KN,13990,more than downpayment,more than downpayment,0,4000
IVUBX8KN,3800,1/29/2020,9900,IVUBX8KN,17790,more than downpayment,more than downpayment,0,3800
IWQW1K64,9900,2/4/2020,9900,,9900,equal to downpayment,,9900,0
IX2SZFIK,9900,11/14/2019,9900,,9900,equal to downpayment,,9900,0
IX2SZFIK,3900,12/27/2019,9900,IX2SZFIK,13800,more than downpayment,equal to downpayment,0,3900
IX2SZFIK,3900,2/2/2020,9900,IX2SZFIK,17700,more than downpayment,more than downpayment,0,3900
ixsO1c1T,9900,11/9/2018,9900,,9900,equal to downpayment,,9900,0
ixsO1c1T,6000,1/16/2019,9900,ixsO1c1T,15900,more than downpayment,equal to downpayment,0,6000
ixsO1c1T,3000,2/1/2019,9900,ixsO1c1T,18900,more than downpayment,more than downpayment,0,3000
ixsO1c1T,4500,2/17/2019,9900,ixsO1c1T,23400,more than downpayment,more than downpayment,0,4500
ixsO1c1T,4500,3/22/2019,9900,ixsO1c1T,27900,more than downpayment,more than downpayment,0,4500
ixsO1c1T,4500,5/2/2019,9900,ixsO1c1T,32400,more than downpayment,more than downpayment,0,4500
ixsO1c1T,4500,5/31/2019,9900,ixsO1c1T,36900,more than downpayment,more than downpayment,0,4500
ixsO1c1T,9000,7/10/2019,9900,ixsO1c1T,45900,more than downpayment,more than downpayment,0,9000
ixsO1c1T,5000,1/28/2020,9900,ixsO1c1T,50900,more than downpayment,more than downpayment,0,5000
IYYAPQOO,9900,1/16/2020,9900,,9900,equal to downpayment,,9900,0
iZdNQ1uT,9900,7/3/2019,9900,,9900,equal to downpayment,,9900,0
iZdNQ1uT,3900,8/22/2019,9900,iZdNQ1uT,13800,more than downpayment,equal to downpayment,0,3900
iZdNQ1uT,3900,9/24/2019,9900,iZdNQ1uT,17700,more than downpayment,more than downpayment,0,3900
iZdNQ1uT,3900,10/24/2019,9900,iZdNQ1uT,21600,more than downpayment,more than downpayment,0,3900
iZdNQ1uT,3900,11/22/2019,9900,iZdNQ1uT,25500,more than downpayment,more than downpayment,0,3900
iZdNQ1uT,3900,12/27/2019,9900,iZdNQ1uT,29400,more than downpayment,more than downpayment,0,3900
iZdNQ1uT,3900,1/23/2020,9900,iZdNQ1uT,33300,more than downpayment,more than downpayment,0,3900
IZHCYAdd,10000,11/1/2018,10000,,10000,equal to downpayment,,10000,0
IZHCYAdd,10000,12/4/2018,10000,IZHCYAdd,20000,more than downpayment,equal to downpayment,0,10000
IZHCYAdd,10000,1/3/2019,10000,IZHCYAdd,30000,more than downpayment,more than downpayment,0,10000
IZHCYAdd,4500,2/4/2019,10000,IZHCYAdd,34500,more than downpayment,more than downpayment,0,4500
IZHCYAdd,4500,3/4/2019,10000,IZHCYAdd,39000,more than downpayment,more than downpayment,0,4500
IZHCYAdd,10000,4/3/2019,10000,IZHCYAdd,49000,more than downpayment,more than downpayment,0,10000
IZHCYAdd,9000,5/4/2019,10000,IZHCYAdd,58000,more than downpayment,more than downpayment,0,9000
izsg2OEv,10000,9/26/2018,10000,,10000,equal to downpayment,,10000,0
izsg2OEv,5000,10/27/2018,10000,izsg2OEv,15000,more than downpayment,equal to downpayment,0,5000
izsg2OEv,5000,11/21/2018,10000,izsg2OEv,20000,more than downpayment,more than downpayment,0,5000
izsg2OEv,5000,1/1/2019,10000,izsg2OEv,25000,more than downpayment,more than downpayment,0,5000
izsg2OEv,5000,2/12/2019,10000,izsg2OEv,30000,more than downpayment,more than downpayment,0,5000
izsg2OEv,5000,3/6/2019,10000,izsg2OEv,35000,more than downpayment,more than downpayment,0,5000
izsg2OEv,5000,4/13/2019,10000,izsg2OEv,40000,more than downpayment,more than downpayment,0,5000
izsg2OEv,5000,5/6/2019,10000,izsg2OEv,45000,more than downpayment,more than downpayment,0,5000
izsg2OEv,6000,6/17/2019,10000,izsg2OEv,51000,more than downpayment,more than downpayment,0,6000
izsg2OEv,5000,7/18/2019,10000,izsg2OEv,56000,more than downpayment,more than downpayment,0,5000
izsg2OEv,4500,8/12/2019,10000,izsg2OEv,60500,more than downpayment,more than downpayment,0,4500
izsg2OEv,3500,10/15/2019,10000,izsg2OEv,64000,more than downpayment,more than downpayment,0,3500
j0zLowII,9900,7/10/2019,9900,,9900,equal to downpayment,,9900,0
j0zLowII,6742,8/1/2019,9900,j0zLowII,16642,more than downpayment,equal to downpayment,0,6742
j0zLowII,3900,8/26/2019,9900,j0zLowII,20542,more than downpayment,more than downpayment,0,3900
j0zLowII,3900,9/26/2019,9900,j0zLowII,24442,more than downpayment,more than downpayment,0,3900
j0zLowII,3900,10/26/2019,9900,j0zLowII,28342,more than downpayment,more than downpayment,0,3900
j0zLowII,3900,11/26/2019,9900,j0zLowII,32242,more than downpayment,more than downpayment,0,3900
J1KY1IK2,9900,9/9/2019,9900,,9900,equal to downpayment,,9900,0
J1KY1IK2,3900,11/27/2019,9900,J1KY1IK2,13800,more than downpayment,equal to downpayment,0,3900
J1KY1IK2,700,1/31/2020,9900,J1KY1IK2,14500,more than downpayment,more than downpayment,0,700
J1KY1IK2,300,2/3/2020,9900,J1KY1IK2,14800,more than downpayment,more than downpayment,0,300
J1KY1IK2,200,2/6/2020,9900,J1KY1IK2,15000,more than downpayment,more than downpayment,0,200
J21LETLP,9900,7/25/2019,9900,,9900,equal to downpayment,,9900,0
J21LETLP,4000,9/9/2019,9900,J21LETLP,13900,more than downpayment,equal to downpayment,0,4000
J21LETLP,3500,10/15/2019,9900,J21LETLP,17400,more than downpayment,more than downpayment,0,3500
J21LETLP,300,11/1/2019,9900,J21LETLP,17700,more than downpayment,more than downpayment,0,300
J21LETLP,2400,11/15/2019,9900,J21LETLP,20100,more than downpayment,more than downpayment,0,2400
J21LETLP,1500,11/30/2019,9900,J21LETLP,21600,more than downpayment,more than downpayment,0,1500
J21LETLP,1000,12/17/2019,9900,J21LETLP,22600,more than downpayment,more than downpayment,0,1000
J21LETLP,1000,12/23/2019,9900,J21LETLP,23600,more than downpayment,more than downpayment,0,1000
J21LETLP,1000,1/2/2020,9900,J21LETLP,24600,more than downpayment,more than downpayment,0,1000
J21LETLP,900,1/9/2020,9900,J21LETLP,25500,more than downpayment,more than downpayment,0,900
J21LETLP,2000,1/26/2020,9900,J21LETLP,27500,more than downpayment,more than downpayment,0,2000
J21LETLP,1900,2/4/2020,9900,J21LETLP,29400,more than downpayment,more than downpayment,0,1900
j2bDBw5S,10000,8/30/2017,10000,,10000,equal to downpayment,,10000,0
j2bDBw5S,3580,10/6/2017,10000,j2bDBw5S,13580,more than downpayment,equal to downpayment,0,3580
j2bDBw5S,3500,11/8/2017,10000,j2bDBw5S,17080,more than downpayment,more than downpayment,0,3500
j2bDBw5S,3500,12/12/2017,10000,j2bDBw5S,20580,more than downpayment,more than downpayment,0,3500
j2bDBw5S,3500,1/8/2018,10000,j2bDBw5S,24080,more than downpayment,more than downpayment,0,3500
j2bDBw5S,3500,2/12/2018,10000,j2bDBw5S,27580,more than downpayment,more than downpayment,0,3500
j2bDBw5S,3500,3/12/2018,10000,j2bDBw5S,31080,more than downpayment,more than downpayment,0,3500
j2bDBw5S,3500,4/18/2018,10000,j2bDBw5S,34580,more than downpayment,more than downpayment,0,3500
j2bDBw5S,5420,6/21/2018,10000,j2bDBw5S,40000,more than downpayment,more than downpayment,0,5420
J2I75AHO,9900,8/25/2019,9900,,9900,equal to downpayment,,9900,0
J2I75AHO,3900,11/28/2019,9900,J2I75AHO,13800,more than downpayment,equal to downpayment,0,3900
J2I75AHO,7106,12/30/2019,9900,J2I75AHO,20906,more than downpayment,more than downpayment,0,7106
J2I75AHO,4500,2/7/2020,9900,J2I75AHO,25406,more than downpayment,more than downpayment,0,4500
J2PTVFNN,9900,10/31/2019,9900,,9900,equal to downpayment,,9900,0
J2PTVFNN,3900,12/5/2019,9900,J2PTVFNN,13800,more than downpayment,equal to downpayment,0,3900
J2PTVFNN,3500,1/4/2020,9900,J2PTVFNN,17300,more than downpayment,more than downpayment,0,3500
J2PTVFNN,400,1/14/2020,9900,J2PTVFNN,17700,more than downpayment,more than downpayment,0,400
J2PTVFNN,1800,1/28/2020,9900,J2PTVFNN,19500,more than downpayment,more than downpayment,0,1800
J2PTVFNN,450,2/4/2020,9900,J2PTVFNN,19950,more than downpayment,more than downpayment,0,450
J2PTVFNN,200,2/5/2020,9900,J2PTVFNN,20150,more than downpayment,more than downpayment,0,200
J4AZHV49,9900,7/30/2019,9900,,9900,equal to downpayment,,9900,0
J4AZHV49,3000,10/1/2019,9900,J4AZHV49,12900,more than downpayment,equal to downpayment,0,3000
J4AZHV49,2500,11/5/2019,9900,J4AZHV49,15400,more than downpayment,more than downpayment,0,2500
J4AZHV49,15000,1/29/2020,9900,J4AZHV49,30400,more than downpayment,more than downpayment,0,15000
J4btgTCW,8900,1/27/2019,8900,,8900,equal to downpayment,,8900,0
J4btgTCW,3900,4/4/2019,8900,J4btgTCW,12800,more than downpayment,equal to downpayment,0,3900
J6KUPWJ7,7000,1/23/2020,8900,,7000,less than downpayment,,7000,0
J6KUPWJ7,1900,1/25/2020,8900,J6KUPWJ7,8900,equal to downpayment,less than downpayment,1900,0
J6WB1XWH,9900,11/13/2019,9900,,9900,equal to downpayment,,9900,0
J6WB1XWH,3900,1/2/2020,9900,J6WB1XWH,13800,more than downpayment,equal to downpayment,0,3900
J6WB1XWH,3900,2/1/2020,9900,J6WB1XWH,17700,more than downpayment,more than downpayment,0,3900
J7hc9rNW,9900,6/25/2019,9900,,9900,equal to downpayment,,9900,0
J7hc9rNW,4000,8/5/2019,9900,J7hc9rNW,13900,more than downpayment,equal to downpayment,0,4000
J7hc9rNW,3900,8/27/2019,9900,J7hc9rNW,17800,more than downpayment,more than downpayment,0,3900
J7hc9rNW,3900,9/30/2019,9900,J7hc9rNW,21700,more than downpayment,more than downpayment,0,3900
J7hc9rNW,3900,11/7/2019,9900,J7hc9rNW,25600,more than downpayment,more than downpayment,0,3900
J7hc9rNW,3900,12/6/2019,9900,J7hc9rNW,29500,more than downpayment,more than downpayment,0,3900
J7hc9rNW,3900,1/6/2020,9900,J7hc9rNW,33400,more than downpayment,more than downpayment,0,3900
J7hc9rNW,3900,2/5/2020,9900,J7hc9rNW,37300,more than downpayment,more than downpayment,0,3900
J8IIXPEI,9000,1/25/2020,9900,,9000,less than downpayment,,9000,0
J8IIXPEI,900,1/28/2020,9900,J8IIXPEI,9900,equal to downpayment,less than downpayment,900,0
J9g4L2Vo,23500,7/30/2019,23400,,23500,more than downpayment,,23400,100
J9g4L2Vo,10600,8/20/2019,23400,J9g4L2Vo,34100,more than downpayment,more than downpayment,0,10600
J9g4L2Vo,8500,9/10/2019,23400,J9g4L2Vo,42600,more than downpayment,more than downpayment,0,8500
J9g4L2Vo,8500,10/29/2019,23400,J9g4L2Vo,51100,more than downpayment,more than downpayment,0,8500
J9g4L2Vo,7300,12/19/2019,23400,J9g4L2Vo,58400,more than downpayment,more than downpayment,0,7300
J9g4L2Vo,7300,1/13/2020,23400,J9g4L2Vo,65700,more than downpayment,more than downpayment,0,7300
J9g4L2Vo,7300,1/25/2020,23400,J9g4L2Vo,73000,more than downpayment,more than downpayment,0,7300
J9IMoaBS,9900,9/6/2019,9900,,9900,equal to downpayment,,9900,0
J9IMoaBS,3900,11/5/2019,9900,J9IMoaBS,13800,more than downpayment,equal to downpayment,0,3900
J9IMoaBS,3900,12/5/2019,9900,J9IMoaBS,17700,more than downpayment,more than downpayment,0,3900
J9IMoaBS,3900,1/7/2020,9900,J9IMoaBS,21600,more than downpayment,more than downpayment,0,3900
J9IMoaBS,3900,2/6/2020,9900,J9IMoaBS,25500,more than downpayment,more than downpayment,0,3900
j9yEPJRy,3900,5/24/2019,0,,3900,more than downpayment,,0,3900
j9yEPJRy,3900,6/24/2019,0,j9yEPJRy,7800,more than downpayment,more than downpayment,0,3900
j9yEPJRy,3900,7/19/2019,0,j9yEPJRy,11700,more than downpayment,more than downpayment,0,3900
j9yEPJRy,3900,8/24/2019,0,j9yEPJRy,15600,more than downpayment,more than downpayment,0,3900
j9yEPJRy,1900,10/2/2019,0,j9yEPJRy,17500,more than downpayment,more than downpayment,0,1900
j9yEPJRy,2000,10/14/2019,0,j9yEPJRy,19500,more than downpayment,more than downpayment,0,2000
j9yEPJRy,2500,10/28/2019,0,j9yEPJRy,22000,more than downpayment,more than downpayment,0,2500
j9yEPJRy,1400,10/31/2019,0,j9yEPJRy,23400,more than downpayment,more than downpayment,0,1400
j9yEPJRy,3900,11/26/2019,0,j9yEPJRy,27300,more than downpayment,more than downpayment,0,3900
j9yEPJRy,2000,12/27/2019,0,j9yEPJRy,29300,more than downpayment,more than downpayment,0,2000
j9yEPJRy,1900,1/5/2020,0,j9yEPJRy,31200,more than downpayment,more than downpayment,0,1900
j9yEPJRy,4000,1/20/2020,0,j9yEPJRy,35200,more than downpayment,more than downpayment,0,4000
JAWOI5BN,8900,8/27/2019,8900,,8900,equal to downpayment,,8900,0
JAWOI5BN,3900,10/15/2019,8900,JAWOI5BN,12800,more than downpayment,equal to downpayment,0,3900
JAWOI5BN,3900,11/17/2019,8900,JAWOI5BN,16700,more than downpayment,more than downpayment,0,3900
JAWOI5BN,3900,12/16/2019,8900,JAWOI5BN,20600,more than downpayment,more than downpayment,0,3900
JAWOI5BN,3900,1/15/2020,8900,JAWOI5BN,24500,more than downpayment,more than downpayment,0,3900
JAXJROK4,9900,2/3/2020,9900,,9900,equal to downpayment,,9900,0
JB1AQ2E2,9900,1/22/2020,9900,,9900,equal to downpayment,,9900,0
JCGTO3US,9900,6/13/2019,8900,,9900,more than downpayment,,8900,1000
JCGTO3US,4000,8/20/2019,8900,JCGTO3US,13900,more than downpayment,more than downpayment,0,4000
JCGTO3US,4000,9/26/2019,8900,JCGTO3US,17900,more than downpayment,more than downpayment,0,4000
JCGTO3US,4000,10/28/2019,8900,JCGTO3US,21900,more than downpayment,more than downpayment,0,4000
JCGTO3US,4000,11/28/2019,8900,JCGTO3US,25900,more than downpayment,more than downpayment,0,4000
JCGTO3US,4000,1/2/2020,8900,JCGTO3US,29900,more than downpayment,more than downpayment,0,4000
JCGTO3US,4000,1/27/2020,8900,JCGTO3US,33900,more than downpayment,more than downpayment,0,4000
JE826SLA,9900,10/17/2019,9900,,9900,equal to downpayment,,9900,0
JE826SLA,3900,11/5/2019,9900,JE826SLA,13800,more than downpayment,equal to downpayment,0,3900
JE826SLA,3900,12/6/2019,9900,JE826SLA,17700,more than downpayment,more than downpayment,0,3900
JE826SLA,3900,1/6/2020,9900,JE826SLA,21600,more than downpayment,more than downpayment,0,3900
JEZF9MNF,9900,10/1/2019,9900,,9900,equal to downpayment,,9900,0
JFBLH8IC,9900,1/17/2020,9900,,9900,equal to downpayment,,9900,0
JG9HEE34,9900,1/30/2020,9900,,9900,equal to downpayment,,9900,0
JGS7ZEJT,9900,9/20/2019,9900,,9900,equal to downpayment,,9900,0
JGS7ZEJT,3900,12/6/2019,9900,JGS7ZEJT,13800,more than downpayment,equal to downpayment,0,3900
JGS7ZEJT,3900,1/13/2020,9900,JGS7ZEJT,17700,more than downpayment,more than downpayment,0,3900
jH4hK0QY,2000,6/27/2019,1999,,2000,more than downpayment,,1999,1
jH4hK0QY,4000,1/6/2020,1999,jH4hK0QY,6000,more than downpayment,more than downpayment,0,4000
jH4hK0QY,4000,2/4/2020,1999,jH4hK0QY,10000,more than downpayment,more than downpayment,0,4000
jHGjgDvn,3000,9/21/2018,9900,,3000,less than downpayment,,3000,0
jHGjgDvn,9900,12/24/2018,9900,jHGjgDvn,12900,more than downpayment,less than downpayment,6900,3000
jHGjgDvn,2940,2/2/2019,9900,jHGjgDvn,15840,more than downpayment,more than downpayment,0,2940
jHGjgDvn,4900,2/28/2019,9900,jHGjgDvn,20740,more than downpayment,more than downpayment,0,4900
jHGjgDvn,5500,3/20/2019,9900,jHGjgDvn,26240,more than downpayment,more than downpayment,0,5500
jHGjgDvn,4500,5/3/2019,9900,jHGjgDvn,30740,more than downpayment,more than downpayment,0,4500
jHGjgDvn,2700,5/31/2019,9900,jHGjgDvn,33440,more than downpayment,more than downpayment,0,2700
jHGjgDvn,300,6/21/2019,9900,jHGjgDvn,33740,more than downpayment,more than downpayment,0,300
jHGjgDvn,1000,6/22/2019,9900,jHGjgDvn,34740,more than downpayment,more than downpayment,0,1000
jHGjgDvn,1800,6/26/2019,9900,jHGjgDvn,36540,more than downpayment,more than downpayment,0,1800
jHGjgDvn,2650,7/12/2019,9900,jHGjgDvn,39190,more than downpayment,more than downpayment,0,2650
jHGjgDvn,550,7/13/2019,9900,jHGjgDvn,39740,more than downpayment,more than downpayment,0,550
jHGjgDvn,400,9/20/2019,9900,jHGjgDvn,40140,more than downpayment,more than downpayment,0,400
jHGjgDvn,1250,10/25/2019,9900,jHGjgDvn,41390,more than downpayment,more than downpayment,0,1250
jHGjgDvn,500,10/27/2019,9900,jHGjgDvn,41890,more than downpayment,more than downpayment,0,500
jHGjgDvn,1200,11/2/2019,9900,jHGjgDvn,43090,more than downpayment,more than downpayment,0,1200
jHGjgDvn,4000,11/28/2019,9900,jHGjgDvn,47090,more than downpayment,more than downpayment,0,4000
jHGjgDvn,1060,11/29/2019,9900,jHGjgDvn,48150,more than downpayment,more than downpayment,0,1060
jHGjgDvn,2250,12/2/2019,9900,jHGjgDvn,50400,more than downpayment,more than downpayment,0,2250
jHGjgDvn,2000,12/17/2019,9900,jHGjgDvn,52400,more than downpayment,more than downpayment,0,2000
jHGjgDvn,920,1/10/2020,9900,jHGjgDvn,53320,more than downpayment,more than downpayment,0,920
jHGjgDvn,820,1/21/2020,9900,jHGjgDvn,54140,more than downpayment,more than downpayment,0,820
jHGjgDvn,200,1/22/2020,9900,jHGjgDvn,54340,more than downpayment,more than downpayment,0,200
JIHQ693U,9900,8/14/2019,9900,,9900,equal to downpayment,,9900,0
JIHQ693U,10000,10/23/2019,9900,JIHQ693U,19900,more than downpayment,equal to downpayment,0,10000
JIHQ693U,1700,12/20/2019,9900,JIHQ693U,21600,more than downpayment,more than downpayment,0,1700
JIHQ693U,2000,1/20/2020,9900,JIHQ693U,23600,more than downpayment,more than downpayment,0,2000
JIIYE3J9,6300,12/2/2019,9900,,6300,less than downpayment,,6300,0
JIIYE3J9,3600,12/3/2019,9900,JIIYE3J9,9900,equal to downpayment,less than downpayment,3600,0
JIIYE3J9,5600,1/13/2020,9900,JIIYE3J9,15500,more than downpayment,equal to downpayment,0,5600
JIIYE3J9,2200,1/18/2020,9900,JIIYE3J9,17700,more than downpayment,more than downpayment,0,2200
JJ3JmTqD,8900,1/24/2019,8900,,8900,equal to downpayment,,8900,0
JJ3JmTqD,3900,3/4/2019,8900,JJ3JmTqD,12800,more than downpayment,equal to downpayment,0,3900
JJ3JmTqD,3900,3/25/2019,8900,JJ3JmTqD,16700,more than downpayment,more than downpayment,0,3900
JJ3JmTqD,3900,5/2/2019,8900,JJ3JmTqD,20600,more than downpayment,more than downpayment,0,3900
JJ3JmTqD,3900,6/5/2019,8900,JJ3JmTqD,24500,more than downpayment,more than downpayment,0,3900
JJ3JmTqD,3900,7/4/2019,8900,JJ3JmTqD,28400,more than downpayment,more than downpayment,0,3900
JJ3JmTqD,3900,8/16/2019,8900,JJ3JmTqD,32300,more than downpayment,more than downpayment,0,3900
JJ3JmTqD,3900,9/4/2019,8900,JJ3JmTqD,36200,more than downpayment,more than downpayment,0,3900
JJ3JmTqD,3900,10/7/2019,8900,JJ3JmTqD,40100,more than downpayment,more than downpayment,0,3900
JJ3JmTqD,3900,11/4/2019,8900,JJ3JmTqD,44000,more than downpayment,more than downpayment,0,3900
JJ3JmTqD,3900,12/6/2019,8900,JJ3JmTqD,47900,more than downpayment,more than downpayment,0,3900
JJ4VKR6A,9900,8/26/2019,9900,,9900,equal to downpayment,,9900,0
JJ4VKR6A,5000,1/28/2020,9900,JJ4VKR6A,14900,more than downpayment,equal to downpayment,0,5000
jJ56WLmi,10000,6/16/2017,10000,,10000,equal to downpayment,,10000,0
jJ56WLmi,3500,7/26/2017,10000,jJ56WLmi,13500,more than downpayment,equal to downpayment,0,3500
jJ56WLmi,3500,8/28/2017,10000,jJ56WLmi,17000,more than downpayment,more than downpayment,0,3500
jJ56WLmi,3500,9/22/2017,10000,jJ56WLmi,20500,more than downpayment,more than downpayment,0,3500
jJ56WLmi,3500,10/31/2017,10000,jJ56WLmi,24000,more than downpayment,more than downpayment,0,3500
jJ56WLmi,3500,11/30/2017,10000,jJ56WLmi,27500,more than downpayment,more than downpayment,0,3500
jJ56WLmi,3500,1/8/2018,10000,jJ56WLmi,31000,more than downpayment,more than downpayment,0,3500
jJ56WLmi,3500,2/20/2018,10000,jJ56WLmi,34500,more than downpayment,more than downpayment,0,3500
jJ56WLmi,5500,5/18/2018,10000,jJ56WLmi,40000,more than downpayment,more than downpayment,0,5500
JJ8N3FDR,9900,10/29/2019,9900,,9900,equal to downpayment,,9900,0
JJ8N3FDR,4000,12/13/2019,9900,JJ8N3FDR,13900,more than downpayment,equal to downpayment,0,4000
JJ8N3FDR,2900,1/18/2020,9900,JJ8N3FDR,16800,more than downpayment,more than downpayment,0,2900
JJ8N3FDR,1000,1/21/2020,9900,JJ8N3FDR,17800,more than downpayment,more than downpayment,0,1000
JJpfEqEK,8900,8/28/2019,9900,,8900,less than downpayment,,8900,0
JJpfEqEK,1000,8/30/2019,9900,JJpfEqEK,9900,equal to downpayment,less than downpayment,1000,0
JJpfEqEK,3900,12/9/2019,9900,JJpfEqEK,13800,more than downpayment,equal to downpayment,0,3900
JJpfEqEK,3900,1/7/2020,9900,JJpfEqEK,17700,more than downpayment,more than downpayment,0,3900
JJpfEqEK,3900,2/8/2020,9900,JJpfEqEK,21600,more than downpayment,more than downpayment,0,3900
JK1tl4Q2,9900,8/19/2019,9900,,9900,equal to downpayment,,9900,0
jK7gLoTV,8900,8/21/2019,8900,,8900,equal to downpayment,,8900,0
jK7gLoTV,3900,10/29/2019,8900,jK7gLoTV,12800,more than downpayment,equal to downpayment,0,3900
jK7gLoTV,3900,11/25/2019,8900,jK7gLoTV,16700,more than downpayment,more than downpayment,0,3900
jK7gLoTV,3900,12/26/2019,8900,jK7gLoTV,20600,more than downpayment,more than downpayment,0,3900
jK7gLoTV,3900,1/26/2020,8900,jK7gLoTV,24500,more than downpayment,more than downpayment,0,3900
Jk8Benql,8900,4/15/2019,8900,,8900,equal to downpayment,,8900,0
Jk8Benql,3900,5/13/2019,8900,Jk8Benql,12800,more than downpayment,equal to downpayment,0,3900
Jk8Benql,3900,6/15/2019,8900,Jk8Benql,16700,more than downpayment,more than downpayment,0,3900
Jk8Benql,3900,7/10/2019,8900,Jk8Benql,20600,more than downpayment,more than downpayment,0,3900
Jk8Benql,3900,8/26/2019,8900,Jk8Benql,24500,more than downpayment,more than downpayment,0,3900
Jk8Benql,3900,9/24/2019,8900,Jk8Benql,28400,more than downpayment,more than downpayment,0,3900
Jk8Benql,3900,10/25/2019,8900,Jk8Benql,32300,more than downpayment,more than downpayment,0,3900
Jk8Benql,3900,11/25/2019,8900,Jk8Benql,36200,more than downpayment,more than downpayment,0,3900
Jk8Benql,3900,12/24/2019,8900,Jk8Benql,40100,more than downpayment,more than downpayment,0,3900
Jk8Benql,3900,1/24/2020,8900,Jk8Benql,44000,more than downpayment,more than downpayment,0,3900
JK8EZVX3,8900,9/5/2019,8900,,8900,equal to downpayment,,8900,0
JK8EZVX3,3900,1/27/2020,8900,JK8EZVX3,12800,more than downpayment,equal to downpayment,0,3900
jKkMBz0K,9000,5/15/2019,8900,,9000,more than downpayment,,8900,100
jKkMBz0K,3900,6/6/2019,8900,jKkMBz0K,12900,more than downpayment,more than downpayment,0,3900
jKkMBz0K,3900,7/1/2019,8900,jKkMBz0K,16800,more than downpayment,more than downpayment,0,3900
jKkMBz0K,3900,8/2/2019,8900,jKkMBz0K,20700,more than downpayment,more than downpayment,0,3900
jKkMBz0K,3900,9/5/2019,8900,jKkMBz0K,24600,more than downpayment,more than downpayment,0,3900
jKkMBz0K,3900,10/5/2019,8900,jKkMBz0K,28500,more than downpayment,more than downpayment,0,3900
jKkMBz0K,3900,11/3/2019,8900,jKkMBz0K,32400,more than downpayment,more than downpayment,0,3900
jKkMBz0K,3900,12/2/2019,8900,jKkMBz0K,36300,more than downpayment,more than downpayment,0,3900
jKkMBz0K,3900,1/2/2020,8900,jKkMBz0K,40200,more than downpayment,more than downpayment,0,3900
jKkMBz0K,3900,2/3/2020,8900,jKkMBz0K,44100,more than downpayment,more than downpayment,0,3900
JKv9Is2m,8900,3/11/2019,8900,,8900,equal to downpayment,,8900,0
JKv9Is2m,3900,4/15/2019,8900,JKv9Is2m,12800,more than downpayment,equal to downpayment,0,3900
JKv9Is2m,3900,5/16/2019,8900,JKv9Is2m,16700,more than downpayment,more than downpayment,0,3900
JKv9Is2m,3900,6/19/2019,8900,JKv9Is2m,20600,more than downpayment,more than downpayment,0,3900
JKv9Is2m,3900,7/12/2019,8900,JKv9Is2m,24500,more than downpayment,more than downpayment,0,3900
JKv9Is2m,11700,10/17/2019,8900,JKv9Is2m,36200,more than downpayment,more than downpayment,0,11700
JKv9Is2m,3900,12/5/2019,8900,JKv9Is2m,40100,more than downpayment,more than downpayment,0,3900
JKv9Is2m,7800,12/21/2019,8900,JKv9Is2m,47900,more than downpayment,more than downpayment,0,7800
JL7RIx4o,28000,8/22/2019,8900,,28000,more than downpayment,,8900,19100
jlW1zT75,10000,5/27/2017,10000,,10000,equal to downpayment,,10000,0
jlW1zT75,3500,7/4/2017,10000,jlW1zT75,13500,more than downpayment,equal to downpayment,0,3500
jlW1zT75,3000,8/2/2017,10000,jlW1zT75,16500,more than downpayment,more than downpayment,0,3000
jlW1zT75,3500,8/21/2017,10000,jlW1zT75,20000,more than downpayment,more than downpayment,0,3500
jlW1zT75,3000,9/11/2017,10000,jlW1zT75,23000,more than downpayment,more than downpayment,0,3000
jlW1zT75,3000,10/30/2017,10000,jlW1zT75,26000,more than downpayment,more than downpayment,0,3000
jlW1zT75,2700,12/1/2017,10000,jlW1zT75,28700,more than downpayment,more than downpayment,0,2700
jlW1zT75,2600,1/9/2018,10000,jlW1zT75,31300,more than downpayment,more than downpayment,0,2600
jlW1zT75,8000,3/3/2018,10000,jlW1zT75,39300,more than downpayment,more than downpayment,0,8000
jlW1zT75,700,3/5/2018,10000,jlW1zT75,40000,more than downpayment,more than downpayment,0,700
jM1T4qFO,8900,5/25/2019,8900,,8900,equal to downpayment,,8900,0
jM1T4qFO,1000,6/20/2019,8900,jM1T4qFO,9900,more than downpayment,equal to downpayment,0,1000
jM1T4qFO,3900,7/22/2019,8900,jM1T4qFO,13800,more than downpayment,more than downpayment,0,3900
jM1T4qFO,3900,8/22/2019,8900,jM1T4qFO,17700,more than downpayment,more than downpayment,0,3900
jM1T4qFO,1500,9/25/2019,8900,jM1T4qFO,19200,more than downpayment,more than downpayment,0,1500
jM1T4qFO,2400,10/2/2019,8900,jM1T4qFO,21600,more than downpayment,more than downpayment,0,2400
jM1T4qFO,3900,10/29/2019,8900,jM1T4qFO,25500,more than downpayment,more than downpayment,0,3900
jM1T4qFO,2000,1/13/2020,8900,jM1T4qFO,27500,more than downpayment,more than downpayment,0,2000
jM1T4qFO,1000,1/19/2020,8900,jM1T4qFO,28500,more than downpayment,more than downpayment,0,1000
jM1T4qFO,1000,1/27/2020,8900,jM1T4qFO,29500,more than downpayment,more than downpayment,0,1000
jM1T4qFO,1500,1/31/2020,8900,jM1T4qFO,31000,more than downpayment,more than downpayment,0,1500
JM3jsm30,10,10/28/2019,9900,,10,less than downpayment,,10,0
JMJ6FGO7,8900,10/23/2019,8900,,8900,equal to downpayment,,8900,0
JMJ6FGO7,4000,1/3/2020,8900,JMJ6FGO7,12900,more than downpayment,equal to downpayment,0,4000
JMJ6FGO7,4000,2/2/2020,8900,JMJ6FGO7,16900,more than downpayment,more than downpayment,0,4000
jN1bza4E,8900,1/22/2019,8900,,8900,equal to downpayment,,8900,0
jN1bza4E,4000,2/22/2019,8900,jN1bza4E,12900,more than downpayment,equal to downpayment,0,4000
jN1bza4E,4000,3/21/2019,8900,jN1bza4E,16900,more than downpayment,more than downpayment,0,4000
jN1bza4E,4000,4/17/2019,8900,jN1bza4E,20900,more than downpayment,more than downpayment,0,4000
jN1bza4E,4000,5/10/2019,8900,jN1bza4E,24900,more than downpayment,more than downpayment,0,4000
jN1bza4E,4000,6/15/2019,8900,jN1bza4E,28900,more than downpayment,more than downpayment,0,4000
jN1bza4E,4000,7/15/2019,8900,jN1bza4E,32900,more than downpayment,more than downpayment,0,4000
jN1bza4E,4000,8/20/2019,8900,jN1bza4E,36900,more than downpayment,more than downpayment,0,4000
jN1bza4E,4000,10/10/2019,8900,jN1bza4E,40900,more than downpayment,more than downpayment,0,4000
jN1bza4E,3900,11/6/2019,8900,jN1bza4E,44800,more than downpayment,more than downpayment,0,3900
jN1bza4E,4500,12/11/2019,8900,jN1bza4E,49300,more than downpayment,more than downpayment,0,4500
jN1bza4E,4000,1/8/2020,8900,jN1bza4E,53300,more than downpayment,more than downpayment,0,4000
JN2EPQeI,10000,8/13/2018,10000,,10000,equal to downpayment,,10000,0
JN2EPQeI,4500,10/17/2018,10000,JN2EPQeI,14500,more than downpayment,equal to downpayment,0,4500
JN2EPQeI,1500,11/26/2018,10000,JN2EPQeI,16000,more than downpayment,more than downpayment,0,1500
JN2EPQeI,2000,12/31/2018,10000,JN2EPQeI,18000,more than downpayment,more than downpayment,0,2000
JN2EPQeI,5000,3/8/2019,10000,JN2EPQeI,23000,more than downpayment,more than downpayment,0,5000
JN2EPQeI,5000,4/26/2019,10000,JN2EPQeI,28000,more than downpayment,more than downpayment,0,5000
JN2EPQeI,4000,6/5/2019,10000,JN2EPQeI,32000,more than downpayment,more than downpayment,0,4000
jnUucSxe,10000,6/15/2019,9900,,10000,more than downpayment,,9900,100
jnUucSxe,4000,7/25/2019,9900,jnUucSxe,14000,more than downpayment,more than downpayment,0,4000
jnUucSxe,4000,7/29/2019,9900,jnUucSxe,18000,more than downpayment,more than downpayment,0,4000
jnUucSxe,4000,8/24/2019,9900,jnUucSxe,22000,more than downpayment,more than downpayment,0,4000
jnUucSxe,4000,10/7/2019,9900,jnUucSxe,26000,more than downpayment,more than downpayment,0,4000
JOAEUCDN,14000,11/28/2019,9900,,14000,more than downpayment,,9900,4100
JOCaHtZm,8900,3/13/2019,8900,,8900,equal to downpayment,,8900,0
JOCaHtZm,4200,4/4/2019,8900,JOCaHtZm,13100,more than downpayment,equal to downpayment,0,4200
JOCaHtZm,4200,5/13/2019,8900,JOCaHtZm,17300,more than downpayment,more than downpayment,0,4200
JOCaHtZm,4200,6/10/2019,8900,JOCaHtZm,21500,more than downpayment,more than downpayment,0,4200
JOCaHtZm,4200,7/13/2019,8900,JOCaHtZm,25700,more than downpayment,more than downpayment,0,4200
JOCaHtZm,4200,8/14/2019,8900,JOCaHtZm,29900,more than downpayment,more than downpayment,0,4200
JOCaHtZm,4200,9/12/2019,8900,JOCaHtZm,34100,more than downpayment,more than downpayment,0,4200
JOCaHtZm,4200,10/15/2019,8900,JOCaHtZm,38300,more than downpayment,more than downpayment,0,4200
JOCaHtZm,4200,11/15/2019,8900,JOCaHtZm,42500,more than downpayment,more than downpayment,0,4200
JOCaHtZm,4200,12/15/2019,8900,JOCaHtZm,46700,more than downpayment,more than downpayment,0,4200
JOCaHtZm,4200,1/15/2020,8900,JOCaHtZm,50900,more than downpayment,more than downpayment,0,4200
jp8DkIFt,11800,11/3/2018,9900,,11800,more than downpayment,,9900,1900
jp8DkIFt,4200,12/2/2018,9900,jp8DkIFt,16000,more than downpayment,more than downpayment,0,4200
jp8DkIFt,4200,12/28/2018,9900,jp8DkIFt,20200,more than downpayment,more than downpayment,0,4200
jp8DkIFt,4500,1/31/2019,9900,jp8DkIFt,24700,more than downpayment,more than downpayment,0,4500
jp8DkIFt,4500,3/1/2019,9900,jp8DkIFt,29200,more than downpayment,more than downpayment,0,4500
jp8DkIFt,4500,3/26/2019,9900,jp8DkIFt,33700,more than downpayment,more than downpayment,0,4500
jp8DkIFt,4500,4/28/2019,9900,jp8DkIFt,38200,more than downpayment,more than downpayment,0,4500
jp8DkIFt,4500,5/27/2019,9900,jp8DkIFt,42700,more than downpayment,more than downpayment,0,4500
jp8DkIFt,4500,6/28/2019,9900,jp8DkIFt,47200,more than downpayment,more than downpayment,0,4500
jp8DkIFt,4500,7/28/2019,9900,jp8DkIFt,51700,more than downpayment,more than downpayment,0,4500
jp8DkIFt,4500,8/31/2019,9900,jp8DkIFt,56200,more than downpayment,more than downpayment,0,4500
jp8DkIFt,4500,9/30/2019,9900,jp8DkIFt,60700,more than downpayment,more than downpayment,0,4500
jp8DkIFt,3900,12/2/2019,9900,jp8DkIFt,64600,more than downpayment,more than downpayment,0,3900
jPJZNXQK,60000,4/4/2019,8900,,60000,more than downpayment,,8900,51100
jPJZNXQK,3000,11/11/2019,8900,jPJZNXQK,63000,more than downpayment,more than downpayment,0,3000
jPJZNXQK,3000,11/19/2019,8900,jPJZNXQK,66000,more than downpayment,more than downpayment,0,3000
jPJZNXQK,3000,12/16/2019,8900,jPJZNXQK,69000,more than downpayment,more than downpayment,0,3000
jPJZNXQK,3000,1/20/2020,8900,jPJZNXQK,72000,more than downpayment,more than downpayment,0,3000
JPOPctHo,8900,1/11/2019,8900,,8900,equal to downpayment,,8900,0
JPOPctHo,3900,2/22/2019,8900,JPOPctHo,12800,more than downpayment,equal to downpayment,0,3900
JPOPctHo,3900,3/24/2019,8900,JPOPctHo,16700,more than downpayment,more than downpayment,0,3900
JPOPctHo,3900,4/24/2019,8900,JPOPctHo,20600,more than downpayment,more than downpayment,0,3900
JPOPctHo,3900,5/24/2019,8900,JPOPctHo,24500,more than downpayment,more than downpayment,0,3900
JPOPctHo,3900,6/21/2019,8900,JPOPctHo,28400,more than downpayment,more than downpayment,0,3900
JPOPctHo,3900,7/25/2019,8900,JPOPctHo,32300,more than downpayment,more than downpayment,0,3900
JPOPctHo,3900,8/25/2019,8900,JPOPctHo,36200,more than downpayment,more than downpayment,0,3900
JPOPctHo,3900,9/25/2019,8900,JPOPctHo,40100,more than downpayment,more than downpayment,0,3900
jq8oFICU,8900,1/21/2019,8900,,8900,equal to downpayment,,8900,0
jq8oFICU,3900,2/24/2019,8900,jq8oFICU,12800,more than downpayment,equal to downpayment,0,3900
jq8oFICU,3900,3/29/2019,8900,jq8oFICU,16700,more than downpayment,more than downpayment,0,3900
jq8oFICU,1500,5/15/2019,8900,jq8oFICU,18200,more than downpayment,more than downpayment,0,1500
jq8oFICU,2400,5/16/2019,8900,jq8oFICU,20600,more than downpayment,more than downpayment,0,2400
jq8oFICU,3900,5/30/2019,8900,jq8oFICU,24500,more than downpayment,more than downpayment,0,3900
jq8oFICU,3900,7/9/2019,8900,jq8oFICU,28400,more than downpayment,more than downpayment,0,3900
jq8oFICU,3900,8/6/2019,8900,jq8oFICU,32300,more than downpayment,more than downpayment,0,3900
jq8oFICU,2200,9/6/2019,8900,jq8oFICU,34500,more than downpayment,more than downpayment,0,2200
jq8oFICU,1500,9/19/2019,8900,jq8oFICU,36000,more than downpayment,more than downpayment,0,1500
jq8oFICU,300,9/27/2019,8900,jq8oFICU,36300,more than downpayment,more than downpayment,0,300
jq8oFICU,3800,10/3/2019,8900,jq8oFICU,40100,more than downpayment,more than downpayment,0,3800
jq8oFICU,100,10/5/2019,8900,jq8oFICU,40200,more than downpayment,more than downpayment,0,100
jq8oFICU,3900,11/7/2019,8900,jq8oFICU,44100,more than downpayment,more than downpayment,0,3900
jq8oFICU,3900,12/5/2019,8900,jq8oFICU,48000,more than downpayment,more than downpayment,0,3900
jq8oFICU,3900,1/10/2020,8900,jq8oFICU,51900,more than downpayment,more than downpayment,0,3900
jq8oFICU,3900,2/4/2020,8900,jq8oFICU,55800,more than downpayment,more than downpayment,0,3900
jQNDpqLd,8900,2/5/2019,8900,,8900,equal to downpayment,,8900,0
jQNDpqLd,3900,3/25/2019,8900,jQNDpqLd,12800,more than downpayment,equal to downpayment,0,3900
jQNDpqLd,3900,5/2/2019,8900,jQNDpqLd,16700,more than downpayment,more than downpayment,0,3900
jQNDpqLd,3900,9/24/2019,8900,jQNDpqLd,20600,more than downpayment,more than downpayment,0,3900
jQNDpqLd,10000,12/19/2019,8900,jQNDpqLd,30600,more than downpayment,more than downpayment,0,10000
jQNDpqLd,3900,1/8/2020,8900,jQNDpqLd,34500,more than downpayment,more than downpayment,0,3900
jQNDpqLd,5500,1/13/2020,8900,jQNDpqLd,40000,more than downpayment,more than downpayment,0,5500
jQNDpqLd,8900,1/15/2020,8900,jQNDpqLd,48900,more than downpayment,more than downpayment,0,8900
jQNDpqLd,3900,1/30/2020,8900,jQNDpqLd,52800,more than downpayment,more than downpayment,0,3900
JQNGKHDU,1000,9/29/2019,9900,,1000,less than downpayment,,1000,0
JQNGKHDU,500,9/30/2019,9900,JQNGKHDU,1500,less than downpayment,less than downpayment,500,0
JQNGKHDU,500,10/1/2019,9900,JQNGKHDU,2000,less than downpayment,less than downpayment,500,0
JQNGKHDU,500,10/2/2019,9900,JQNGKHDU,2500,less than downpayment,less than downpayment,500,0
JQNGKHDU,1000,10/3/2019,9900,JQNGKHDU,3500,less than downpayment,less than downpayment,1000,0
JQNGKHDU,500,10/5/2019,9900,JQNGKHDU,4000,less than downpayment,less than downpayment,500,0
JQNGKHDU,500,10/7/2019,9900,JQNGKHDU,4500,less than downpayment,less than downpayment,500,0
JQNGKHDU,500,10/9/2019,9900,JQNGKHDU,5000,less than downpayment,less than downpayment,500,0
JQNGKHDU,500,10/10/2019,9900,JQNGKHDU,5500,less than downpayment,less than downpayment,500,0
JQNGKHDU,500,10/15/2019,9900,JQNGKHDU,6000,less than downpayment,less than downpayment,500,0
JQNGKHDU,1000,10/17/2019,9900,JQNGKHDU,7000,less than downpayment,less than downpayment,1000,0
JQNGKHDU,3000,10/19/2019,9900,JQNGKHDU,10000,more than downpayment,less than downpayment,2900,100
JQNGKHDU,168,10/29/2019,9900,JQNGKHDU,10168,more than downpayment,more than downpayment,0,168
JQNGKHDU,100,11/11/2019,9900,JQNGKHDU,10268,more than downpayment,more than downpayment,0,100
JQNGKHDU,150,11/14/2019,9900,JQNGKHDU,10418,more than downpayment,more than downpayment,0,150
JQNGKHDU,200,11/15/2019,9900,JQNGKHDU,10618,more than downpayment,more than downpayment,0,200
JQNGKHDU,400,11/28/2019,9900,JQNGKHDU,11018,more than downpayment,more than downpayment,0,400
JQNGKHDU,500,12/12/2019,9900,JQNGKHDU,11518,more than downpayment,more than downpayment,0,500
JQNGKHDU,500,1/7/2020,9900,JQNGKHDU,12018,more than downpayment,more than downpayment,0,500
JQNGKHDU,200,1/10/2020,9900,JQNGKHDU,12218,more than downpayment,more than downpayment,0,200
JQNGKHDU,2000,1/13/2020,9900,JQNGKHDU,14218,more than downpayment,more than downpayment,0,2000
JQNGKHDU,1000,1/20/2020,9900,JQNGKHDU,15218,more than downpayment,more than downpayment,0,1000
JQNGKHDU,500,1/22/2020,9900,JQNGKHDU,15718,more than downpayment,more than downpayment,0,500
JQNGKHDU,100,1/24/2020,9900,JQNGKHDU,15818,more than downpayment,more than downpayment,0,100
JQNGKHDU,2000,1/27/2020,9900,JQNGKHDU,17818,more than downpayment,more than downpayment,0,2000
JQNGKHDU,100,1/28/2020,9900,JQNGKHDU,17918,more than downpayment,more than downpayment,0,100
JQNGKHDU,100,1/29/2020,9900,JQNGKHDU,18018,more than downpayment,more than downpayment,0,100
JQNGKHDU,100,1/30/2020,9900,JQNGKHDU,18118,more than downpayment,more than downpayment,0,100
JQNGKHDU,100,1/31/2020,9900,JQNGKHDU,18218,more than downpayment,more than downpayment,0,100
JQNGKHDU,300,2/2/2020,9900,JQNGKHDU,18518,more than downpayment,more than downpayment,0,300
JqrQqh8f,9900,6/4/2019,8900,,9900,more than downpayment,,8900,1000
JqrQqh8f,3900,7/15/2019,8900,JqrQqh8f,13800,more than downpayment,more than downpayment,0,3900
JqrQqh8f,3900,8/15/2019,8900,JqrQqh8f,17700,more than downpayment,more than downpayment,0,3900
JqrQqh8f,3900,9/17/2019,8900,JqrQqh8f,21600,more than downpayment,more than downpayment,0,3900
JqrQqh8f,3900,10/17/2019,8900,JqrQqh8f,25500,more than downpayment,more than downpayment,0,3900
JqrQqh8f,3900,11/18/2019,8900,JqrQqh8f,29400,more than downpayment,more than downpayment,0,3900
JqrQqh8f,3900,1/16/2020,8900,JqrQqh8f,33300,more than downpayment,more than downpayment,0,3900
JRX8U57E,9900,9/20/2019,9900,,9900,equal to downpayment,,9900,0
JRX8U57E,3900,11/15/2019,9900,JRX8U57E,13800,more than downpayment,equal to downpayment,0,3900
JRX8U57E,3900,12/15/2019,9900,JRX8U57E,17700,more than downpayment,more than downpayment,0,3900
JRX8U57E,1700,1/20/2020,9900,JRX8U57E,19400,more than downpayment,more than downpayment,0,1700
JRX8U57E,2200,1/26/2020,9900,JRX8U57E,21600,more than downpayment,more than downpayment,0,2200
JS31B7JP,2100,1/3/2020,9900,,2100,less than downpayment,,2100,0
JS31B7JP,3300,1/9/2020,9900,JS31B7JP,5400,less than downpayment,less than downpayment,3300,0
JS31B7JP,4500,1/22/2020,9900,JS31B7JP,9900,equal to downpayment,less than downpayment,4500,0
JS3XZ4F1,9900,11/8/2019,9900,,9900,equal to downpayment,,9900,0
JS3XZ4F1,3900,12/12/2019,9900,JS3XZ4F1,13800,more than downpayment,equal to downpayment,0,3900
JS3XZ4F1,7800,2/5/2020,9900,JS3XZ4F1,21600,more than downpayment,more than downpayment,0,7800
jSUfOkkq,8900,8/30/2019,8900,,8900,equal to downpayment,,8900,0
jSUfOkkq,3900,1/27/2020,8900,jSUfOkkq,12800,more than downpayment,equal to downpayment,0,3900
JSzijUx6,9900,7/12/2019,9900,,9900,equal to downpayment,,9900,0
JSzijUx6,1000,10/1/2019,9900,JSzijUx6,10900,more than downpayment,equal to downpayment,0,1000
Jt9tSkr1,9900,6/28/2019,9900,,9900,equal to downpayment,,9900,0
Jt9tSkr1,3900,8/26/2019,9900,Jt9tSkr1,13800,more than downpayment,equal to downpayment,0,3900
Jt9tSkr1,3900,1/15/2020,9900,Jt9tSkr1,17700,more than downpayment,more than downpayment,0,3900
JTUTHCZL,10000,10/23/2019,9900,,10000,more than downpayment,,9900,100
JTUTHCZL,3900,1/10/2020,9900,JTUTHCZL,13900,more than downpayment,more than downpayment,0,3900
JTUTHCZL,3100,2/8/2020,9900,JTUTHCZL,17000,more than downpayment,more than downpayment,0,3100
JUUHP8VX,9900,10/24/2019,9900,,9900,equal to downpayment,,9900,0
JUUHP8VX,3900,12/4/2019,9900,JUUHP8VX,13800,more than downpayment,equal to downpayment,0,3900
JUUHP8VX,3900,1/4/2020,9900,JUUHP8VX,17700,more than downpayment,more than downpayment,0,3900
JUUHP8VX,3900,2/6/2020,9900,JUUHP8VX,21600,more than downpayment,more than downpayment,0,3900
jUvlSUwk,10000,7/11/2017,10000,,10000,equal to downpayment,,10000,0
jUvlSUwk,3500,10/14/2017,10000,jUvlSUwk,13500,more than downpayment,equal to downpayment,0,3500
jUvlSUwk,3500,11/11/2017,10000,jUvlSUwk,17000,more than downpayment,more than downpayment,0,3500
jUvlSUwk,3500,12/21/2017,10000,jUvlSUwk,20500,more than downpayment,more than downpayment,0,3500
jUvlSUwk,3500,1/24/2018,10000,jUvlSUwk,24000,more than downpayment,more than downpayment,0,3500
jUvlSUwk,3500,2/25/2018,10000,jUvlSUwk,27500,more than downpayment,more than downpayment,0,3500
jUvlSUwk,3500,4/30/2018,10000,jUvlSUwk,31000,more than downpayment,more than downpayment,0,3500
jUvlSUwk,3500,5/25/2018,10000,jUvlSUwk,34500,more than downpayment,more than downpayment,0,3500
jUvlSUwk,3500,8/27/2018,10000,jUvlSUwk,38000,more than downpayment,more than downpayment,0,3500
jUvlSUwk,2000,10/29/2018,10000,jUvlSUwk,40000,more than downpayment,more than downpayment,0,2000
jUvlSUwk,6000,1/25/2019,10000,jUvlSUwk,46000,more than downpayment,more than downpayment,0,6000
jUvlSUwk,500,3/26/2019,10000,jUvlSUwk,46500,more than downpayment,more than downpayment,0,500
jUvlSUwk,200,5/9/2019,10000,jUvlSUwk,46700,more than downpayment,more than downpayment,0,200
jUvlSUwk,500,6/7/2019,10000,jUvlSUwk,47200,more than downpayment,more than downpayment,0,500
jUvlSUwk,500,7/23/2019,10000,jUvlSUwk,47700,more than downpayment,more than downpayment,0,500
jUvlSUwk,500,8/1/2019,10000,jUvlSUwk,48200,more than downpayment,more than downpayment,0,500
jUvlSUwk,300,11/25/2019,10000,jUvlSUwk,48500,more than downpayment,more than downpayment,0,300
JVE43UER,8900,5/21/2019,8900,,8900,equal to downpayment,,8900,0
JVE43UER,6000,7/5/2019,8900,JVE43UER,14900,more than downpayment,equal to downpayment,0,6000
JVE43UER,2400,8/5/2019,8900,JVE43UER,17300,more than downpayment,more than downpayment,0,2400
JVE43UER,4000,8/30/2019,8900,JVE43UER,21300,more than downpayment,more than downpayment,0,4000
JVE43UER,4000,9/25/2019,8900,JVE43UER,25300,more than downpayment,more than downpayment,0,4000
JVE43UER,3900,10/23/2019,8900,JVE43UER,29200,more than downpayment,more than downpayment,0,3900
JVE43UER,3900,11/25/2019,8900,JVE43UER,33100,more than downpayment,more than downpayment,0,3900
JVE43UER,3900,12/25/2019,8900,JVE43UER,37000,more than downpayment,more than downpayment,0,3900
jVl8t6qb,8900,8/2/2019,8900,,8900,equal to downpayment,,8900,0
jVl8t6qb,3900,8/29/2019,8900,jVl8t6qb,12800,more than downpayment,equal to downpayment,0,3900
jVl8t6qb,3900,10/4/2019,8900,jVl8t6qb,16700,more than downpayment,more than downpayment,0,3900
jVl8t6qb,7800,12/25/2019,8900,jVl8t6qb,24500,more than downpayment,more than downpayment,0,7800
jVl8t6qb,3900,1/25/2020,8900,jVl8t6qb,28400,more than downpayment,more than downpayment,0,3900
JVR66MM7,9900,7/11/2019,9900,,9900,equal to downpayment,,9900,0
JVR66MM7,2500,11/26/2019,9900,JVR66MM7,12400,more than downpayment,equal to downpayment,0,2500
JVYNI4F7,9900,8/8/2019,9900,,9900,equal to downpayment,,9900,0
JVYNI4F7,2400,10/3/2019,9900,JVYNI4F7,12300,more than downpayment,equal to downpayment,0,2400
JVYNI4F7,500,10/4/2019,9900,JVYNI4F7,12800,more than downpayment,more than downpayment,0,500
JVYNI4F7,1000,10/7/2019,9900,JVYNI4F7,13800,more than downpayment,more than downpayment,0,1000
JVYNI4F7,3900,11/4/2019,9900,JVYNI4F7,17700,more than downpayment,more than downpayment,0,3900
JVYNI4F7,3900,12/2/2019,9900,JVYNI4F7,21600,more than downpayment,more than downpayment,0,3900
JVYNI4F7,2400,1/17/2020,9900,JVYNI4F7,24000,more than downpayment,more than downpayment,0,2400
JVYNI4F7,700,1/27/2020,9900,JVYNI4F7,24700,more than downpayment,more than downpayment,0,700
JW3EYWNH,9900,8/22/2019,9900,,9900,equal to downpayment,,9900,0
JW3EYWNH,3900,11/25/2019,9900,JW3EYWNH,13800,more than downpayment,equal to downpayment,0,3900
JW3EYWNH,3900,12/25/2019,9900,JW3EYWNH,17700,more than downpayment,more than downpayment,0,3900
JW3EYWNH,3900,1/29/2020,9900,JW3EYWNH,21600,more than downpayment,more than downpayment,0,3900
JWO61IVS,8900,1/7/2020,8900,,8900,equal to downpayment,,8900,0
Jx2vfMJU,8900,3/19/2019,8900,,8900,equal to downpayment,,8900,0
Jx2vfMJU,4000,5/10/2019,8900,Jx2vfMJU,12900,more than downpayment,equal to downpayment,0,4000
Jx2vfMJU,3900,6/25/2019,8900,Jx2vfMJU,16800,more than downpayment,more than downpayment,0,3900
Jx2vfMJU,2000,8/30/2019,8900,Jx2vfMJU,18800,more than downpayment,more than downpayment,0,2000
Jx2vfMJU,10000,10/1/2019,8900,Jx2vfMJU,28800,more than downpayment,more than downpayment,0,10000
JX5MLJA6,9900,7/9/2019,9900,,9900,equal to downpayment,,9900,0
JX5MLJA6,3900,8/8/2019,9900,JX5MLJA6,13800,more than downpayment,equal to downpayment,0,3900
JX5MLJA6,3900,9/4/2019,9900,JX5MLJA6,17700,more than downpayment,more than downpayment,0,3900
JX5MLJA6,3900,10/4/2019,9900,JX5MLJA6,21600,more than downpayment,more than downpayment,0,3900
JX5MLJA6,3900,11/5/2019,9900,JX5MLJA6,25500,more than downpayment,more than downpayment,0,3900
JX5MLJA6,3900,12/5/2019,9900,JX5MLJA6,29400,more than downpayment,more than downpayment,0,3900
JX5MLJA6,3900,12/26/2019,9900,JX5MLJA6,33300,more than downpayment,more than downpayment,0,3900
JX5MLJA6,3900,2/5/2020,9900,JX5MLJA6,37200,more than downpayment,more than downpayment,0,3900
JX7CDQ2S,9900,12/9/2019,9900,,9900,equal to downpayment,,9900,0
jXgJnA0w,12400,6/29/2019,9900,,12400,more than downpayment,,9900,2500
jXgJnA0w,3900,8/24/2019,9900,jXgJnA0w,16300,more than downpayment,more than downpayment,0,3900
jXgJnA0w,3900,9/25/2019,9900,jXgJnA0w,20200,more than downpayment,more than downpayment,0,3900
jXgJnA0w,3900,10/25/2019,9900,jXgJnA0w,24100,more than downpayment,more than downpayment,0,3900
jXgJnA0w,3900,11/25/2019,9900,jXgJnA0w,28000,more than downpayment,more than downpayment,0,3900
jXgJnA0w,3900,12/26/2019,9900,jXgJnA0w,31900,more than downpayment,more than downpayment,0,3900
jXgJnA0w,3900,1/25/2020,9900,jXgJnA0w,35800,more than downpayment,more than downpayment,0,3900
JxWYLUMY,9900,6/7/2019,8900,,9900,more than downpayment,,8900,1000
JxWYLUMY,3900,7/11/2019,8900,JxWYLUMY,13800,more than downpayment,more than downpayment,0,3900
JxWYLUMY,3900,8/22/2019,8900,JxWYLUMY,17700,more than downpayment,more than downpayment,0,3900
JxWYLUMY,3900,9/22/2019,8900,JxWYLUMY,21600,more than downpayment,more than downpayment,0,3900
JxWYLUMY,3900,10/24/2019,8900,JxWYLUMY,25500,more than downpayment,more than downpayment,0,3900
JxWYLUMY,3900,11/21/2019,8900,JxWYLUMY,29400,more than downpayment,more than downpayment,0,3900
JxWYLUMY,3900,12/23/2019,8900,JxWYLUMY,33300,more than downpayment,more than downpayment,0,3900
JxWYLUMY,3900,1/19/2020,8900,JxWYLUMY,37200,more than downpayment,more than downpayment,0,3900
jyfQJPHF,9900,6/13/2019,9900,,9900,equal to downpayment,,9900,0
jyfQJPHF,3900,8/5/2019,9900,jyfQJPHF,13800,more than downpayment,equal to downpayment,0,3900
jyfQJPHF,4500,10/1/2019,9900,jyfQJPHF,18300,more than downpayment,more than downpayment,0,4500
jyfQJPHF,3400,11/4/2019,9900,jyfQJPHF,21700,more than downpayment,more than downpayment,0,3400
jyfQJPHF,3900,12/5/2019,9900,jyfQJPHF,25600,more than downpayment,more than downpayment,0,3900
jyfQJPHF,3000,1/2/2020,9900,jyfQJPHF,28600,more than downpayment,more than downpayment,0,3000
jyfQJPHF,3900,2/6/2020,9900,jyfQJPHF,32500,more than downpayment,more than downpayment,0,3900
JZilUV7Q,10000,4/16/2019,8900,,10000,more than downpayment,,8900,1100
JZilUV7Q,3900,7/17/2019,8900,JZilUV7Q,13900,more than downpayment,more than downpayment,0,3900
JZilUV7Q,3900,8/22/2019,8900,JZilUV7Q,17800,more than downpayment,more than downpayment,0,3900
JZilUV7Q,3900,9/25/2019,8900,JZilUV7Q,21700,more than downpayment,more than downpayment,0,3900
JZilUV7Q,3900,11/5/2019,8900,JZilUV7Q,25600,more than downpayment,more than downpayment,0,3900
JZilUV7Q,3900,11/27/2019,8900,JZilUV7Q,29500,more than downpayment,more than downpayment,0,3900
JZilUV7Q,2800,1/4/2020,8900,JZilUV7Q,32300,more than downpayment,more than downpayment,0,2800
JZilUV7Q,3900,1/15/2020,8900,JZilUV7Q,36200,more than downpayment,more than downpayment,0,3900
jzJMdwCq,9900,7/10/2019,9900,,9900,equal to downpayment,,9900,0
jzJMdwCq,3700,8/2/2019,9900,jzJMdwCq,13600,more than downpayment,equal to downpayment,0,3700
jzJMdwCq,200,8/15/2019,9900,jzJMdwCq,13800,more than downpayment,more than downpayment,0,200
jzJMdwCq,3500,9/25/2019,9900,jzJMdwCq,17300,more than downpayment,more than downpayment,0,3500
jzJMdwCq,400,9/30/2019,9900,jzJMdwCq,17700,more than downpayment,more than downpayment,0,400
jzJMdwCq,3900,10/24/2019,9900,jzJMdwCq,21600,more than downpayment,more than downpayment,0,3900
jzJMdwCq,3900,11/30/2019,9900,jzJMdwCq,25500,more than downpayment,more than downpayment,0,3900
jzJMdwCq,2450,1/24/2020,9900,jzJMdwCq,27950,more than downpayment,more than downpayment,0,2450
jzJMdwCq,1450,2/4/2020,9900,jzJMdwCq,29400,more than downpayment,more than downpayment,0,1450
JZVVYR4W,8900,10/21/2019,9900,,8900,less than downpayment,,8900,0
JZVVYR4W,1000,11/21/2019,9900,JZVVYR4W,9900,equal to downpayment,less than downpayment,1000,0
JZVVYR4W,1000,11/24/2019,9900,JZVVYR4W,10900,more than downpayment,equal to downpayment,0,1000
JZVVYR4W,2350,12/23/2019,9900,JZVVYR4W,13250,more than downpayment,more than downpayment,0,2350
JZVVYR4W,1270,1/7/2020,9900,JZVVYR4W,14520,more than downpayment,more than downpayment,0,1270
JZVVYR4W,500,1/18/2020,9900,JZVVYR4W,15020,more than downpayment,more than downpayment,0,500
JZVVYR4W,1960,1/24/2020,9900,JZVVYR4W,16980,more than downpayment,more than downpayment,0,1960
JZVVYR4W,1000,2/6/2020,9900,JZVVYR4W,17980,more than downpayment,more than downpayment,0,1000
JZWA6MKY,9900,10/8/2019,9900,,9900,equal to downpayment,,9900,0
JZWA6MKY,3900,11/25/2019,9900,JZWA6MKY,13800,more than downpayment,equal to downpayment,0,3900
JZWA6MKY,3900,12/22/2019,9900,JZWA6MKY,17700,more than downpayment,more than downpayment,0,3900
JZWA6MKY,3900,1/20/2020,9900,JZWA6MKY,21600,more than downpayment,more than downpayment,0,3900
k01A03wg,8900,4/29/2019,8900,,8900,equal to downpayment,,8900,0
k01A03wg,3900,6/2/2019,8900,k01A03wg,12800,more than downpayment,equal to downpayment,0,3900
k01A03wg,3900,7/8/2019,8900,k01A03wg,16700,more than downpayment,more than downpayment,0,3900
k01A03wg,3900,8/11/2019,8900,k01A03wg,20600,more than downpayment,more than downpayment,0,3900
k01A03wg,3900,9/4/2019,8900,k01A03wg,24500,more than downpayment,more than downpayment,0,3900
k01A03wg,3900,10/11/2019,8900,k01A03wg,28400,more than downpayment,more than downpayment,0,3900
k01A03wg,3900,11/25/2019,8900,k01A03wg,32300,more than downpayment,more than downpayment,0,3900
k01A03wg,3900,12/20/2019,8900,k01A03wg,36200,more than downpayment,more than downpayment,0,3900
k01A03wg,3900,1/25/2020,8900,k01A03wg,40100,more than downpayment,more than downpayment,0,3900
k0s1bPBB,9900,6/15/2019,9900,,9900,equal to downpayment,,9900,0
k0s1bPBB,3900,8/1/2019,9900,k0s1bPBB,13800,more than downpayment,equal to downpayment,0,3900
k0s1bPBB,16000,1/27/2020,9900,k0s1bPBB,29800,more than downpayment,more than downpayment,0,16000
K158RUA9,8900,7/25/2019,8900,,8900,equal to downpayment,,8900,0
K1SSHHRO,19000,1/27/2020,9900,,19000,more than downpayment,,9900,9100
K24XsFtG,10000,9/25/2018,10000,,10000,equal to downpayment,,10000,0
K24XsFtG,4500,10/30/2018,10000,K24XsFtG,14500,more than downpayment,equal to downpayment,0,4500
K24XsFtG,4500,12/2/2018,10000,K24XsFtG,19000,more than downpayment,more than downpayment,0,4500
K24XsFtG,4500,12/27/2018,10000,K24XsFtG,23500,more than downpayment,more than downpayment,0,4500
K24XsFtG,4000,2/7/2019,10000,K24XsFtG,27500,more than downpayment,more than downpayment,0,4000
K24XsFtG,500,2/11/2019,10000,K24XsFtG,28000,more than downpayment,more than downpayment,0,500
K24XsFtG,4500,3/28/2019,10000,K24XsFtG,32500,more than downpayment,more than downpayment,0,4500
K24XsFtG,3450,4/8/2019,10000,K24XsFtG,35950,more than downpayment,more than downpayment,0,3450
K24XsFtG,1000,4/22/2019,10000,K24XsFtG,36950,more than downpayment,more than downpayment,0,1000
K24XsFtG,4600,4/30/2019,10000,K24XsFtG,41550,more than downpayment,more than downpayment,0,4600
K24XsFtG,4500,6/22/2019,10000,K24XsFtG,46050,more than downpayment,more than downpayment,0,4500
K24XsFtG,9000,8/25/2019,10000,K24XsFtG,55050,more than downpayment,more than downpayment,0,9000
K24XsFtG,4500,9/30/2019,10000,K24XsFtG,59550,more than downpayment,more than downpayment,0,4500
K24XsFtG,4450,10/15/2019,10000,K24XsFtG,64000,more than downpayment,more than downpayment,0,4450
k2TDuz8N,9900,6/8/2019,9900,,9900,equal to downpayment,,9900,0
k2TDuz8N,4000,7/29/2019,9900,k2TDuz8N,13900,more than downpayment,equal to downpayment,0,4000
k2TDuz8N,3900,8/29/2019,9900,k2TDuz8N,17800,more than downpayment,more than downpayment,0,3900
k2TDuz8N,3900,9/28/2019,9900,k2TDuz8N,21700,more than downpayment,more than downpayment,0,3900
k2TDuz8N,3900,10/30/2019,9900,k2TDuz8N,25600,more than downpayment,more than downpayment,0,3900
k2TDuz8N,2800,11/29/2019,9900,k2TDuz8N,28400,more than downpayment,more than downpayment,0,2800
k2TDuz8N,1500,12/5/2019,9900,k2TDuz8N,29900,more than downpayment,more than downpayment,0,1500
k2TDuz8N,1000,1/4/2020,9900,k2TDuz8N,30900,more than downpayment,more than downpayment,0,1000
k2TDuz8N,2500,1/13/2020,9900,k2TDuz8N,33400,more than downpayment,more than downpayment,0,2500
k2TDuz8N,1000,1/23/2020,9900,k2TDuz8N,34400,more than downpayment,more than downpayment,0,1000
k2TDuz8N,2400,1/27/2020,9900,k2TDuz8N,36800,more than downpayment,more than downpayment,0,2400
k2TDuz8N,1000,2/8/2020,9900,k2TDuz8N,37800,more than downpayment,more than downpayment,0,1000
K2W5IZOK,9900,12/16/2019,9900,,9900,equal to downpayment,,9900,0
K3vson6y,8900,10/26/2018,8900,,8900,equal to downpayment,,8900,0
K3vson6y,7800,11/23/2018,8900,K3vson6y,16700,more than downpayment,equal to downpayment,0,7800
K3vson6y,7800,1/17/2019,8900,K3vson6y,24500,more than downpayment,more than downpayment,0,7800
K3vson6y,3900,2/5/2019,8900,K3vson6y,28400,more than downpayment,more than downpayment,0,3900
K3vson6y,3900,3/10/2019,8900,K3vson6y,32300,more than downpayment,more than downpayment,0,3900
K3vson6y,3900,4/18/2019,8900,K3vson6y,36200,more than downpayment,more than downpayment,0,3900
K3vson6y,3900,6/26/2019,8900,K3vson6y,40100,more than downpayment,more than downpayment,0,3900
K3vson6y,3900,9/2/2019,8900,K3vson6y,44000,more than downpayment,more than downpayment,0,3900
K3vson6y,3900,10/8/2019,8900,K3vson6y,47900,more than downpayment,more than downpayment,0,3900
K3vson6y,3900,10/18/2019,8900,K3vson6y,51800,more than downpayment,more than downpayment,0,3900
K3vson6y,3900,12/6/2019,8900,K3vson6y,55700,more than downpayment,more than downpayment,0,3900
K3vson6y,3900,2/2/2020,8900,K3vson6y,59600,more than downpayment,more than downpayment,0,3900
K6avIrsW,10000,7/24/2017,10000,,10000,equal to downpayment,,10000,0
K6avIrsW,833,1/15/2018,10000,K6avIrsW,10833,more than downpayment,equal to downpayment,0,833
K6avIrsW,6000,4/16/2018,10000,K6avIrsW,16833,more than downpayment,more than downpayment,0,6000
K6HPL7CY,9900,12/18/2019,9900,,9900,equal to downpayment,,9900,0
K8ESD15O,9900,9/16/2019,9900,,9900,equal to downpayment,,9900,0
K8ESD15O,3400,11/10/2019,9900,K8ESD15O,13300,more than downpayment,equal to downpayment,0,3400
K8ESD15O,500,11/12/2019,9900,K8ESD15O,13800,more than downpayment,more than downpayment,0,500
K8ESD15O,3900,12/11/2019,9900,K8ESD15O,17700,more than downpayment,more than downpayment,0,3900
K8ESD15O,3000,1/29/2020,9900,K8ESD15O,20700,more than downpayment,more than downpayment,0,3000
K8ESD15O,900,2/7/2020,9900,K8ESD15O,21600,more than downpayment,more than downpayment,0,900
k8JzB36B,50000,12/19/2018,0,,50000,more than downpayment,,0,50000
k8JzB36B,17000,3/22/2019,0,k8JzB36B,67000,more than downpayment,more than downpayment,0,17000
k8JzB36B,17000,5/3/2019,0,k8JzB36B,84000,more than downpayment,more than downpayment,0,17000
k8JzB36B,7000,1/16/2020,0,k8JzB36B,91000,more than downpayment,more than downpayment,0,7000
ka9NJKeX,10000,1/22/2019,10000,,10000,equal to downpayment,,10000,0
ka9NJKeX,4500,3/4/2019,10000,ka9NJKeX,14500,more than downpayment,equal to downpayment,0,4500
ka9NJKeX,4500,4/5/2019,10000,ka9NJKeX,19000,more than downpayment,more than downpayment,0,4500
ka9NJKeX,4500,5/6/2019,10000,ka9NJKeX,23500,more than downpayment,more than downpayment,0,4500
ka9NJKeX,4500,6/6/2019,10000,ka9NJKeX,28000,more than downpayment,more than downpayment,0,4500
ka9NJKeX,4500,7/9/2019,10000,ka9NJKeX,32500,more than downpayment,more than downpayment,0,4500
ka9NJKeX,4500,8/5/2019,10000,ka9NJKeX,37000,more than downpayment,more than downpayment,0,4500
ka9NJKeX,4500,9/13/2019,10000,ka9NJKeX,41500,more than downpayment,more than downpayment,0,4500
ka9NJKeX,4500,10/8/2019,10000,ka9NJKeX,46000,more than downpayment,more than downpayment,0,4500
ka9NJKeX,4500,11/22/2019,10000,ka9NJKeX,50500,more than downpayment,more than downpayment,0,4500
ka9NJKeX,4500,12/11/2019,10000,ka9NJKeX,55000,more than downpayment,more than downpayment,0,4500
ka9NJKeX,4500,1/8/2020,10000,ka9NJKeX,59500,more than downpayment,more than downpayment,0,4500
kCEg0TFA,10000,8/31/2017,10000,,10000,equal to downpayment,,10000,0
kCEg0TFA,3500,10/5/2017,10000,kCEg0TFA,13500,more than downpayment,equal to downpayment,0,3500
kCEg0TFA,1000,3/20/2018,10000,kCEg0TFA,14500,more than downpayment,more than downpayment,0,1000
kCEg0TFA,1000,4/13/2018,10000,kCEg0TFA,15500,more than downpayment,more than downpayment,0,1000
kCEg0TFA,1000,1/14/2019,10000,kCEg0TFA,16500,more than downpayment,more than downpayment,0,1000
kCEg0TFA,2000,3/5/2019,10000,kCEg0TFA,18500,more than downpayment,more than downpayment,0,2000
kcfpo9oA,8900,3/16/2019,8900,,8900,equal to downpayment,,8900,0
kcfpo9oA,4950,4/24/2019,8900,kcfpo9oA,13850,more than downpayment,equal to downpayment,0,4950
kcfpo9oA,800,6/22/2019,8900,kcfpo9oA,14650,more than downpayment,more than downpayment,0,800
kcfpo9oA,650,7/1/2019,8900,kcfpo9oA,15300,more than downpayment,more than downpayment,0,650
kcfpo9oA,1300,7/3/2019,8900,kcfpo9oA,16600,more than downpayment,more than downpayment,0,1300
kcfpo9oA,100,7/9/2019,8900,kcfpo9oA,16700,more than downpayment,more than downpayment,0,100
kcfpo9oA,900,7/25/2019,8900,kcfpo9oA,17600,more than downpayment,more than downpayment,0,900
kcfpo9oA,2200,8/2/2019,8900,kcfpo9oA,19800,more than downpayment,more than downpayment,0,2200
kcfpo9oA,530,8/8/2019,8900,kcfpo9oA,20330,more than downpayment,more than downpayment,0,530
kcfpo9oA,500,8/10/2019,8900,kcfpo9oA,20830,more than downpayment,more than downpayment,0,500
kcfpo9oA,3400,9/6/2019,8900,kcfpo9oA,24230,more than downpayment,more than downpayment,0,3400
kcfpo9oA,300,9/17/2019,8900,kcfpo9oA,24530,more than downpayment,more than downpayment,0,300
kcfpo9oA,4800,9/25/2019,8900,kcfpo9oA,29330,more than downpayment,more than downpayment,0,4800
kcfpo9oA,400,10/29/2019,8900,kcfpo9oA,29730,more than downpayment,more than downpayment,0,400
kcfpo9oA,4100,12/16/2019,8900,kcfpo9oA,33830,more than downpayment,more than downpayment,0,4100
kcfpo9oA,2000,12/24/2019,8900,kcfpo9oA,35830,more than downpayment,more than downpayment,0,2000
kcfpo9oA,1400,12/25/2019,8900,kcfpo9oA,37230,more than downpayment,more than downpayment,0,1400
kcfpo9oA,2000,12/28/2019,8900,kcfpo9oA,39230,more than downpayment,more than downpayment,0,2000
kcfpo9oA,950,1/8/2020,8900,kcfpo9oA,40180,more than downpayment,more than downpayment,0,950
KD6MVEU6,9900,1/14/2020,9900,,9900,equal to downpayment,,9900,0
KdNpwu7g,8900,7/29/2019,8900,,8900,equal to downpayment,,8900,0
KdNpwu7g,3900,9/5/2019,8900,KdNpwu7g,12800,more than downpayment,equal to downpayment,0,3900
KdNpwu7g,3900,10/16/2019,8900,KdNpwu7g,16700,more than downpayment,more than downpayment,0,3900
KdNpwu7g,3900,11/13/2019,8900,KdNpwu7g,20600,more than downpayment,more than downpayment,0,3900
KdNpwu7g,3900,1/3/2020,8900,KdNpwu7g,24500,more than downpayment,more than downpayment,0,3900
KdNpwu7g,3900,1/7/2020,8900,KdNpwu7g,28400,more than downpayment,more than downpayment,0,3900
KDSTD4CM,5000,1/31/2020,7900,,5000,less than downpayment,,5000,0
kdTh3hD0,8900,4/25/2019,8900,,8900,equal to downpayment,,8900,0
kdTh3hD0,3900,6/4/2019,8900,kdTh3hD0,12800,more than downpayment,equal to downpayment,0,3900
kdTh3hD0,3900,7/6/2019,8900,kdTh3hD0,16700,more than downpayment,more than downpayment,0,3900
kdTh3hD0,3900,11/23/2019,8900,kdTh3hD0,20600,more than downpayment,more than downpayment,0,3900
kdTh3hD0,3900,12/25/2019,8900,kdTh3hD0,24500,more than downpayment,more than downpayment,0,3900
kdTh3hD0,3900,2/3/2020,8900,kdTh3hD0,28400,more than downpayment,more than downpayment,0,3900
KE7ICUKC,9900,11/23/2019,9900,,9900,equal to downpayment,,9900,0
KE7ICUKC,4000,2/3/2020,9900,KE7ICUKC,13900,more than downpayment,equal to downpayment,0,4000
KE8KP2GW,8900,1/15/2020,8900,,8900,equal to downpayment,,8900,0
kekq96y9,9900,7/9/2019,9900,,9900,equal to downpayment,,9900,0
kErKe1Ru,10000,12/15/2017,10000,,10000,equal to downpayment,,10000,0
KF1J94GM,9900,2/9/2020,9900,,9900,equal to downpayment,,9900,0
KfcbwJqv,10000,6/22/2017,10000,,10000,equal to downpayment,,10000,0
KfcbwJqv,3500,8/1/2017,10000,KfcbwJqv,13500,more than downpayment,equal to downpayment,0,3500
KfcbwJqv,3500,9/1/2017,10000,KfcbwJqv,17000,more than downpayment,more than downpayment,0,3500
KfcbwJqv,3500,10/1/2017,10000,KfcbwJqv,20500,more than downpayment,more than downpayment,0,3500
KfcbwJqv,3500,10/26/2017,10000,KfcbwJqv,24000,more than downpayment,more than downpayment,0,3500
KfcbwJqv,3500,11/26/2017,10000,KfcbwJqv,27500,more than downpayment,more than downpayment,0,3500
KfcbwJqv,3500,12/27/2017,10000,KfcbwJqv,31000,more than downpayment,more than downpayment,0,3500
KfcbwJqv,3500,1/29/2018,10000,KfcbwJqv,34500,more than downpayment,more than downpayment,0,3500
KfcbwJqv,3500,3/1/2018,10000,KfcbwJqv,38000,more than downpayment,more than downpayment,0,3500
KfcbwJqv,3500,3/30/2018,10000,KfcbwJqv,41500,more than downpayment,more than downpayment,0,3500
KfcbwJqv,3500,4/30/2018,10000,KfcbwJqv,45000,more than downpayment,more than downpayment,0,3500
KFUEBMU3,9900,11/12/2019,9900,,9900,equal to downpayment,,9900,0
KFUEBMU3,3900,12/3/2019,9900,KFUEBMU3,13800,more than downpayment,equal to downpayment,0,3900
KFUEBMU3,3900,1/3/2020,9900,KFUEBMU3,17700,more than downpayment,more than downpayment,0,3900
KFUEBMU3,3900,2/4/2020,9900,KFUEBMU3,21600,more than downpayment,more than downpayment,0,3900
kFxsJaYq,10000,1/23/2018,10000,,10000,equal to downpayment,,10000,0
kFxsJaYq,4500,2/23/2018,10000,kFxsJaYq,14500,more than downpayment,equal to downpayment,0,4500
kFxsJaYq,4500,3/25/2018,10000,kFxsJaYq,19000,more than downpayment,more than downpayment,0,4500
kFxsJaYq,4500,4/28/2018,10000,kFxsJaYq,23500,more than downpayment,more than downpayment,0,4500
kFxsJaYq,4500,5/31/2018,10000,kFxsJaYq,28000,more than downpayment,more than downpayment,0,4500
kFxsJaYq,4500,7/7/2018,10000,kFxsJaYq,32500,more than downpayment,more than downpayment,0,4500
kFxsJaYq,4500,8/7/2018,10000,kFxsJaYq,37000,more than downpayment,more than downpayment,0,4500
kFxsJaYq,4500,9/3/2018,10000,kFxsJaYq,41500,more than downpayment,more than downpayment,0,4500
kFxsJaYq,4500,10/4/2018,10000,kFxsJaYq,46000,more than downpayment,more than downpayment,0,4500
kFxsJaYq,4500,10/26/2018,10000,kFxsJaYq,50500,more than downpayment,more than downpayment,0,4500
kFxsJaYq,4500,12/9/2018,10000,kFxsJaYq,55000,more than downpayment,more than downpayment,0,4500
kFxsJaYq,4500,1/8/2019,10000,kFxsJaYq,59500,more than downpayment,more than downpayment,0,4500
kFxsJaYq,4500,2/5/2019,10000,kFxsJaYq,64000,more than downpayment,more than downpayment,0,4500
KHEBEP2A,9900,12/17/2019,8900,,9900,more than downpayment,,8900,1000
kJ4s6MYu,10000,6/28/2019,9900,,10000,more than downpayment,,9900,100
kJ4s6MYu,4000,8/4/2019,9900,kJ4s6MYu,14000,more than downpayment,more than downpayment,0,4000
kJ4s6MYu,4000,9/5/2019,9900,kJ4s6MYu,18000,more than downpayment,more than downpayment,0,4000
kJ4s6MYu,4000,10/2/2019,9900,kJ4s6MYu,22000,more than downpayment,more than downpayment,0,4000
kJ4s6MYu,3900,11/5/2019,9900,kJ4s6MYu,25900,more than downpayment,more than downpayment,0,3900
kJ4s6MYu,3900,12/3/2019,9900,kJ4s6MYu,29800,more than downpayment,more than downpayment,0,3900
kJ4s6MYu,3900,1/4/2020,9900,kJ4s6MYu,33700,more than downpayment,more than downpayment,0,3900
kJ4s6MYu,3900,2/4/2020,9900,kJ4s6MYu,37600,more than downpayment,more than downpayment,0,3900
kJAI8qZn,10000,11/28/2018,10000,,10000,equal to downpayment,,10000,0
kJAI8qZn,4500,12/24/2018,10000,kJAI8qZn,14500,more than downpayment,equal to downpayment,0,4500
kJAI8qZn,4500,1/24/2019,10000,kJAI8qZn,19000,more than downpayment,more than downpayment,0,4500
kJAI8qZn,4500,2/25/2019,10000,kJAI8qZn,23500,more than downpayment,more than downpayment,0,4500
kJAI8qZn,4500,3/25/2019,10000,kJAI8qZn,28000,more than downpayment,more than downpayment,0,4500
kJAI8qZn,4500,4/25/2019,10000,kJAI8qZn,32500,more than downpayment,more than downpayment,0,4500
kJAI8qZn,4500,5/25/2019,10000,kJAI8qZn,37000,more than downpayment,more than downpayment,0,4500
kJAI8qZn,4500,6/25/2019,10000,kJAI8qZn,41500,more than downpayment,more than downpayment,0,4500
kJAI8qZn,4500,7/25/2019,10000,kJAI8qZn,46000,more than downpayment,more than downpayment,0,4500
kJAI8qZn,4500,8/26/2019,10000,kJAI8qZn,50500,more than downpayment,more than downpayment,0,4500
kJAI8qZn,4500,9/25/2019,10000,kJAI8qZn,55000,more than downpayment,more than downpayment,0,4500
kJAI8qZn,4500,10/25/2019,10000,kJAI8qZn,59500,more than downpayment,more than downpayment,0,4500
kJAI8qZn,4500,11/25/2019,10000,kJAI8qZn,64000,more than downpayment,more than downpayment,0,4500
KjxFzTuZ,9900,12/21/2018,9900,,9900,equal to downpayment,,9900,0
KjxFzTuZ,9000,2/11/2019,9900,KjxFzTuZ,18900,more than downpayment,equal to downpayment,0,9000
KjxFzTuZ,9000,4/26/2019,9900,KjxFzTuZ,27900,more than downpayment,more than downpayment,0,9000
KjxFzTuZ,4500,6/24/2019,9900,KjxFzTuZ,32400,more than downpayment,more than downpayment,0,4500
KjxFzTuZ,4500,6/29/2019,9900,KjxFzTuZ,36900,more than downpayment,more than downpayment,0,4500
KjxFzTuZ,4500,8/30/2019,9900,KjxFzTuZ,41400,more than downpayment,more than downpayment,0,4500
KjxFzTuZ,4500,9/24/2019,9900,KjxFzTuZ,45900,more than downpayment,more than downpayment,0,4500
KjxFzTuZ,4500,10/24/2019,9900,KjxFzTuZ,50400,more than downpayment,more than downpayment,0,4500
KjxFzTuZ,4500,11/25/2019,9900,KjxFzTuZ,54900,more than downpayment,more than downpayment,0,4500
KjxFzTuZ,4500,12/30/2019,9900,KjxFzTuZ,59400,more than downpayment,more than downpayment,0,4500
KjxFzTuZ,4500,1/24/2020,9900,KjxFzTuZ,63900,more than downpayment,more than downpayment,0,4500
KK2GT4QX,9900,11/9/2019,9900,,9900,equal to downpayment,,9900,0
KK2GT4QX,3900,12/4/2019,9900,KK2GT4QX,13800,more than downpayment,equal to downpayment,0,3900
KK2GT4QX,3900,1/3/2020,9900,KK2GT4QX,17700,more than downpayment,more than downpayment,0,3900
KK2GT4QX,3900,2/4/2020,9900,KK2GT4QX,21600,more than downpayment,more than downpayment,0,3900
kk4BUAt9,3900,8/14/2018,9900,,3900,less than downpayment,,3900,0
kk4BUAt9,9900,7/8/2019,9900,kk4BUAt9,13800,more than downpayment,less than downpayment,6000,3900
kk4BUAt9,3900,9/11/2019,9900,kk4BUAt9,17700,more than downpayment,more than downpayment,0,3900
kk4BUAt9,3900,10/23/2019,9900,kk4BUAt9,21600,more than downpayment,more than downpayment,0,3900
kk4BUAt9,3900,11/14/2019,9900,kk4BUAt9,25500,more than downpayment,more than downpayment,0,3900
kk4BUAt9,3900,12/20/2019,9900,kk4BUAt9,29400,more than downpayment,more than downpayment,0,3900
kk4BUAt9,3900,1/23/2020,9900,kk4BUAt9,33300,more than downpayment,more than downpayment,0,3900
KKFHBIDE,8900,1/31/2020,8900,,8900,equal to downpayment,,8900,0
KKGCB2H5,1594,10/14/2019,1594,,1594,equal to downpayment,,1594,0
kKr118nz,9900,8/19/2019,9900,,9900,equal to downpayment,,9900,0
kKr118nz,3900,10/13/2019,9900,kKr118nz,13800,more than downpayment,equal to downpayment,0,3900
kKr118nz,3900,11/14/2019,9900,kKr118nz,17700,more than downpayment,more than downpayment,0,3900
kKr118nz,3900,12/13/2019,9900,kKr118nz,21600,more than downpayment,more than downpayment,0,3900
KKYXOII9,9900,9/2/2019,9900,,9900,equal to downpayment,,9900,0
KKYXOII9,3900,11/21/2019,9900,KKYXOII9,13800,more than downpayment,equal to downpayment,0,3900
KKYXOII9,3900,12/26/2019,9900,KKYXOII9,17700,more than downpayment,more than downpayment,0,3900
KKYXOII9,3900,1/24/2020,9900,KKYXOII9,21600,more than downpayment,more than downpayment,0,3900
klM7DKtu,8900,4/2/2019,8900,,8900,equal to downpayment,,8900,0
klM7DKtu,3900,5/10/2019,8900,klM7DKtu,12800,more than downpayment,equal to downpayment,0,3900
klM7DKtu,3900,6/4/2019,8900,klM7DKtu,16700,more than downpayment,more than downpayment,0,3900
klM7DKtu,3900,7/12/2019,8900,klM7DKtu,20600,more than downpayment,more than downpayment,0,3900
klM7DKtu,3900,8/21/2019,8900,klM7DKtu,24500,more than downpayment,more than downpayment,0,3900
klM7DKtu,3900,10/17/2019,8900,klM7DKtu,28400,more than downpayment,more than downpayment,0,3900
KN5GTTJN,9900,7/12/2019,9900,,9900,equal to downpayment,,9900,0
KN5GTTJN,4000,9/12/2019,9900,KN5GTTJN,13900,more than downpayment,equal to downpayment,0,4000
KN5GTTJN,4000,10/16/2019,9900,KN5GTTJN,17900,more than downpayment,more than downpayment,0,4000
KN5GTTJN,2000,11/28/2019,9900,KN5GTTJN,19900,more than downpayment,more than downpayment,0,2000
KN5GTTJN,1700,12/4/2019,9900,KN5GTTJN,21600,more than downpayment,more than downpayment,0,1700
KN5GTTJN,2000,12/30/2019,9900,KN5GTTJN,23600,more than downpayment,more than downpayment,0,2000
KN5GTTJN,2000,1/5/2020,9900,KN5GTTJN,25600,more than downpayment,more than downpayment,0,2000
KN5GTTJN,2000,1/20/2020,9900,KN5GTTJN,27600,more than downpayment,more than downpayment,0,2000
KN5GTTJN,2000,1/29/2020,9900,KN5GTTJN,29600,more than downpayment,more than downpayment,0,2000
Knt8RcOo,9899.97,6/13/2019,9900,,9899.97,less than downpayment,,9899.97,0
Knt8RcOo,3900,7/25/2019,9900,Knt8RcOo,13799.97,more than downpayment,less than downpayment,0.03,3899.97
Knt8RcOo,3900,8/24/2019,9900,Knt8RcOo,17699.97,more than downpayment,more than downpayment,0,3900
Knt8RcOo,3900,9/24/2019,9900,Knt8RcOo,21599.97,more than downpayment,more than downpayment,0,3900
Knt8RcOo,3900,10/24/2019,9900,Knt8RcOo,25499.97,more than downpayment,more than downpayment,0,3900
Knt8RcOo,3900,12/6/2019,9900,Knt8RcOo,29399.97,more than downpayment,more than downpayment,0,3900
Knt8RcOo,3900,12/30/2019,9900,Knt8RcOo,33299.97,more than downpayment,more than downpayment,0,3900
Knt8RcOo,3900,1/24/2020,9900,Knt8RcOo,37199.97,more than downpayment,more than downpayment,0,3900
KO61BHH2,6265,5/12/2017,6625,,6265,less than downpayment,,6265,0
KO61BHH2,1500,12/21/2017,6625,KO61BHH2,7765,more than downpayment,less than downpayment,360,1140
KO61BHH2,1500,2/11/2018,6625,KO61BHH2,9265,more than downpayment,more than downpayment,0,1500
KO61BHH2,1000,4/16/2018,6625,KO61BHH2,10265,more than downpayment,more than downpayment,0,1000
KO61BHH2,3000,6/25/2018,6625,KO61BHH2,13265,more than downpayment,more than downpayment,0,3000
KO61BHH2,1000,8/5/2018,6625,KO61BHH2,14265,more than downpayment,more than downpayment,0,1000
KO61BHH2,3000,10/8/2018,6625,KO61BHH2,17265,more than downpayment,more than downpayment,0,3000
KO61BHH2,2000,8/15/2019,6625,KO61BHH2,19265,more than downpayment,more than downpayment,0,2000
kOcauB5H,8900,11/9/2018,8900,,8900,equal to downpayment,,8900,0
kOcauB5H,3900,1/29/2019,8900,kOcauB5H,12800,more than downpayment,equal to downpayment,0,3900
kOcauB5H,3900,3/29/2019,8900,kOcauB5H,16700,more than downpayment,more than downpayment,0,3900
kOcauB5H,3900,5/8/2019,8900,kOcauB5H,20600,more than downpayment,more than downpayment,0,3900
kOcauB5H,3900,5/29/2019,8900,kOcauB5H,24500,more than downpayment,more than downpayment,0,3900
kOcauB5H,3900,7/2/2019,8900,kOcauB5H,28400,more than downpayment,more than downpayment,0,3900
kOcauB5H,3900,8/6/2019,8900,kOcauB5H,32300,more than downpayment,more than downpayment,0,3900
kOcauB5H,3900,8/30/2019,8900,kOcauB5H,36200,more than downpayment,more than downpayment,0,3900
kOcauB5H,3900,9/29/2019,8900,kOcauB5H,40100,more than downpayment,more than downpayment,0,3900
kOcauB5H,3900,10/28/2019,8900,kOcauB5H,44000,more than downpayment,more than downpayment,0,3900
kOcauB5H,3900,11/25/2019,8900,kOcauB5H,47900,more than downpayment,more than downpayment,0,3900
kOcauB5H,3900,1/1/2020,8900,kOcauB5H,51800,more than downpayment,more than downpayment,0,3900
kOcauB5H,3900,1/27/2020,8900,kOcauB5H,55700,more than downpayment,more than downpayment,0,3900
KOPUTJGG,1594,10/14/2019,1594,,1594,equal to downpayment,,1594,0
KOPUTJGG,3100,11/29/2019,1594,KOPUTJGG,4694,more than downpayment,equal to downpayment,0,3100
KOPUTJGG,3100,1/4/2020,1594,KOPUTJGG,7794,more than downpayment,more than downpayment,0,3100
KOPUTJGG,3100,2/6/2020,1594,KOPUTJGG,10894,more than downpayment,more than downpayment,0,3100
kPEZHszY,8900,3/23/2019,8900,,8900,equal to downpayment,,8900,0
kPEZHszY,3900,4/8/2019,8900,kPEZHszY,12800,more than downpayment,equal to downpayment,0,3900
kPEZHszY,3900,5/22/2019,8900,kPEZHszY,16700,more than downpayment,more than downpayment,0,3900
kPEZHszY,3900,6/26/2019,8900,kPEZHszY,20600,more than downpayment,more than downpayment,0,3900
kPEZHszY,3900,7/18/2019,8900,kPEZHszY,24500,more than downpayment,more than downpayment,0,3900
kPEZHszY,3900,8/27/2019,8900,kPEZHszY,28400,more than downpayment,more than downpayment,0,3900
kPEZHszY,3900,9/27/2019,8900,kPEZHszY,32300,more than downpayment,more than downpayment,0,3900
kPEZHszY,3900,10/22/2019,8900,kPEZHszY,36200,more than downpayment,more than downpayment,0,3900
kPEZHszY,3900,11/19/2019,8900,kPEZHszY,40100,more than downpayment,more than downpayment,0,3900
kPEZHszY,69900,12/18/2019,8900,kPEZHszY,110000,more than downpayment,more than downpayment,0,69900
KQJegrr3,9000,4/23/2019,8900,,9000,more than downpayment,,8900,100
KQJegrr3,800,5/7/2019,8900,KQJegrr3,9800,more than downpayment,more than downpayment,0,800
KQJegrr3,3200,5/17/2019,8900,KQJegrr3,13000,more than downpayment,more than downpayment,0,3200
KQJegrr3,1400,6/17/2019,8900,KQJegrr3,14400,more than downpayment,more than downpayment,0,1400
KQJegrr3,2600,6/24/2019,8900,KQJegrr3,17000,more than downpayment,more than downpayment,0,2600
KQJegrr3,900,7/8/2019,8900,KQJegrr3,17900,more than downpayment,more than downpayment,0,900
KQJegrr3,3100,7/22/2019,8900,KQJegrr3,21000,more than downpayment,more than downpayment,0,3100
KQJegrr3,5000,8/21/2019,8900,KQJegrr3,26000,more than downpayment,more than downpayment,0,5000
KQJegrr3,3900,9/23/2019,8900,KQJegrr3,29900,more than downpayment,more than downpayment,0,3900
KQJegrr3,4000,10/22/2019,8900,KQJegrr3,33900,more than downpayment,more than downpayment,0,4000
KQJegrr3,3900,11/23/2019,8900,KQJegrr3,37800,more than downpayment,more than downpayment,0,3900
KQJegrr3,4000,12/22/2019,8900,KQJegrr3,41800,more than downpayment,more than downpayment,0,4000
KQJegrr3,1700,1/22/2020,8900,KQJegrr3,43500,more than downpayment,more than downpayment,0,1700
KQJegrr3,2200,1/23/2020,8900,KQJegrr3,45700,more than downpayment,more than downpayment,0,2200
KQXID6ZA,8900,1/22/2019,0,,8900,more than downpayment,,0,8900
KQXID6ZA,3900,2/27/2019,0,KQXID6ZA,12800,more than downpayment,more than downpayment,0,3900
KQXID6ZA,3900,3/27/2019,0,KQXID6ZA,16700,more than downpayment,more than downpayment,0,3900
KQXID6ZA,3900,6/24/2019,0,KQXID6ZA,20600,more than downpayment,more than downpayment,0,3900
KQXID6ZA,3900,8/13/2019,0,KQXID6ZA,24500,more than downpayment,more than downpayment,0,3900
KQXID6ZA,4000,8/28/2019,0,KQXID6ZA,28500,more than downpayment,more than downpayment,0,4000
KQXID6ZA,4000,9/28/2019,0,KQXID6ZA,32500,more than downpayment,more than downpayment,0,4000
KQXID6ZA,3900,11/27/2019,0,KQXID6ZA,36400,more than downpayment,more than downpayment,0,3900
KQXID6ZA,3000,12/26/2019,0,KQXID6ZA,39400,more than downpayment,more than downpayment,0,3000
KQXID6ZA,1000,1/3/2020,0,KQXID6ZA,40400,more than downpayment,more than downpayment,0,1000
KQXID6ZA,5000,2/4/2020,0,KQXID6ZA,45400,more than downpayment,more than downpayment,0,5000
KRH9JK59,9900,10/11/2019,9900,,9900,equal to downpayment,,9900,0
KRH9JK59,7800,12/11/2019,9900,KRH9JK59,17700,more than downpayment,equal to downpayment,0,7800
KRPTAF3P,9900,10/4/2019,9900,,9900,equal to downpayment,,9900,0
KRPTAF3P,3900,12/2/2019,9900,KRPTAF3P,13800,more than downpayment,equal to downpayment,0,3900
KRPTAF3P,3900,12/26/2019,9900,KRPTAF3P,17700,more than downpayment,more than downpayment,0,3900
KRPTAF3P,3900,1/26/2020,9900,KRPTAF3P,21600,more than downpayment,more than downpayment,0,3900
KRQVAUIG,9900,7/10/2019,9900,,9900,equal to downpayment,,9900,0
KRQVAUIG,3900,9/4/2019,9900,KRQVAUIG,13800,more than downpayment,equal to downpayment,0,3900
KRQVAUIG,3900,10/3/2019,9900,KRQVAUIG,17700,more than downpayment,more than downpayment,0,3900
KRQVAUIG,3900,11/5/2019,9900,KRQVAUIG,21600,more than downpayment,more than downpayment,0,3900
KRQVAUIG,3900,12/5/2019,9900,KRQVAUIG,25500,more than downpayment,more than downpayment,0,3900
KRQVAUIG,3900,12/30/2019,9900,KRQVAUIG,29400,more than downpayment,more than downpayment,0,3900
KRQVAUIG,3900,2/5/2020,9900,KRQVAUIG,33300,more than downpayment,more than downpayment,0,3900
krwq5b1p,10000,8/15/2017,10000,,10000,equal to downpayment,,10000,0
krwq5b1p,10000,10/24/2017,10000,krwq5b1p,20000,more than downpayment,equal to downpayment,0,10000
krwq5b1p,10000,11/26/2017,10000,krwq5b1p,30000,more than downpayment,more than downpayment,0,10000
krwq5b1p,15000,12/28/2017,10000,krwq5b1p,45000,more than downpayment,more than downpayment,0,15000
KRzenBoz,8900,3/6/2019,8900,,8900,equal to downpayment,,8900,0
KRzenBoz,3900,4/7/2019,8900,KRzenBoz,12800,more than downpayment,equal to downpayment,0,3900
KRzenBoz,3900,5/6/2019,8900,KRzenBoz,16700,more than downpayment,more than downpayment,0,3900
KRzenBoz,3900,6/6/2019,8900,KRzenBoz,20600,more than downpayment,more than downpayment,0,3900
KRzenBoz,3900,7/8/2019,8900,KRzenBoz,24500,more than downpayment,more than downpayment,0,3900
KRzenBoz,3900,8/8/2019,8900,KRzenBoz,28400,more than downpayment,more than downpayment,0,3900
KRzenBoz,3900,9/6/2019,8900,KRzenBoz,32300,more than downpayment,more than downpayment,0,3900
KRzenBoz,3900,10/24/2019,8900,KRzenBoz,36200,more than downpayment,more than downpayment,0,3900
KRzenBoz,3900,11/8/2019,8900,KRzenBoz,40100,more than downpayment,more than downpayment,0,3900
KRzenBoz,3900,12/15/2019,8900,KRzenBoz,44000,more than downpayment,more than downpayment,0,3900
KRzenBoz,3900,1/4/2020,8900,KRzenBoz,47900,more than downpayment,more than downpayment,0,3900
KRzenBoz,3900,2/7/2020,8900,KRzenBoz,51800,more than downpayment,more than downpayment,0,3900
ksg9lOE2,8900,1/22/2019,8900,,8900,equal to downpayment,,8900,0
ksg9lOE2,3900,2/26/2019,8900,ksg9lOE2,12800,more than downpayment,equal to downpayment,0,3900
ksg9lOE2,3900,3/25/2019,8900,ksg9lOE2,16700,more than downpayment,more than downpayment,0,3900
ksg9lOE2,3900,4/25/2019,8900,ksg9lOE2,20600,more than downpayment,more than downpayment,0,3900
ksg9lOE2,3900,5/26/2019,8900,ksg9lOE2,24500,more than downpayment,more than downpayment,0,3900
ksg9lOE2,3900,6/26/2019,8900,ksg9lOE2,28400,more than downpayment,more than downpayment,0,3900
ksg9lOE2,3900,7/24/2019,8900,ksg9lOE2,32300,more than downpayment,more than downpayment,0,3900
ksg9lOE2,3900,8/25/2019,8900,ksg9lOE2,36200,more than downpayment,more than downpayment,0,3900
ksg9lOE2,3900,9/24/2019,8900,ksg9lOE2,40100,more than downpayment,more than downpayment,0,3900
ksg9lOE2,3900,10/26/2019,8900,ksg9lOE2,44000,more than downpayment,more than downpayment,0,3900
ksg9lOE2,3900,11/27/2019,8900,ksg9lOE2,47900,more than downpayment,more than downpayment,0,3900
ksg9lOE2,3900,12/26/2019,8900,ksg9lOE2,51800,more than downpayment,more than downpayment,0,3900
ksg9lOE2,3900,1/26/2020,8900,ksg9lOE2,55700,more than downpayment,more than downpayment,0,3900
kTCeO4f2,10000,11/13/2018,10000,,10000,equal to downpayment,,10000,0
KTNHPXZ9,8000,9/30/2019,7900,,8000,more than downpayment,,7900,100
KTNHPXZ9,3000,11/1/2019,7900,KTNHPXZ9,11000,more than downpayment,more than downpayment,0,3000
KTNHPXZ9,3100,12/5/2019,7900,KTNHPXZ9,14100,more than downpayment,more than downpayment,0,3100
KTNHPXZ9,3100,1/2/2020,7900,KTNHPXZ9,17200,more than downpayment,more than downpayment,0,3100
KTNHPXZ9,3100,2/6/2020,7900,KTNHPXZ9,20300,more than downpayment,more than downpayment,0,3100
ktor4zU9,14400,12/10/2018,9900,,14400,more than downpayment,,9900,4500
ktor4zU9,4500,2/4/2019,9900,ktor4zU9,18900,more than downpayment,more than downpayment,0,4500
ktor4zU9,4500,2/25/2019,9900,ktor4zU9,23400,more than downpayment,more than downpayment,0,4500
ktor4zU9,4500,3/25/2019,9900,ktor4zU9,27900,more than downpayment,more than downpayment,0,4500
ktor4zU9,4500,4/27/2019,9900,ktor4zU9,32400,more than downpayment,more than downpayment,0,4500
ktor4zU9,4500,5/24/2019,9900,ktor4zU9,36900,more than downpayment,more than downpayment,0,4500
ktor4zU9,3500,7/2/2019,9900,ktor4zU9,40400,more than downpayment,more than downpayment,0,3500
ktor4zU9,5500,7/23/2019,9900,ktor4zU9,45900,more than downpayment,more than downpayment,0,5500
ktor4zU9,4500,8/25/2019,9900,ktor4zU9,50400,more than downpayment,more than downpayment,0,4500
ktor4zU9,4000,10/4/2019,9900,ktor4zU9,54400,more than downpayment,more than downpayment,0,4000
ktor4zU9,7700,11/25/2019,9900,ktor4zU9,62100,more than downpayment,more than downpayment,0,7700
ktor4zU9,1800,12/31/2019,9900,ktor4zU9,63900,more than downpayment,more than downpayment,0,1800
KtPtgGNK,8900,5/6/2019,8900,,8900,equal to downpayment,,8900,0
KtPtgGNK,3900,6/4/2019,8900,KtPtgGNK,12800,more than downpayment,equal to downpayment,0,3900
KtPtgGNK,3900,7/1/2019,8900,KtPtgGNK,16700,more than downpayment,more than downpayment,0,3900
KtPtgGNK,3900,8/3/2019,8900,KtPtgGNK,20600,more than downpayment,more than downpayment,0,3900
KtPtgGNK,3900,9/3/2019,8900,KtPtgGNK,24500,more than downpayment,more than downpayment,0,3900
KtPtgGNK,3900,10/2/2019,8900,KtPtgGNK,28400,more than downpayment,more than downpayment,0,3900
KtPtgGNK,3900,11/4/2019,8900,KtPtgGNK,32300,more than downpayment,more than downpayment,0,3900
KtPtgGNK,3900,12/2/2019,8900,KtPtgGNK,36200,more than downpayment,more than downpayment,0,3900
KtPtgGNK,3900,1/3/2020,8900,KtPtgGNK,40100,more than downpayment,more than downpayment,0,3900
KtPtgGNK,3900,2/3/2020,8900,KtPtgGNK,44000,more than downpayment,more than downpayment,0,3900
ktSPT1lE,9900,7/15/2019,9900,,9900,equal to downpayment,,9900,0
ku3yhcBP,8900,7/19/2019,8900,,8900,equal to downpayment,,8900,0
ku3yhcBP,3900,9/20/2019,8900,ku3yhcBP,12800,more than downpayment,equal to downpayment,0,3900
ku3yhcBP,3900,10/23/2019,8900,ku3yhcBP,16700,more than downpayment,more than downpayment,0,3900
ku3yhcBP,3900,11/25/2019,8900,ku3yhcBP,20600,more than downpayment,more than downpayment,0,3900
ku3yhcBP,3900,12/25/2019,8900,ku3yhcBP,24500,more than downpayment,more than downpayment,0,3900
ku3yhcBP,3900,1/21/2020,8900,ku3yhcBP,28400,more than downpayment,more than downpayment,0,3900
kU8cBTEI,8900,2/4/2019,0,,8900,more than downpayment,,0,8900
kU8cBTEI,89100,3/1/2019,0,kU8cBTEI,98000,more than downpayment,more than downpayment,0,89100
kvPBbyqj,9900,7/30/2019,9900,,9900,equal to downpayment,,9900,0
kvPBbyqj,5000,9/4/2019,9900,kvPBbyqj,14900,more than downpayment,equal to downpayment,0,5000
kvPBbyqj,4000,10/5/2019,9900,kvPBbyqj,18900,more than downpayment,more than downpayment,0,4000
kvPBbyqj,4000,11/5/2019,9900,kvPBbyqj,22900,more than downpayment,more than downpayment,0,4000
kvPBbyqj,5000,12/6/2019,9900,kvPBbyqj,27900,more than downpayment,more than downpayment,0,5000
kvPBbyqj,4000,1/7/2020,9900,kvPBbyqj,31900,more than downpayment,more than downpayment,0,4000
kvPBbyqj,4000,2/4/2020,9900,kvPBbyqj,35900,more than downpayment,more than downpayment,0,4000
kvzweUVz,5000,2/8/2019,8900,,5000,less than downpayment,,5000,0
kvzweUVz,8900,5/25/2019,8900,kvzweUVz,13900,more than downpayment,less than downpayment,3900,5000
KWViKpmX,20000,9/20/2018,10000,,20000,more than downpayment,,10000,10000
KWViKpmX,38000,1/16/2019,10000,KWViKpmX,58000,more than downpayment,more than downpayment,0,38000
KXAAPLBG,8900,11/29/2019,8900,,8900,equal to downpayment,,8900,0
kxoWVqIz,10000,8/24/2018,10000,,10000,equal to downpayment,,10000,0
kxoWVqIz,4500,9/23/2018,10000,kxoWVqIz,14500,more than downpayment,equal to downpayment,0,4500
kxoWVqIz,4500,10/25/2018,10000,kxoWVqIz,19000,more than downpayment,more than downpayment,0,4500
kxoWVqIz,4500,11/23/2018,10000,kxoWVqIz,23500,more than downpayment,more than downpayment,0,4500
kxoWVqIz,4500,12/31/2018,10000,kxoWVqIz,28000,more than downpayment,more than downpayment,0,4500
kxoWVqIz,4500,1/23/2019,10000,kxoWVqIz,32500,more than downpayment,more than downpayment,0,4500
kxoWVqIz,3000,3/4/2019,10000,kxoWVqIz,35500,more than downpayment,more than downpayment,0,3000
kxoWVqIz,1500,3/11/2019,10000,kxoWVqIz,37000,more than downpayment,more than downpayment,0,1500
kxoWVqIz,4450,3/25/2019,10000,kxoWVqIz,41450,more than downpayment,more than downpayment,0,4450
kxoWVqIz,50,3/26/2019,10000,kxoWVqIz,41500,more than downpayment,more than downpayment,0,50
kxoWVqIz,3000,5/13/2019,10000,kxoWVqIz,44500,more than downpayment,more than downpayment,0,3000
kxoWVqIz,1500,5/19/2019,10000,kxoWVqIz,46000,more than downpayment,more than downpayment,0,1500
kxoWVqIz,4000,8/6/2019,10000,kxoWVqIz,50000,more than downpayment,more than downpayment,0,4000
kxoWVqIz,4000,10/4/2019,10000,kxoWVqIz,54000,more than downpayment,more than downpayment,0,4000
KxubUm02,20000,7/17/2017,10000,,20000,more than downpayment,,10000,10000
KxubUm02,2000,9/19/2017,10000,KxubUm02,22000,more than downpayment,more than downpayment,0,2000
KxubUm02,25000,4/10/2018,10000,KxubUm02,47000,more than downpayment,more than downpayment,0,25000
KxUMvQTL,9900,11/8/2018,9900,,9900,equal to downpayment,,9900,0
KxUMvQTL,4500,12/15/2018,9900,KxUMvQTL,14400,more than downpayment,equal to downpayment,0,4500
KxUMvQTL,4500,1/14/2019,9900,KxUMvQTL,18900,more than downpayment,more than downpayment,0,4500
KxUMvQTL,4500,2/14/2019,9900,KxUMvQTL,23400,more than downpayment,more than downpayment,0,4500
KxUMvQTL,4500,3/14/2019,9900,KxUMvQTL,27900,more than downpayment,more than downpayment,0,4500
KxUMvQTL,4500,4/13/2019,9900,KxUMvQTL,32400,more than downpayment,more than downpayment,0,4500
KxUMvQTL,4500,5/14/2019,9900,KxUMvQTL,36900,more than downpayment,more than downpayment,0,4500
KxUMvQTL,4500,6/15/2019,9900,KxUMvQTL,41400,more than downpayment,more than downpayment,0,4500
KxUMvQTL,4500,7/14/2019,9900,KxUMvQTL,45900,more than downpayment,more than downpayment,0,4500
KxUMvQTL,4500,8/14/2019,9900,KxUMvQTL,50400,more than downpayment,more than downpayment,0,4500
KxUMvQTL,4500,9/13/2019,9900,KxUMvQTL,54900,more than downpayment,more than downpayment,0,4500
KxUMvQTL,4500,10/14/2019,9900,KxUMvQTL,59400,more than downpayment,more than downpayment,0,4500
KxUMvQTL,4500,12/4/2019,9900,KxUMvQTL,63900,more than downpayment,more than downpayment,0,4500
KxUMvQTL,4500,1/17/2020,9900,KxUMvQTL,68400,more than downpayment,more than downpayment,0,4500
KxUMvQTL,4500,1/31/2020,9900,KxUMvQTL,72900,more than downpayment,more than downpayment,0,4500
kxxCYlmQ,9900,11/30/2019,9900,,9900,equal to downpayment,,9900,0
KYRXGRZ1,1100,11/14/2019,9900,,1100,less than downpayment,,1100,0
KYRXGRZ1,700,11/16/2019,9900,KYRXGRZ1,1800,less than downpayment,less than downpayment,700,0
KYRXGRZ1,1650,11/19/2019,9900,KYRXGRZ1,3450,less than downpayment,less than downpayment,1650,0
KYRXGRZ1,1000,11/26/2019,9900,KYRXGRZ1,4450,less than downpayment,less than downpayment,1000,0
KYRXGRZ1,500,11/28/2019,9900,KYRXGRZ1,4950,less than downpayment,less than downpayment,500,0
KYRXGRZ1,500,12/4/2019,9900,KYRXGRZ1,5450,less than downpayment,less than downpayment,500,0
KYRXGRZ1,500,12/8/2019,9900,KYRXGRZ1,5950,less than downpayment,less than downpayment,500,0
KYRXGRZ1,250,1/5/2020,9900,KYRXGRZ1,6200,less than downpayment,less than downpayment,250,0
KYRXGRZ1,300,1/10/2020,9900,KYRXGRZ1,6500,less than downpayment,less than downpayment,300,0
KYRXGRZ1,200,1/17/2020,9900,KYRXGRZ1,6700,less than downpayment,less than downpayment,200,0
KYRXGRZ1,540,1/23/2020,9900,KYRXGRZ1,7240,less than downpayment,less than downpayment,540,0
KYRXGRZ1,400,1/26/2020,9900,KYRXGRZ1,7640,less than downpayment,less than downpayment,400,0
KYRXGRZ1,200,1/28/2020,9900,KYRXGRZ1,7840,less than downpayment,less than downpayment,200,0
KYRXGRZ1,500,1/30/2020,9900,KYRXGRZ1,8340,less than downpayment,less than downpayment,500,0
KYRXGRZ1,450,2/1/2020,9900,KYRXGRZ1,8790,less than downpayment,less than downpayment,450,0
KYRXGRZ1,900,2/6/2020,9900,KYRXGRZ1,9690,less than downpayment,less than downpayment,900,0
KYRXGRZ1,800,2/8/2020,9900,KYRXGRZ1,10490,more than downpayment,less than downpayment,210,590
KYTKYC9K,8900,9/13/2019,8900,,8900,equal to downpayment,,8900,0
KYTKYC9K,3900,2/7/2020,8900,KYTKYC9K,12800,more than downpayment,equal to downpayment,0,3900
KZ4U4CRW,23400,9/9/2019,8900,,23400,more than downpayment,,8900,14500
KZ4U4CRW,7300,10/3/2019,8900,KZ4U4CRW,30700,more than downpayment,more than downpayment,0,7300
KZ4U4CRW,7300,11/5/2019,8900,KZ4U4CRW,38000,more than downpayment,more than downpayment,0,7300
KZ4U4CRW,7300,12/5/2019,8900,KZ4U4CRW,45300,more than downpayment,more than downpayment,0,7300
KZ4U4CRW,7300,1/3/2020,8900,KZ4U4CRW,52600,more than downpayment,more than downpayment,0,7300
KZ4U4CRW,7300,2/4/2020,8900,KZ4U4CRW,59900,more than downpayment,more than downpayment,0,7300
kZjf3w59,8900,4/24/2019,8900,,8900,equal to downpayment,,8900,0
kZjf3w59,2000,5/9/2019,8900,kZjf3w59,10900,more than downpayment,equal to downpayment,0,2000
kZjf3w59,1900,6/1/2019,8900,kZjf3w59,12800,more than downpayment,more than downpayment,0,1900
kZjf3w59,4000,6/28/2019,8900,kZjf3w59,16800,more than downpayment,more than downpayment,0,4000
kZjf3w59,3900,7/14/2019,8900,kZjf3w59,20700,more than downpayment,more than downpayment,0,3900
kZjf3w59,3900,9/2/2019,8900,kZjf3w59,24600,more than downpayment,more than downpayment,0,3900
kZjf3w59,3900,10/2/2019,8900,kZjf3w59,28500,more than downpayment,more than downpayment,0,3900
kZjf3w59,3900,11/2/2019,8900,kZjf3w59,32400,more than downpayment,more than downpayment,0,3900
kZjf3w59,3900,11/29/2019,8900,kZjf3w59,36300,more than downpayment,more than downpayment,0,3900
kZjf3w59,3900,12/31/2019,8900,kZjf3w59,40200,more than downpayment,more than downpayment,0,3900
kZjf3w59,3900,1/29/2020,8900,kZjf3w59,44100,more than downpayment,more than downpayment,0,3900
KZq5WLhH,9900,7/5/2019,9900,,9900,equal to downpayment,,9900,0
KZq5WLhH,3900,9/4/2019,9900,KZq5WLhH,13800,more than downpayment,equal to downpayment,0,3900
KZq5WLhH,3900,10/1/2019,9900,KZq5WLhH,17700,more than downpayment,more than downpayment,0,3900
KZq5WLhH,3900,11/4/2019,9900,KZq5WLhH,21600,more than downpayment,more than downpayment,0,3900
KZq5WLhH,3900,12/2/2019,9900,KZq5WLhH,25500,more than downpayment,more than downpayment,0,3900
KZq5WLhH,3900,1/2/2020,9900,KZq5WLhH,29400,more than downpayment,more than downpayment,0,3900
KZq5WLhH,3900,2/4/2020,9900,KZq5WLhH,33300,more than downpayment,more than downpayment,0,3900
L131MFJP,9900,12/1/2019,9900,,9900,equal to downpayment,,9900,0
L131MFJP,3900,2/5/2020,9900,L131MFJP,13800,more than downpayment,equal to downpayment,0,3900
l1dt24KH,9900,6/10/2019,9900,,9900,equal to downpayment,,9900,0
l1dt24KH,3900,8/27/2019,9900,l1dt24KH,13800,more than downpayment,equal to downpayment,0,3900
l1dt24KH,3900,9/30/2019,9900,l1dt24KH,17700,more than downpayment,more than downpayment,0,3900
l1dt24KH,3900,10/26/2019,9900,l1dt24KH,21600,more than downpayment,more than downpayment,0,3900
l1dt24KH,3900,11/28/2019,9900,l1dt24KH,25500,more than downpayment,more than downpayment,0,3900
l1dt24KH,3900,12/20/2019,9900,l1dt24KH,29400,more than downpayment,more than downpayment,0,3900
l1dt24KH,3900,1/24/2020,9900,l1dt24KH,33300,more than downpayment,more than downpayment,0,3900
L1V9VKID,9900,1/6/2020,9900,,9900,equal to downpayment,,9900,0
L1Z1SGHK,9900,11/6/2019,9900,,9900,equal to downpayment,,9900,0
L1Z1SGHK,35000,12/5/2019,9900,L1Z1SGHK,44900,more than downpayment,equal to downpayment,0,35000
L282A2I6,9900,2/1/2020,9900,,9900,equal to downpayment,,9900,0
L2CAIF95,40000,10/4/2019,26250,,40000,more than downpayment,,26250,13750
L2CAIF95,65000,10/31/2019,26250,L2CAIF95,105000,more than downpayment,more than downpayment,0,65000
l2lqhUQo,8900,11/20/2019,8900,,8900,equal to downpayment,,8900,0
l2lqhUQo,3900,1/27/2020,8900,l2lqhUQo,12800,more than downpayment,equal to downpayment,0,3900
L2OANWMN,8900,1/10/2020,8900,,8900,equal to downpayment,,8900,0
L37LV2AK,9900,11/4/2019,9900,,9900,equal to downpayment,,9900,0
L37LV2AK,3900,12/17/2019,9900,L37LV2AK,13800,more than downpayment,equal to downpayment,0,3900
L37LV2AK,3900,1/17/2020,9900,L37LV2AK,17700,more than downpayment,more than downpayment,0,3900
L3A47L7S,8900,12/9/2019,8900,,8900,equal to downpayment,,8900,0
L3A47L7S,3900,1/13/2020,8900,L3A47L7S,12800,more than downpayment,equal to downpayment,0,3900
L3EO11KA,9900,6/18/2019,8900,,9900,more than downpayment,,8900,1000
L3EO11KA,3900,8/1/2019,8900,L3EO11KA,13800,more than downpayment,more than downpayment,0,3900
L3EO11KA,3900,9/3/2019,8900,L3EO11KA,17700,more than downpayment,more than downpayment,0,3900
L3EO11KA,3900,10/5/2019,8900,L3EO11KA,21600,more than downpayment,more than downpayment,0,3900
L3EO11KA,3900,11/4/2019,8900,L3EO11KA,25500,more than downpayment,more than downpayment,0,3900
L3EO11KA,3900,12/4/2019,8900,L3EO11KA,29400,more than downpayment,more than downpayment,0,3900
L3EO11KA,3900,1/4/2020,8900,L3EO11KA,33300,more than downpayment,more than downpayment,0,3900
L3EO11KA,3900,2/4/2020,8900,L3EO11KA,37200,more than downpayment,more than downpayment,0,3900
l3w8HGJF,9900,6/27/2019,9900,,9900,equal to downpayment,,9900,0
l3w8HGJF,4000,8/27/2019,9900,l3w8HGJF,13900,more than downpayment,equal to downpayment,0,4000
l3w8HGJF,3900,9/26/2019,9900,l3w8HGJF,17800,more than downpayment,more than downpayment,0,3900
l3w8HGJF,3800,11/13/2019,9900,l3w8HGJF,21600,more than downpayment,more than downpayment,0,3800
l3w8HGJF,3900,12/5/2019,9900,l3w8HGJF,25500,more than downpayment,more than downpayment,0,3900
l3w8HGJF,3900,1/4/2020,9900,l3w8HGJF,29400,more than downpayment,more than downpayment,0,3900
l3w8HGJF,3000,1/29/2020,9900,l3w8HGJF,32400,more than downpayment,more than downpayment,0,3000
L3YMTCKD,9900,6/15/2019,8900,,9900,more than downpayment,,8900,1000
L3YMTCKD,3900,8/4/2019,8900,L3YMTCKD,13800,more than downpayment,more than downpayment,0,3900
L3YMTCKD,3900,8/28/2019,8900,L3YMTCKD,17700,more than downpayment,more than downpayment,0,3900
L3YMTCKD,3900,10/5/2019,8900,L3YMTCKD,21600,more than downpayment,more than downpayment,0,3900
L3YMTCKD,3900,11/5/2019,8900,L3YMTCKD,25500,more than downpayment,more than downpayment,0,3900
L3YMTCKD,3900,12/3/2019,8900,L3YMTCKD,29400,more than downpayment,more than downpayment,0,3900
L3YMTCKD,3900,2/4/2020,8900,L3YMTCKD,33300,more than downpayment,more than downpayment,0,3900
L47YXTUP,9900,1/7/2020,9900,,9900,equal to downpayment,,9900,0
L488Q9LR,9900,8/23/2019,9900,,9900,equal to downpayment,,9900,0
L488Q9LR,3900,10/4/2019,9900,L488Q9LR,13800,more than downpayment,equal to downpayment,0,3900
L488Q9LR,3000,11/6/2019,9900,L488Q9LR,16800,more than downpayment,more than downpayment,0,3000
L488Q9LR,900,11/27/2019,9900,L488Q9LR,17700,more than downpayment,more than downpayment,0,900
L488Q9LR,2000,12/6/2019,9900,L488Q9LR,19700,more than downpayment,more than downpayment,0,2000
L488Q9LR,1900,12/29/2019,9900,L488Q9LR,21600,more than downpayment,more than downpayment,0,1900
L488Q9LR,3900,1/25/2020,9900,L488Q9LR,25500,more than downpayment,more than downpayment,0,3900
L4V2NHTL,9900,7/19/2019,9900,,9900,equal to downpayment,,9900,0
L4V2NHTL,3900,9/13/2019,9900,L4V2NHTL,13800,more than downpayment,equal to downpayment,0,3900
L4V2NHTL,3900,11/1/2019,9900,L4V2NHTL,17700,more than downpayment,more than downpayment,0,3900
L4V2NHTL,3900,11/26/2019,9900,L4V2NHTL,21600,more than downpayment,more than downpayment,0,3900
L4V2NHTL,3900,1/2/2020,9900,L4V2NHTL,25500,more than downpayment,more than downpayment,0,3900
L4V2NHTL,3900,1/29/2020,9900,L4V2NHTL,29400,more than downpayment,more than downpayment,0,3900
L5iF7UlR,28000,12/18/2018,10000,,28000,more than downpayment,,10000,18000
L5iF7UlR,4500,4/26/2019,10000,L5iF7UlR,32500,more than downpayment,more than downpayment,0,4500
L5iF7UlR,4500,6/3/2019,10000,L5iF7UlR,37000,more than downpayment,more than downpayment,0,4500
L5iF7UlR,4500,7/8/2019,10000,L5iF7UlR,41500,more than downpayment,more than downpayment,0,4500
L5iF7UlR,4500,8/30/2019,10000,L5iF7UlR,46000,more than downpayment,more than downpayment,0,4500
L5iF7UlR,3000,12/25/2019,10000,L5iF7UlR,49000,more than downpayment,more than downpayment,0,3000
L5iF7UlR,470,2/4/2020,10000,L5iF7UlR,49470,more than downpayment,more than downpayment,0,470
L5WXaEnx,9900,7/11/2019,9900,,9900,equal to downpayment,,9900,0
L5WXaEnx,3900,9/7/2019,9900,L5WXaEnx,13800,more than downpayment,equal to downpayment,0,3900
L5WXaEnx,3900,10/12/2019,9900,L5WXaEnx,17700,more than downpayment,more than downpayment,0,3900
L5WXaEnx,3900,10/29/2019,9900,L5WXaEnx,21600,more than downpayment,more than downpayment,0,3900
L5WXaEnx,3900,12/5/2019,9900,L5WXaEnx,25500,more than downpayment,more than downpayment,0,3900
L5WXaEnx,3900,1/4/2020,9900,L5WXaEnx,29400,more than downpayment,more than downpayment,0,3900
L5WXaEnx,3900,2/8/2020,9900,L5WXaEnx,33300,more than downpayment,more than downpayment,0,3900
L61ZM5K3,9900,10/22/2019,9900,,9900,equal to downpayment,,9900,0
L61ZM5K3,3900,11/11/2019,9900,L61ZM5K3,13800,more than downpayment,equal to downpayment,0,3900
L61ZM5K3,3900,12/10/2019,9900,L61ZM5K3,17700,more than downpayment,more than downpayment,0,3900
L61ZM5K3,3900,1/9/2020,9900,L61ZM5K3,21600,more than downpayment,more than downpayment,0,3900
L6oBQW3M,8900,3/1/2019,8900,,8900,equal to downpayment,,8900,0
L6oBQW3M,23400,3/27/2019,8900,L6oBQW3M,32300,more than downpayment,equal to downpayment,0,23400
L6oBQW3M,23400,4/29/2019,8900,L6oBQW3M,55700,more than downpayment,more than downpayment,0,23400
L6oBQW3M,23400,5/28/2019,8900,L6oBQW3M,79100,more than downpayment,more than downpayment,0,23400
L6oBQW3M,23400,6/28/2019,8900,L6oBQW3M,102500,more than downpayment,more than downpayment,0,23400
L6oBQW3M,3900,2/7/2020,8900,L6oBQW3M,106400,more than downpayment,more than downpayment,0,3900
L6WT5Q6C,8900,1/10/2020,8900,,8900,equal to downpayment,,8900,0
L7USHP5L,9900,7/30/2019,9900,,9900,equal to downpayment,,9900,0
L7USHP5L,3900,8/27/2019,9900,L7USHP5L,13800,more than downpayment,equal to downpayment,0,3900
L7USHP5L,3900,10/21/2019,9900,L7USHP5L,17700,more than downpayment,more than downpayment,0,3900
L7USHP5L,3900,12/15/2019,9900,L7USHP5L,21600,more than downpayment,more than downpayment,0,3900
L7USHP5L,3900,1/17/2020,9900,L7USHP5L,25500,more than downpayment,more than downpayment,0,3900
L8M6YE8A,9900,6/26/2019,9900,,9900,equal to downpayment,,9900,0
L8M6YE8A,3900,9/2/2019,9900,L8M6YE8A,13800,more than downpayment,equal to downpayment,0,3900
L8M6YE8A,3900,10/2/2019,9900,L8M6YE8A,17700,more than downpayment,more than downpayment,0,3900
L8M6YE8A,3900,11/2/2019,9900,L8M6YE8A,21600,more than downpayment,more than downpayment,0,3900
L8M6YE8A,3900,12/2/2019,9900,L8M6YE8A,25500,more than downpayment,more than downpayment,0,3900
L8M6YE8A,3900,1/2/2020,9900,L8M6YE8A,29400,more than downpayment,more than downpayment,0,3900
L8M6YE8A,3900,2/2/2020,9900,L8M6YE8A,33300,more than downpayment,more than downpayment,0,3900
L93IXW64,9900,11/14/2019,9900,,9900,equal to downpayment,,9900,0
L93IXW64,3900,1/25/2020,9900,L93IXW64,13800,more than downpayment,equal to downpayment,0,3900
L94K7OZN,1594,10/14/2019,1594,,1594,equal to downpayment,,1594,0
LA87I4Z5,9900,1/24/2020,9900,,9900,equal to downpayment,,9900,0
LARWUM2N,9900,12/27/2019,9900,,9900,equal to downpayment,,9900,0
lBA3gxAc,8900,7/16/2019,8900,,8900,equal to downpayment,,8900,0
LC4D2V2U,8900,11/11/2019,8900,,8900,equal to downpayment,,8900,0
LC4D2V2U,1000,11/12/2019,8900,LC4D2V2U,9900,more than downpayment,equal to downpayment,0,1000
LC4D2V2U,4000,12/26/2019,8900,LC4D2V2U,13900,more than downpayment,more than downpayment,0,4000
LC4D2V2U,4000,1/25/2020,8900,LC4D2V2U,17900,more than downpayment,more than downpayment,0,4000
LC9I5LH4,9900,12/12/2019,9900,,9900,equal to downpayment,,9900,0
Lcdx41wa,8900,4/15/2019,8900,,8900,equal to downpayment,,8900,0
Lcdx41wa,4000,5/7/2019,8900,Lcdx41wa,12900,more than downpayment,equal to downpayment,0,4000
Lcdx41wa,4000,5/24/2019,8900,Lcdx41wa,16900,more than downpayment,more than downpayment,0,4000
Lcdx41wa,4000,6/21/2019,8900,Lcdx41wa,20900,more than downpayment,more than downpayment,0,4000
Lcdx41wa,600,9/3/2019,8900,Lcdx41wa,21500,more than downpayment,more than downpayment,0,600
Lcdx41wa,1700,9/16/2019,8900,Lcdx41wa,23200,more than downpayment,more than downpayment,0,1700
Lcdx41wa,1300,10/4/2019,8900,Lcdx41wa,24500,more than downpayment,more than downpayment,0,1300
Lcdx41wa,500,10/7/2019,8900,Lcdx41wa,25000,more than downpayment,more than downpayment,0,500
Lcdx41wa,1000,10/11/2019,8900,Lcdx41wa,26000,more than downpayment,more than downpayment,0,1000
Lcdx41wa,2450,10/15/2019,8900,Lcdx41wa,28450,more than downpayment,more than downpayment,0,2450
Lcdx41wa,3900,10/29/2019,8900,Lcdx41wa,32350,more than downpayment,more than downpayment,0,3900
Lcdx41wa,3650,11/23/2019,8900,Lcdx41wa,36000,more than downpayment,more than downpayment,0,3650
Lcdx41wa,250,11/29/2019,8900,Lcdx41wa,36250,more than downpayment,more than downpayment,0,250
Lcdx41wa,970,1/10/2020,8900,Lcdx41wa,37220,more than downpayment,more than downpayment,0,970
Lcdx41wa,1000,1/14/2020,8900,Lcdx41wa,38220,more than downpayment,more than downpayment,0,1000
ldt3Ul0s,8900,2/5/2019,8900,,8900,equal to downpayment,,8900,0
ldt3Ul0s,3900,3/20/2019,8900,ldt3Ul0s,12800,more than downpayment,equal to downpayment,0,3900
ldt3Ul0s,3900,4/30/2019,8900,ldt3Ul0s,16700,more than downpayment,more than downpayment,0,3900
ldt3Ul0s,3900,5/29/2019,8900,ldt3Ul0s,20600,more than downpayment,more than downpayment,0,3900
ldt3Ul0s,2700,7/27/2019,8900,ldt3Ul0s,23300,more than downpayment,more than downpayment,0,2700
le2mO2Zq,8900,1/29/2019,8900,,8900,equal to downpayment,,8900,0
le2mO2Zq,4000,2/12/2019,8900,le2mO2Zq,12900,more than downpayment,equal to downpayment,0,4000
le2mO2Zq,3900,3/11/2019,8900,le2mO2Zq,16800,more than downpayment,more than downpayment,0,3900
le2mO2Zq,3900,4/18/2019,8900,le2mO2Zq,20700,more than downpayment,more than downpayment,0,3900
le2mO2Zq,3900,5/17/2019,8900,le2mO2Zq,24600,more than downpayment,more than downpayment,0,3900
le2mO2Zq,3900,7/5/2019,8900,le2mO2Zq,28500,more than downpayment,more than downpayment,0,3900
le2mO2Zq,3900,8/16/2019,8900,le2mO2Zq,32400,more than downpayment,more than downpayment,0,3900
le2mO2Zq,3800,10/12/2019,8900,le2mO2Zq,36200,more than downpayment,more than downpayment,0,3800
le2mO2Zq,3900,11/1/2019,8900,le2mO2Zq,40100,more than downpayment,more than downpayment,0,3900
le2mO2Zq,3900,11/29/2019,8900,le2mO2Zq,44000,more than downpayment,more than downpayment,0,3900
le2mO2Zq,3900,1/9/2020,8900,le2mO2Zq,47900,more than downpayment,more than downpayment,0,3900
LeRqLrPO,10000,7/16/2019,8900,,10000,more than downpayment,,8900,1100
LEsv9IgS,8900,1/11/2019,8900,,8900,equal to downpayment,,8900,0
LEsv9IgS,3900,2/13/2019,8900,LEsv9IgS,12800,more than downpayment,equal to downpayment,0,3900
LEsv9IgS,4000,3/13/2019,8900,LEsv9IgS,16800,more than downpayment,more than downpayment,0,4000
LEsv9IgS,3900,4/12/2019,8900,LEsv9IgS,20700,more than downpayment,more than downpayment,0,3900
LEsv9IgS,3900,5/14/2019,8900,LEsv9IgS,24600,more than downpayment,more than downpayment,0,3900
LEsv9IgS,3900,6/14/2019,8900,LEsv9IgS,28500,more than downpayment,more than downpayment,0,3900
LEsv9IgS,3000,7/16/2019,8900,LEsv9IgS,31500,more than downpayment,more than downpayment,0,3000
LEsv9IgS,900,7/29/2019,8900,LEsv9IgS,32400,more than downpayment,more than downpayment,0,900
LEsv9IgS,3900,8/15/2019,8900,LEsv9IgS,36300,more than downpayment,more than downpayment,0,3900
LEsv9IgS,3900,9/19/2019,8900,LEsv9IgS,40200,more than downpayment,more than downpayment,0,3900
LEsv9IgS,1000,10/15/2019,8900,LEsv9IgS,41200,more than downpayment,more than downpayment,0,1000
LEsv9IgS,1000,10/20/2019,8900,LEsv9IgS,42200,more than downpayment,more than downpayment,0,1000
LEsv9IgS,1000,11/7/2019,8900,LEsv9IgS,43200,more than downpayment,more than downpayment,0,1000
LEsv9IgS,1700,11/21/2019,8900,LEsv9IgS,44900,more than downpayment,more than downpayment,0,1700
LEsv9IgS,500,11/25/2019,8900,LEsv9IgS,45400,more than downpayment,more than downpayment,0,500
LEsv9IgS,1000,12/8/2019,8900,LEsv9IgS,46400,more than downpayment,more than downpayment,0,1000
LEsv9IgS,1500,12/12/2019,8900,LEsv9IgS,47900,more than downpayment,more than downpayment,0,1500
LEsv9IgS,1000,1/4/2020,8900,LEsv9IgS,48900,more than downpayment,more than downpayment,0,1000
LEsv9IgS,1500,1/9/2020,8900,LEsv9IgS,50400,more than downpayment,more than downpayment,0,1500
LEsv9IgS,1400,1/10/2020,8900,LEsv9IgS,51800,more than downpayment,more than downpayment,0,1400
LEsv9IgS,900,1/11/2020,8900,LEsv9IgS,52700,more than downpayment,more than downpayment,0,900
LEsv9IgS,500,1/16/2020,8900,LEsv9IgS,53200,more than downpayment,more than downpayment,0,500
LEsv9IgS,2500,1/21/2020,8900,LEsv9IgS,55700,more than downpayment,more than downpayment,0,2500
LEsv9IgS,2000,1/23/2020,8900,LEsv9IgS,57700,more than downpayment,more than downpayment,0,2000
lfG1gp8E,8900,4/10/2019,8900,,8900,equal to downpayment,,8900,0
lfG1gp8E,3900,5/24/2019,8900,lfG1gp8E,12800,more than downpayment,equal to downpayment,0,3900
lfG1gp8E,15600,6/19/2019,8900,lfG1gp8E,28400,more than downpayment,more than downpayment,0,15600
lfG1gp8E,19500,10/1/2019,8900,lfG1gp8E,47900,more than downpayment,more than downpayment,0,19500
LFWajhWX,11900,3/6/2019,9900,,11900,more than downpayment,,9900,2000
LFWajhWX,4500,5/3/2019,9900,LFWajhWX,16400,more than downpayment,more than downpayment,0,4500
LFWajhWX,4500,6/3/2019,9900,LFWajhWX,20900,more than downpayment,more than downpayment,0,4500
LFWajhWX,4500,7/3/2019,9900,LFWajhWX,25400,more than downpayment,more than downpayment,0,4500
LFWajhWX,4500,7/26/2019,9900,LFWajhWX,29900,more than downpayment,more than downpayment,0,4500
LFWajhWX,4500,8/31/2019,9900,LFWajhWX,34400,more than downpayment,more than downpayment,0,4500
LFWajhWX,4500,10/4/2019,9900,LFWajhWX,38900,more than downpayment,more than downpayment,0,4500
LFWajhWX,4500,10/30/2019,9900,LFWajhWX,43400,more than downpayment,more than downpayment,0,4500
LFWajhWX,4500,12/5/2019,9900,LFWajhWX,47900,more than downpayment,more than downpayment,0,4500
LFWajhWX,4500,1/6/2020,9900,LFWajhWX,52400,more than downpayment,more than downpayment,0,4500
LFWajhWX,4500,2/5/2020,9900,LFWajhWX,56900,more than downpayment,more than downpayment,0,4500
Lg8Binqg,8900,4/23/2019,8900,,8900,equal to downpayment,,8900,0
Lg8Binqg,3900,6/3/2019,8900,Lg8Binqg,12800,more than downpayment,equal to downpayment,0,3900
Lg8Binqg,3900,7/4/2019,8900,Lg8Binqg,16700,more than downpayment,more than downpayment,0,3900
Lg8Binqg,3900,8/2/2019,8900,Lg8Binqg,20600,more than downpayment,more than downpayment,0,3900
Lg8Binqg,3900,9/5/2019,8900,Lg8Binqg,24500,more than downpayment,more than downpayment,0,3900
Lg8Binqg,3900,10/5/2019,8900,Lg8Binqg,28400,more than downpayment,more than downpayment,0,3900
Lg8Binqg,3900,11/5/2019,8900,Lg8Binqg,32300,more than downpayment,more than downpayment,0,3900
Lg8Binqg,3900,12/6/2019,8900,Lg8Binqg,36200,more than downpayment,more than downpayment,0,3900
Lg8Binqg,3900,1/6/2020,8900,Lg8Binqg,40100,more than downpayment,more than downpayment,0,3900
Lg8Binqg,3900,2/5/2020,8900,Lg8Binqg,44000,more than downpayment,more than downpayment,0,3900
lGHbaTHd,10000,6/23/2017,10000,,10000,equal to downpayment,,10000,0
lGHbaTHd,4000,9/12/2017,10000,lGHbaTHd,14000,more than downpayment,equal to downpayment,0,4000
lGHbaTHd,4000,10/22/2017,10000,lGHbaTHd,18000,more than downpayment,more than downpayment,0,4000
lGHbaTHd,4000,11/17/2017,10000,lGHbaTHd,22000,more than downpayment,more than downpayment,0,4000
lGHbaTHd,4000,12/23/2017,10000,lGHbaTHd,26000,more than downpayment,more than downpayment,0,4000
lGHbaTHd,4000,1/17/2018,10000,lGHbaTHd,30000,more than downpayment,more than downpayment,0,4000
lGHbaTHd,4000,2/16/2018,10000,lGHbaTHd,34000,more than downpayment,more than downpayment,0,4000
lGHbaTHd,4000,3/13/2018,10000,lGHbaTHd,38000,more than downpayment,more than downpayment,0,4000
lGHbaTHd,4000,4/13/2018,10000,lGHbaTHd,42000,more than downpayment,more than downpayment,0,4000
lGHbaTHd,4000,5/17/2018,10000,lGHbaTHd,46000,more than downpayment,more than downpayment,0,4000
lGHbaTHd,4000,7/15/2018,10000,lGHbaTHd,50000,more than downpayment,more than downpayment,0,4000
lGHbaTHd,2000,8/12/2018,10000,lGHbaTHd,52000,more than downpayment,more than downpayment,0,2000
LGLBGFFH,9900,12/20/2019,9900,,9900,equal to downpayment,,9900,0
LGXDIW3X,9900,1/7/2020,9900,,9900,equal to downpayment,,9900,0
lhcGeVL7,9000,1/22/2019,8900,,9000,more than downpayment,,8900,100
lhcGeVL7,4000,2/20/2019,8900,lhcGeVL7,13000,more than downpayment,more than downpayment,0,4000
lhcGeVL7,4000,3/20/2019,8900,lhcGeVL7,17000,more than downpayment,more than downpayment,0,4000
lhcGeVL7,6900,5/8/2019,8900,lhcGeVL7,23900,more than downpayment,more than downpayment,0,6900
lhcGeVL7,1000,6/1/2019,8900,lhcGeVL7,24900,more than downpayment,more than downpayment,0,1000
lhcGeVL7,1450,7/5/2019,8900,lhcGeVL7,26350,more than downpayment,more than downpayment,0,1450
lhcGeVL7,1450,7/20/2019,8900,lhcGeVL7,27800,more than downpayment,more than downpayment,0,1450
lhcGeVL7,5000,8/5/2019,8900,lhcGeVL7,32800,more than downpayment,more than downpayment,0,5000
lhcGeVL7,4000,9/5/2019,8900,lhcGeVL7,36800,more than downpayment,more than downpayment,0,4000
lhcGeVL7,3850,10/15/2019,8900,lhcGeVL7,40650,more than downpayment,more than downpayment,0,3850
lhcGeVL7,4000,11/14/2019,8900,lhcGeVL7,44650,more than downpayment,more than downpayment,0,4000
lhcGeVL7,3900,1/7/2020,8900,lhcGeVL7,48550,more than downpayment,more than downpayment,0,3900
LHcqbXVQ,8900,1/31/2019,8900,,8900,equal to downpayment,,8900,0
LHcqbXVQ,3900,3/12/2019,8900,LHcqbXVQ,12800,more than downpayment,equal to downpayment,0,3900
LHcqbXVQ,3900,4/17/2019,8900,LHcqbXVQ,16700,more than downpayment,more than downpayment,0,3900
LHcqbXVQ,3900,5/2/2019,8900,LHcqbXVQ,20600,more than downpayment,more than downpayment,0,3900
LHcqbXVQ,3900,6/5/2019,8900,LHcqbXVQ,24500,more than downpayment,more than downpayment,0,3900
LHcqbXVQ,10000,10/1/2019,8900,LHcqbXVQ,34500,more than downpayment,more than downpayment,0,10000
LHcqbXVQ,5600,10/4/2019,8900,LHcqbXVQ,40100,more than downpayment,more than downpayment,0,5600
LHcqbXVQ,1500,11/13/2019,8900,LHcqbXVQ,41600,more than downpayment,more than downpayment,0,1500
LHcqbXVQ,2000,11/26/2019,8900,LHcqbXVQ,43600,more than downpayment,more than downpayment,0,2000
LHcqbXVQ,600,11/30/2019,8900,LHcqbXVQ,44200,more than downpayment,more than downpayment,0,600
LHcqbXVQ,3700,1/2/2020,8900,LHcqbXVQ,47900,more than downpayment,more than downpayment,0,3700
LHcqbXVQ,3900,1/13/2020,8900,LHcqbXVQ,51800,more than downpayment,more than downpayment,0,3900
LHcqbXVQ,3900,2/4/2020,8900,LHcqbXVQ,55700,more than downpayment,more than downpayment,0,3900
LHI4Q5W6,8900,10/8/2019,8900,,8900,equal to downpayment,,8900,0
LHI4Q5W6,3900,11/25/2019,8900,LHI4Q5W6,12800,more than downpayment,equal to downpayment,0,3900
LHI4Q5W6,3900,1/7/2020,8900,LHI4Q5W6,16700,more than downpayment,more than downpayment,0,3900
LIgcJ0MG,20000,7/9/2018,20000,,20000,equal to downpayment,,20000,0
LIgcJ0MG,12000,7/25/2018,20000,LIgcJ0MG,32000,more than downpayment,equal to downpayment,0,12000
LIgcJ0MG,20000,9/3/2018,20000,LIgcJ0MG,52000,more than downpayment,more than downpayment,0,20000
LIgcJ0MG,20000,9/26/2018,20000,LIgcJ0MG,72000,more than downpayment,more than downpayment,0,20000
LIgcJ0MG,4000,1/25/2019,20000,LIgcJ0MG,76000,more than downpayment,more than downpayment,0,4000
LIgcJ0MG,11183,4/12/2019,20000,LIgcJ0MG,87183,more than downpayment,more than downpayment,0,11183
LIgcJ0MG,12016,6/24/2019,20000,LIgcJ0MG,99199,more than downpayment,more than downpayment,0,12016
LIgcJ0MG,12016,7/24/2019,20000,LIgcJ0MG,111215,more than downpayment,more than downpayment,0,12016
LIgcJ0MG,10000,12/18/2019,20000,LIgcJ0MG,121215,more than downpayment,more than downpayment,0,10000
LIgcJ0MG,12000,1/27/2020,20000,LIgcJ0MG,133215,more than downpayment,more than downpayment,0,12000
LINFODZ1,9900,10/9/2019,9900,,9900,equal to downpayment,,9900,0
LINFODZ1,3900,12/14/2019,9900,LINFODZ1,13800,more than downpayment,equal to downpayment,0,3900
LINFODZ1,3900,1/1/2020,9900,LINFODZ1,17700,more than downpayment,more than downpayment,0,3900
LINFODZ1,3900,1/30/2020,9900,LINFODZ1,21600,more than downpayment,more than downpayment,0,3900
LIOQ6F69,9900,1/14/2020,9900,,9900,equal to downpayment,,9900,0
lJ3PQJ4m,24300,12/20/2018,9900,,24300,more than downpayment,,9900,14400
lJ3PQJ4m,10000,2/16/2019,9900,lJ3PQJ4m,34300,more than downpayment,more than downpayment,0,10000
lJ3PQJ4m,4500,5/25/2019,9900,lJ3PQJ4m,38800,more than downpayment,more than downpayment,0,4500
lJ3PQJ4m,4500,7/2/2019,9900,lJ3PQJ4m,43300,more than downpayment,more than downpayment,0,4500
lJ3PQJ4m,5000,8/15/2019,9900,lJ3PQJ4m,48300,more than downpayment,more than downpayment,0,5000
lJ3PQJ4m,4500,8/27/2019,9900,lJ3PQJ4m,52800,more than downpayment,more than downpayment,0,4500
lJ3PQJ4m,4500,9/25/2019,9900,lJ3PQJ4m,57300,more than downpayment,more than downpayment,0,4500
lJ3PQJ4m,4500,10/26/2019,9900,lJ3PQJ4m,61800,more than downpayment,more than downpayment,0,4500
lJ3PQJ4m,8600,12/18/2019,9900,lJ3PQJ4m,70400,more than downpayment,more than downpayment,0,8600
lJ3PQJ4m,7000,12/19/2019,9900,lJ3PQJ4m,77400,more than downpayment,more than downpayment,0,7000
LJH4NBF1,9900,10/2/2019,9900,,9900,equal to downpayment,,9900,0
LJH4NBF1,3900,11/28/2019,9900,LJH4NBF1,13800,more than downpayment,equal to downpayment,0,3900
LJH4NBF1,3900,12/27/2019,9900,LJH4NBF1,17700,more than downpayment,more than downpayment,0,3900
LJH4NBF1,107800,1/18/2020,9900,LJH4NBF1,125500,more than downpayment,more than downpayment,0,107800
LKxZYokB,10000,12/17/2017,10000,,10000,equal to downpayment,,10000,0
LKxZYokB,4500,8/25/2018,10000,LKxZYokB,14500,more than downpayment,equal to downpayment,0,4500
LKxZYokB,4400,12/6/2018,10000,LKxZYokB,18900,more than downpayment,more than downpayment,0,4400
LKxZYokB,4500,2/18/2019,10000,LKxZYokB,23400,more than downpayment,more than downpayment,0,4500
LKxZYokB,4000,4/2/2019,10000,LKxZYokB,27400,more than downpayment,more than downpayment,0,4000
LKxZYokB,2500,7/7/2019,10000,LKxZYokB,29900,more than downpayment,more than downpayment,0,2500
LKxZYokB,2500,8/6/2019,10000,LKxZYokB,32400,more than downpayment,more than downpayment,0,2500
LKxZYokB,3200,9/4/2019,10000,LKxZYokB,35600,more than downpayment,more than downpayment,0,3200
LKxZYokB,3000,10/14/2019,10000,LKxZYokB,38600,more than downpayment,more than downpayment,0,3000
lLoaK2Ga,10000,2/6/2019,10000,,10000,equal to downpayment,,10000,0
lLoaK2Ga,4500,3/22/2019,10000,lLoaK2Ga,14500,more than downpayment,equal to downpayment,0,4500
lLoaK2Ga,4500,4/29/2019,10000,lLoaK2Ga,19000,more than downpayment,more than downpayment,0,4500
lLoaK2Ga,4500,5/23/2019,10000,lLoaK2Ga,23500,more than downpayment,more than downpayment,0,4500
lLoaK2Ga,4500,6/21/2019,10000,lLoaK2Ga,28000,more than downpayment,more than downpayment,0,4500
lLoaK2Ga,4500,7/23/2019,10000,lLoaK2Ga,32500,more than downpayment,more than downpayment,0,4500
lLoaK2Ga,4500,8/20/2019,10000,lLoaK2Ga,37000,more than downpayment,more than downpayment,0,4500
lLoaK2Ga,4500,9/21/2019,10000,lLoaK2Ga,41500,more than downpayment,more than downpayment,0,4500
lLoaK2Ga,4500,10/24/2019,10000,lLoaK2Ga,46000,more than downpayment,more than downpayment,0,4500
lLoaK2Ga,4500,11/25/2019,10000,lLoaK2Ga,50500,more than downpayment,more than downpayment,0,4500
lLoaK2Ga,4500,12/26/2019,10000,lLoaK2Ga,55000,more than downpayment,more than downpayment,0,4500
lLoaK2Ga,4500,1/22/2020,10000,lLoaK2Ga,59500,more than downpayment,more than downpayment,0,4500
LLxmRlGf,8900,1/10/2019,8900,,8900,equal to downpayment,,8900,0
LLxmRlGf,3900,4/6/2019,8900,LLxmRlGf,12800,more than downpayment,equal to downpayment,0,3900
LLxmRlGf,3900,5/10/2019,8900,LLxmRlGf,16700,more than downpayment,more than downpayment,0,3900
LLxmRlGf,3900,6/8/2019,8900,LLxmRlGf,20600,more than downpayment,more than downpayment,0,3900
LLxmRlGf,3900,7/5/2019,8900,LLxmRlGf,24500,more than downpayment,more than downpayment,0,3900
LLxmRlGf,3900,8/16/2019,8900,LLxmRlGf,28400,more than downpayment,more than downpayment,0,3900
LLxmRlGf,3900,10/8/2019,8900,LLxmRlGf,32300,more than downpayment,more than downpayment,0,3900
LLxmRlGf,7800,11/6/2019,8900,LLxmRlGf,40100,more than downpayment,more than downpayment,0,7800
LLxmRlGf,3900,12/9/2019,8900,LLxmRlGf,44000,more than downpayment,more than downpayment,0,3900
LLxmRlGf,7800,2/8/2020,8900,LLxmRlGf,51800,more than downpayment,more than downpayment,0,7800
LlZZQRWZ,8900,11/12/2018,0,,8900,more than downpayment,,0,8900
LlZZQRWZ,3900,1/3/2019,0,LlZZQRWZ,12800,more than downpayment,more than downpayment,0,3900
LM39riaL,4500,3/14/2018,10000,,4500,less than downpayment,,4500,0
LM39riaL,9000,4/13/2018,10000,LM39riaL,13500,more than downpayment,less than downpayment,5500,3500
LM39riaL,4500,5/15/2018,10000,LM39riaL,18000,more than downpayment,more than downpayment,0,4500
LM39riaL,4500,6/19/2018,10000,LM39riaL,22500,more than downpayment,more than downpayment,0,4500
LM39riaL,4500,7/18/2018,10000,LM39riaL,27000,more than downpayment,more than downpayment,0,4500
LM39riaL,4500,8/16/2018,10000,LM39riaL,31500,more than downpayment,more than downpayment,0,4500
LM39riaL,10000,8/20/2018,10000,LM39riaL,41500,more than downpayment,more than downpayment,0,10000
LM39riaL,4500,9/18/2018,10000,LM39riaL,46000,more than downpayment,more than downpayment,0,4500
LM39riaL,4500,10/16/2018,10000,LM39riaL,50500,more than downpayment,more than downpayment,0,4500
LM39riaL,4500,11/19/2018,10000,LM39riaL,55000,more than downpayment,more than downpayment,0,4500
LM39riaL,5000,12/14/2018,10000,LM39riaL,60000,more than downpayment,more than downpayment,0,5000
LM39riaL,4500,1/17/2019,10000,LM39riaL,64500,more than downpayment,more than downpayment,0,4500
LM39riaL,4000,2/18/2019,10000,LM39riaL,68500,more than downpayment,more than downpayment,0,4000
lmHGIQZS,10000,6/9/2017,10000,,10000,equal to downpayment,,10000,0
lmHGIQZS,5000,6/29/2017,10000,lmHGIQZS,15000,more than downpayment,equal to downpayment,0,5000
lmHGIQZS,5000,7/19/2017,10000,lmHGIQZS,20000,more than downpayment,more than downpayment,0,5000
lmHGIQZS,15000,9/18/2017,10000,lmHGIQZS,35000,more than downpayment,more than downpayment,0,15000
lmHGIQZS,20000,10/1/2017,10000,lmHGIQZS,55000,more than downpayment,more than downpayment,0,20000
LnYNyU6q,10000,7/16/2017,10000,,10000,equal to downpayment,,10000,0
LnYNyU6q,13000,10/2/2017,10000,LnYNyU6q,23000,more than downpayment,equal to downpayment,0,13000
LnYNyU6q,3500,11/16/2017,10000,LnYNyU6q,26500,more than downpayment,more than downpayment,0,3500
LnYNyU6q,3500,12/13/2017,10000,LnYNyU6q,30000,more than downpayment,more than downpayment,0,3500
LnYNyU6q,3500,1/15/2018,10000,LnYNyU6q,33500,more than downpayment,more than downpayment,0,3500
LnYNyU6q,3500,2/15/2018,10000,LnYNyU6q,37000,more than downpayment,more than downpayment,0,3500
LnYNyU6q,3500,3/16/2018,10000,LnYNyU6q,40500,more than downpayment,more than downpayment,0,3500
LnYNyU6q,3500,4/20/2018,10000,LnYNyU6q,44000,more than downpayment,more than downpayment,0,3500
LnYNyU6q,3500,5/17/2018,10000,LnYNyU6q,47500,more than downpayment,more than downpayment,0,3500
LnYNyU6q,3500,6/19/2018,10000,LnYNyU6q,51000,more than downpayment,more than downpayment,0,3500
LnYNyU6q,1000,7/11/2018,10000,LnYNyU6q,52000,more than downpayment,more than downpayment,0,1000
LO8Q5QHX,9900,6/17/2019,9900,,9900,equal to downpayment,,9900,0
LO8Q5QHX,100,12/5/2019,9900,LO8Q5QHX,10000,more than downpayment,equal to downpayment,0,100
LO8Q5QHX,100,12/7/2019,9900,LO8Q5QHX,10100,more than downpayment,more than downpayment,0,100
LO8Q5QHX,100,12/8/2019,9900,LO8Q5QHX,10200,more than downpayment,more than downpayment,0,100
LO8Q5QHX,150,12/14/2019,9900,LO8Q5QHX,10350,more than downpayment,more than downpayment,0,150
LO8Q5QHX,500,12/28/2019,9900,LO8Q5QHX,10850,more than downpayment,more than downpayment,0,500
LO8Q5QHX,900,1/15/2020,9900,LO8Q5QHX,11750,more than downpayment,more than downpayment,0,900
LO8Q5QHX,150,1/26/2020,9900,LO8Q5QHX,11900,more than downpayment,more than downpayment,0,150
LO8Q5QHX,290,1/27/2020,9900,LO8Q5QHX,12190,more than downpayment,more than downpayment,0,290
LO8Q5QHX,3901,2/8/2020,9900,LO8Q5QHX,16091,more than downpayment,more than downpayment,0,3901
LO8Q5QHX,1,2/9/2020,9900,LO8Q5QHX,16092,more than downpayment,more than downpayment,0,1
LOc0eMzv,8900,3/28/2019,8900,,8900,equal to downpayment,,8900,0
LOc0eMzv,3900,5/6/2019,8900,LOc0eMzv,12800,more than downpayment,equal to downpayment,0,3900
LOc0eMzv,3900,6/4/2019,8900,LOc0eMzv,16700,more than downpayment,more than downpayment,0,3900
LOc0eMzv,3900,7/5/2019,8900,LOc0eMzv,20600,more than downpayment,more than downpayment,0,3900
LOc0eMzv,3900,8/5/2019,8900,LOc0eMzv,24500,more than downpayment,more than downpayment,0,3900
LOc0eMzv,3900,9/13/2019,8900,LOc0eMzv,28400,more than downpayment,more than downpayment,0,3900
LOc0eMzv,3900,10/7/2019,8900,LOc0eMzv,32300,more than downpayment,more than downpayment,0,3900
LOc0eMzv,3900,11/20/2019,8900,LOc0eMzv,36200,more than downpayment,more than downpayment,0,3900
LOc0eMzv,3900,12/18/2019,8900,LOc0eMzv,40100,more than downpayment,more than downpayment,0,3900
LOc0eMzv,3900,1/14/2020,8900,LOc0eMzv,44000,more than downpayment,more than downpayment,0,3900
LojqseGy,10000,2/18/2019,10000,,10000,equal to downpayment,,10000,0
LojqseGy,40000,3/3/2019,10000,LojqseGy,50000,more than downpayment,equal to downpayment,0,40000
LojqseGy,2000,3/4/2019,10000,LojqseGy,52000,more than downpayment,more than downpayment,0,2000
LOJTOOS7,9900,12/20/2019,8900,,9900,more than downpayment,,8900,1000
lpTKigCZ,8900,8/26/2019,8900,,8900,equal to downpayment,,8900,0
lpTKigCZ,3900,10/17/2019,8900,lpTKigCZ,12800,more than downpayment,equal to downpayment,0,3900
lpTKigCZ,3900,11/18/2019,8900,lpTKigCZ,16700,more than downpayment,more than downpayment,0,3900
lpTKigCZ,3900,12/16/2019,8900,lpTKigCZ,20600,more than downpayment,more than downpayment,0,3900
lpTKigCZ,3900,1/14/2020,8900,lpTKigCZ,24500,more than downpayment,more than downpayment,0,3900
LPV3NFVY,25000,9/20/2019,8900,,25000,more than downpayment,,8900,16100
LPV3NFVY,1250,9/30/2019,8900,LPV3NFVY,26250,more than downpayment,more than downpayment,0,1250
LPV3NFVY,8000,11/22/2019,8900,LPV3NFVY,34250,more than downpayment,more than downpayment,0,8000
LPV3NFVY,17000,11/23/2019,8900,LPV3NFVY,51250,more than downpayment,more than downpayment,0,17000
LPV3NFVY,1500,11/25/2019,8900,LPV3NFVY,52750,more than downpayment,more than downpayment,0,1500
LPV3NFVY,18000,12/21/2019,8900,LPV3NFVY,70750,more than downpayment,more than downpayment,0,18000
LPV3NFVY,7500,12/25/2019,8900,LPV3NFVY,78250,more than downpayment,more than downpayment,0,7500
LPV3NFVY,1000,12/29/2019,8900,LPV3NFVY,79250,more than downpayment,more than downpayment,0,1000
LPV3NFVY,10000,1/21/2020,8900,LPV3NFVY,89250,more than downpayment,more than downpayment,0,10000
LPV3NFVY,16500,1/24/2020,8900,LPV3NFVY,105750,more than downpayment,more than downpayment,0,16500
LPYB2DOI,9900,10/17/2019,9900,,9900,equal to downpayment,,9900,0
LPYB2DOI,900,12/5/2019,9900,LPYB2DOI,10800,more than downpayment,equal to downpayment,0,900
LPYB2DOI,400,12/8/2019,9900,LPYB2DOI,11200,more than downpayment,more than downpayment,0,400
LPYB2DOI,900,12/10/2019,9900,LPYB2DOI,12100,more than downpayment,more than downpayment,0,900
LPYB2DOI,1000,12/14/2019,9900,LPYB2DOI,13100,more than downpayment,more than downpayment,0,1000
LPYB2DOI,900,12/16/2019,9900,LPYB2DOI,14000,more than downpayment,more than downpayment,0,900
LPYB2DOI,400,12/20/2019,9900,LPYB2DOI,14400,more than downpayment,more than downpayment,0,400
LPYB2DOI,1500,1/10/2020,9900,LPYB2DOI,15900,more than downpayment,more than downpayment,0,1500
LPYB2DOI,2300,2/3/2020,9900,LPYB2DOI,18200,more than downpayment,more than downpayment,0,2300
LQ7BCHUU,9900,7/6/2019,9900,,9900,equal to downpayment,,9900,0
LQ7BCHUU,3900,7/30/2019,9900,LQ7BCHUU,13800,more than downpayment,equal to downpayment,0,3900
LQ7BCHUU,3900,10/2/2019,9900,LQ7BCHUU,17700,more than downpayment,more than downpayment,0,3900
LQ7BCHUU,9000,11/29/2019,9900,LQ7BCHUU,26700,more than downpayment,more than downpayment,0,9000
LQ7BCHUU,2400,1/20/2020,9900,LQ7BCHUU,29100,more than downpayment,more than downpayment,0,2400
LQ7BCHUU,500,1/28/2020,9900,LQ7BCHUU,29600,more than downpayment,more than downpayment,0,500
LQBN7SWE,12000,9/19/2019,1999,,12000,more than downpayment,,1999,10001
LQBN7SWE,2800,11/5/2019,1999,LQBN7SWE,14800,more than downpayment,more than downpayment,0,2800
LQBN7SWE,3900,12/10/2019,1999,LQBN7SWE,18700,more than downpayment,more than downpayment,0,3900
LQBN7SWE,1900,1/14/2020,1999,LQBN7SWE,20600,more than downpayment,more than downpayment,0,1900
lQfT5A40,9000,4/24/2019,8900,,9000,more than downpayment,,8900,100
lqL6XN3a,9900,8/2/2019,9900,,9900,equal to downpayment,,9900,0
lqrjO05F,10000,3/25/2019,10000,,10000,equal to downpayment,,10000,0
lqrjO05F,4500,4/26/2019,10000,lqrjO05F,14500,more than downpayment,equal to downpayment,0,4500
lqrjO05F,4500,5/27/2019,10000,lqrjO05F,19000,more than downpayment,more than downpayment,0,4500
lqrjO05F,4500,7/11/2019,10000,lqrjO05F,23500,more than downpayment,more than downpayment,0,4500
lqrjO05F,4500,8/7/2019,10000,lqrjO05F,28000,more than downpayment,more than downpayment,0,4500
lqrjO05F,4500,9/3/2019,10000,lqrjO05F,32500,more than downpayment,more than downpayment,0,4500
lqrjO05F,4500,10/14/2019,10000,lqrjO05F,37000,more than downpayment,more than downpayment,0,4500
lqrjO05F,4500,11/7/2019,10000,lqrjO05F,41500,more than downpayment,more than downpayment,0,4500
lqrjO05F,4500,12/7/2019,10000,lqrjO05F,46000,more than downpayment,more than downpayment,0,4500
lqrjO05F,4500,1/7/2020,10000,lqrjO05F,50500,more than downpayment,more than downpayment,0,4500
lqrjO05F,4500,2/6/2020,10000,lqrjO05F,55000,more than downpayment,more than downpayment,0,4500
LrfEiKSb,8900,7/31/2019,8900,,8900,equal to downpayment,,8900,0
LrfEiKSb,3900,9/21/2019,8900,LrfEiKSb,12800,more than downpayment,equal to downpayment,0,3900
LSE8uf1Z,800,1/19/2018,0,,800,more than downpayment,,0,800
LSE8uf1Z,800,3/19/2018,0,LSE8uf1Z,1600,more than downpayment,more than downpayment,0,800
LSE8uf1Z,1000,4/30/2018,0,LSE8uf1Z,2600,more than downpayment,more than downpayment,0,1000
LSE8uf1Z,1000,5/28/2018,0,LSE8uf1Z,3600,more than downpayment,more than downpayment,0,1000
LSE8uf1Z,1000,6/29/2018,0,LSE8uf1Z,4600,more than downpayment,more than downpayment,0,1000
LSE8uf1Z,1000,7/30/2018,0,LSE8uf1Z,5600,more than downpayment,more than downpayment,0,1000
LSE8uf1Z,1000,8/28/2018,0,LSE8uf1Z,6600,more than downpayment,more than downpayment,0,1000
LSE8uf1Z,1000,9/29/2018,0,LSE8uf1Z,7600,more than downpayment,more than downpayment,0,1000
LSE8uf1Z,1000,10/29/2018,0,LSE8uf1Z,8600,more than downpayment,more than downpayment,0,1000
LSE8uf1Z,1000,11/27/2018,0,LSE8uf1Z,9600,more than downpayment,more than downpayment,0,1000
LSE8uf1Z,1000,1/7/2019,0,LSE8uf1Z,10600,more than downpayment,more than downpayment,0,1000
LSE8uf1Z,1000,1/30/2019,0,LSE8uf1Z,11600,more than downpayment,more than downpayment,0,1000
LSE8uf1Z,1400,2/28/2019,0,LSE8uf1Z,13000,more than downpayment,more than downpayment,0,1400
LSE8uf1Z,1000,3/27/2019,0,LSE8uf1Z,14000,more than downpayment,more than downpayment,0,1000
LSE8uf1Z,1000,4/30/2019,0,LSE8uf1Z,15000,more than downpayment,more than downpayment,0,1000
LSE8uf1Z,1000,5/31/2019,0,LSE8uf1Z,16000,more than downpayment,more than downpayment,0,1000
LSE8uf1Z,4004,11/9/2019,0,LSE8uf1Z,20004,more than downpayment,more than downpayment,0,4004
LsHiO1fa,9900,7/12/2019,9900,,9900,equal to downpayment,,9900,0
LsHiO1fa,4000,8/6/2019,9900,LsHiO1fa,13900,more than downpayment,equal to downpayment,0,4000
LsHiO1fa,4000,8/31/2019,9900,LsHiO1fa,17900,more than downpayment,more than downpayment,0,4000
LsHiO1fa,3900,10/3/2019,9900,LsHiO1fa,21800,more than downpayment,more than downpayment,0,3900
LsHiO1fa,3900,11/7/2019,9900,LsHiO1fa,25700,more than downpayment,more than downpayment,0,3900
LsHiO1fa,3900,12/30/2019,9900,LsHiO1fa,29600,more than downpayment,more than downpayment,0,3900
LsHiO1fa,3900,2/3/2020,9900,LsHiO1fa,33500,more than downpayment,more than downpayment,0,3900
LSJD13TK,8900,1/28/2020,8900,,8900,equal to downpayment,,8900,0
LSPULYI4,5000,12/30/2019,7900,,5000,less than downpayment,,5000,0
LSU5UyRV,9000,4/23/2019,8900,,9000,more than downpayment,,8900,100
LSU5UyRV,8000,5/5/2019,8900,LSU5UyRV,17000,more than downpayment,more than downpayment,0,8000
LSU5UyRV,8000,5/24/2019,8900,LSU5UyRV,25000,more than downpayment,more than downpayment,0,8000
LSU5UyRV,8000,7/5/2019,8900,LSU5UyRV,33000,more than downpayment,more than downpayment,0,8000
LSU5UyRV,8000,8/3/2019,8900,LSU5UyRV,41000,more than downpayment,more than downpayment,0,8000
LSU5UyRV,8000,9/9/2019,8900,LSU5UyRV,49000,more than downpayment,more than downpayment,0,8000
LSU5UyRV,4000,10/2/2019,8900,LSU5UyRV,53000,more than downpayment,more than downpayment,0,4000
LSU5UyRV,4000,11/5/2019,8900,LSU5UyRV,57000,more than downpayment,more than downpayment,0,4000
LSU5UyRV,8000,12/4/2019,8900,LSU5UyRV,65000,more than downpayment,more than downpayment,0,8000
LSU5UyRV,8000,1/6/2020,8900,LSU5UyRV,73000,more than downpayment,more than downpayment,0,8000
LSU5UyRV,4000,2/6/2020,8900,LSU5UyRV,77000,more than downpayment,more than downpayment,0,4000
LSW4L35U,10000,1/30/2020,8900,,10000,more than downpayment,,8900,1100
LtiAx6Fm,10000,11/27/2017,10000,,10000,equal to downpayment,,10000,0
LtiAx6Fm,20000,8/20/2018,10000,LtiAx6Fm,30000,more than downpayment,equal to downpayment,0,20000
LtiAx6Fm,20000,8/28/2018,10000,LtiAx6Fm,50000,more than downpayment,more than downpayment,0,20000
LtiAx6Fm,14000,11/21/2018,10000,LtiAx6Fm,64000,more than downpayment,more than downpayment,0,14000
LtiAx6Fm,2000,10/22/2019,10000,LtiAx6Fm,66000,more than downpayment,more than downpayment,0,2000
LUIGGLTI,9900,11/20/2019,9900,,9900,equal to downpayment,,9900,0
LUIGGLTI,2900,1/13/2020,9900,LUIGGLTI,12800,more than downpayment,equal to downpayment,0,2900
LUIGGLTI,1000,1/15/2020,9900,LUIGGLTI,13800,more than downpayment,more than downpayment,0,1000
LUIGGLTI,1900,1/17/2020,9900,LUIGGLTI,15700,more than downpayment,more than downpayment,0,1900
LUIGGLTI,900,1/19/2020,9900,LUIGGLTI,16600,more than downpayment,more than downpayment,0,900
LUIGGLTI,1100,1/23/2020,9900,LUIGGLTI,17700,more than downpayment,more than downpayment,0,1100
LUIGGLTI,900,1/29/2020,9900,LUIGGLTI,18600,more than downpayment,more than downpayment,0,900
LUIGGLTI,1000,2/1/2020,9900,LUIGGLTI,19600,more than downpayment,more than downpayment,0,1000
luOTiQfe,8900,1/20/2019,8900,,8900,equal to downpayment,,8900,0
luOTiQfe,3900,3/5/2019,8900,luOTiQfe,12800,more than downpayment,equal to downpayment,0,3900
luOTiQfe,3900,4/8/2019,8900,luOTiQfe,16700,more than downpayment,more than downpayment,0,3900
luOTiQfe,3900,5/9/2019,8900,luOTiQfe,20600,more than downpayment,more than downpayment,0,3900
luOTiQfe,3900,6/11/2019,8900,luOTiQfe,24500,more than downpayment,more than downpayment,0,3900
luOTiQfe,3900,7/12/2019,8900,luOTiQfe,28400,more than downpayment,more than downpayment,0,3900
luOTiQfe,3900,9/2/2019,8900,luOTiQfe,32300,more than downpayment,more than downpayment,0,3900
luOTiQfe,3900,9/24/2019,8900,luOTiQfe,36200,more than downpayment,more than downpayment,0,3900
luOTiQfe,3900,11/8/2019,8900,luOTiQfe,40100,more than downpayment,more than downpayment,0,3900
LUYCSBNT,12800,8/28/2019,9900,,12800,more than downpayment,,9900,2900
LUYCSBNT,4000,11/4/2019,9900,LUYCSBNT,16800,more than downpayment,more than downpayment,0,4000
LUYCSBNT,3900,12/4/2019,9900,LUYCSBNT,20700,more than downpayment,more than downpayment,0,3900
LUYCSBNT,3900,1/5/2020,9900,LUYCSBNT,24600,more than downpayment,more than downpayment,0,3900
LVDXIHTX,8900,1/17/2020,8900,,8900,equal to downpayment,,8900,0
lw6jAbzB,8900,1/24/2019,8900,,8900,equal to downpayment,,8900,0
lw6jAbzB,3900,3/1/2019,8900,lw6jAbzB,12800,more than downpayment,equal to downpayment,0,3900
lw6jAbzB,3900,4/29/2019,8900,lw6jAbzB,16700,more than downpayment,more than downpayment,0,3900
lw6jAbzB,3900,5/30/2019,8900,lw6jAbzB,20600,more than downpayment,more than downpayment,0,3900
lw6jAbzB,3900,7/3/2019,8900,lw6jAbzB,24500,more than downpayment,more than downpayment,0,3900
lw6jAbzB,3900,8/1/2019,8900,lw6jAbzB,28400,more than downpayment,more than downpayment,0,3900
lw6jAbzB,3940,9/3/2019,8900,lw6jAbzB,32340,more than downpayment,more than downpayment,0,3940
lw6jAbzB,3860,10/8/2019,8900,lw6jAbzB,36200,more than downpayment,more than downpayment,0,3860
lw6jAbzB,3900,11/18/2019,8900,lw6jAbzB,40100,more than downpayment,more than downpayment,0,3900
lw6jAbzB,7800,1/27/2020,8900,lw6jAbzB,47900,more than downpayment,more than downpayment,0,7800
LW7E56GN,9900,10/27/2019,9900,,9900,equal to downpayment,,9900,0
LW7E56GN,4000,12/20/2019,9900,LW7E56GN,13900,more than downpayment,equal to downpayment,0,4000
lWBUyVOv,9900,7/23/2019,9900,,9900,equal to downpayment,,9900,0
lWBUyVOv,3900,10/4/2019,9900,lWBUyVOv,13800,more than downpayment,equal to downpayment,0,3900
lWBUyVOv,3900,11/6/2019,9900,lWBUyVOv,17700,more than downpayment,more than downpayment,0,3900
lWBUyVOv,3900,12/4/2019,9900,lWBUyVOv,21600,more than downpayment,more than downpayment,0,3900
lWBUyVOv,3900,12/26/2019,9900,lWBUyVOv,25500,more than downpayment,more than downpayment,0,3900
lWBUyVOv,3900,1/30/2020,9900,lWBUyVOv,29400,more than downpayment,more than downpayment,0,3900
LWL8PB5Q,9900,11/11/2019,9900,,9900,equal to downpayment,,9900,0
LWL8PB5Q,4000,12/6/2019,9900,LWL8PB5Q,13900,more than downpayment,equal to downpayment,0,4000
LWL8PB5Q,4000,1/4/2020,9900,LWL8PB5Q,17900,more than downpayment,more than downpayment,0,4000
LWL8PB5Q,3900,2/4/2020,9900,LWL8PB5Q,21800,more than downpayment,more than downpayment,0,3900
LWxNYn2x,9900,11/2/2018,9900,,9900,equal to downpayment,,9900,0
LWxNYn2x,4500,12/21/2018,9900,LWxNYn2x,14400,more than downpayment,equal to downpayment,0,4500
LWxNYn2x,4500,1/24/2019,9900,LWxNYn2x,18900,more than downpayment,more than downpayment,0,4500
LWxNYn2x,4500,2/25/2019,9900,LWxNYn2x,23400,more than downpayment,more than downpayment,0,4500
LWxNYn2x,6000,4/29/2019,9900,LWxNYn2x,29400,more than downpayment,more than downpayment,0,6000
LWxNYn2x,5000,5/26/2019,9900,LWxNYn2x,34400,more than downpayment,more than downpayment,0,5000
LWxNYn2x,7000,7/18/2019,9900,LWxNYn2x,41400,more than downpayment,more than downpayment,0,7000
LWxNYn2x,9000,9/18/2019,9900,LWxNYn2x,50400,more than downpayment,more than downpayment,0,9000
LWxNYn2x,4500,11/11/2019,9900,LWxNYn2x,54900,more than downpayment,more than downpayment,0,4500
LWxNYn2x,2000,12/20/2019,9900,LWxNYn2x,56900,more than downpayment,more than downpayment,0,2000
LWxNYn2x,2500,1/12/2020,9900,LWxNYn2x,59400,more than downpayment,more than downpayment,0,2500
LWxNYn2x,4500,2/3/2020,9900,LWxNYn2x,63900,more than downpayment,more than downpayment,0,4500
LXII36ZU,9900,6/27/2019,9900,,9900,equal to downpayment,,9900,0
LXII36ZU,3900,9/2/2019,9900,LXII36ZU,13800,more than downpayment,equal to downpayment,0,3900
LXII36ZU,3900,10/2/2019,9900,LXII36ZU,17700,more than downpayment,more than downpayment,0,3900
LXII36ZU,3900,11/4/2019,9900,LXII36ZU,21600,more than downpayment,more than downpayment,0,3900
LXII36ZU,3900,12/4/2019,9900,LXII36ZU,25500,more than downpayment,more than downpayment,0,3900
LXII36ZU,3900,12/30/2019,9900,LXII36ZU,29400,more than downpayment,more than downpayment,0,3900
LXII36ZU,3900,2/5/2020,9900,LXII36ZU,33300,more than downpayment,more than downpayment,0,3900
LY7dRbiS,9900,8/20/2019,9900,,9900,equal to downpayment,,9900,0
LY7dRbiS,3900,9/25/2019,9900,LY7dRbiS,13800,more than downpayment,equal to downpayment,0,3900
LY7dRbiS,3900,10/30/2019,9900,LY7dRbiS,17700,more than downpayment,more than downpayment,0,3900
LY7dRbiS,3900,12/3/2019,9900,LY7dRbiS,21600,more than downpayment,more than downpayment,0,3900
LY7dRbiS,3900,12/26/2019,9900,LY7dRbiS,25500,more than downpayment,more than downpayment,0,3900
LY7dRbiS,3900,1/27/2020,9900,LY7dRbiS,29400,more than downpayment,more than downpayment,0,3900
lyQbkBj3,9900,11/7/2018,9900,,9900,equal to downpayment,,9900,0
lyQbkBj3,4500,12/28/2018,9900,lyQbkBj3,14400,more than downpayment,equal to downpayment,0,4500
lyQbkBj3,4500,1/25/2019,9900,lyQbkBj3,18900,more than downpayment,more than downpayment,0,4500
lyQbkBj3,4500,2/25/2019,9900,lyQbkBj3,23400,more than downpayment,more than downpayment,0,4500
lyQbkBj3,4500,3/19/2019,9900,lyQbkBj3,27900,more than downpayment,more than downpayment,0,4500
lyQbkBj3,4500,4/30/2019,9900,lyQbkBj3,32400,more than downpayment,more than downpayment,0,4500
lyQbkBj3,9000,5/29/2019,9900,lyQbkBj3,41400,more than downpayment,more than downpayment,0,9000
lyQbkBj3,4500,8/5/2019,9900,lyQbkBj3,45900,more than downpayment,more than downpayment,0,4500
lyQbkBj3,4500,8/25/2019,9900,lyQbkBj3,50400,more than downpayment,more than downpayment,0,4500
lyQbkBj3,4500,9/25/2019,9900,lyQbkBj3,54900,more than downpayment,more than downpayment,0,4500
lyQbkBj3,4500,10/29/2019,9900,lyQbkBj3,59400,more than downpayment,more than downpayment,0,4500
lyQbkBj3,4500,12/3/2019,9900,lyQbkBj3,63900,more than downpayment,more than downpayment,0,4500
lYVZ0rUT,8900,2/12/2019,8900,,8900,equal to downpayment,,8900,0
lYVZ0rUT,11700,3/8/2019,8900,lYVZ0rUT,20600,more than downpayment,equal to downpayment,0,11700
lYVZ0rUT,3900,5/7/2019,8900,lYVZ0rUT,24500,more than downpayment,more than downpayment,0,3900
lYVZ0rUT,7800,6/3/2019,8900,lYVZ0rUT,32300,more than downpayment,more than downpayment,0,7800
lYVZ0rUT,3900,9/3/2019,8900,lYVZ0rUT,36200,more than downpayment,more than downpayment,0,3900
lYVZ0rUT,3900,9/25/2019,8900,lYVZ0rUT,40100,more than downpayment,more than downpayment,0,3900
lYVZ0rUT,3900,10/26/2019,8900,lYVZ0rUT,44000,more than downpayment,more than downpayment,0,3900
lYVZ0rUT,3900,11/25/2019,8900,lYVZ0rUT,47900,more than downpayment,more than downpayment,0,3900
lYVZ0rUT,3900,12/13/2019,8900,lYVZ0rUT,51800,more than downpayment,more than downpayment,0,3900
lYVZ0rUT,3900,1/23/2020,8900,lYVZ0rUT,55700,more than downpayment,more than downpayment,0,3900
LZ5JpTeU,11000,7/8/2019,9900,,11000,more than downpayment,,9900,1100
LZ5JpTeU,3900,7/23/2019,9900,LZ5JpTeU,14900,more than downpayment,more than downpayment,0,3900
LZ5JpTeU,3900,8/25/2019,9900,LZ5JpTeU,18800,more than downpayment,more than downpayment,0,3900
LZ5JpTeU,3900,9/23/2019,9900,LZ5JpTeU,22700,more than downpayment,more than downpayment,0,3900
LZ5JpTeU,3900,10/23/2019,9900,LZ5JpTeU,26600,more than downpayment,more than downpayment,0,3900
LZ5JpTeU,3900,11/25/2019,9900,LZ5JpTeU,30500,more than downpayment,more than downpayment,0,3900
LZ5JpTeU,3900,12/27/2019,9900,LZ5JpTeU,34400,more than downpayment,more than downpayment,0,3900
LZ5JpTeU,3900,1/27/2020,9900,LZ5JpTeU,38300,more than downpayment,more than downpayment,0,3900
LzDDgTNL,13800,7/11/2019,9900,,13800,more than downpayment,,9900,3900
LzDDgTNL,3900,10/1/2019,9900,LzDDgTNL,17700,more than downpayment,more than downpayment,0,3900
LzDDgTNL,3900,11/7/2019,9900,LzDDgTNL,21600,more than downpayment,more than downpayment,0,3900
LzDDgTNL,3900,11/24/2019,9900,LzDDgTNL,25500,more than downpayment,more than downpayment,0,3900
LzDDgTNL,3900,1/1/2020,9900,LzDDgTNL,29400,more than downpayment,more than downpayment,0,3900
LzDDgTNL,3900,2/5/2020,9900,LzDDgTNL,33300,more than downpayment,more than downpayment,0,3900
lZxOWpwZ,8900,2/8/2019,8900,,8900,equal to downpayment,,8900,0
lZxOWpwZ,3900,3/25/2019,8900,lZxOWpwZ,12800,more than downpayment,equal to downpayment,0,3900
lZxOWpwZ,3900,4/28/2019,8900,lZxOWpwZ,16700,more than downpayment,more than downpayment,0,3900
lZxOWpwZ,3900,5/22/2019,8900,lZxOWpwZ,20600,more than downpayment,more than downpayment,0,3900
lZxOWpwZ,3900,6/24/2019,8900,lZxOWpwZ,24500,more than downpayment,more than downpayment,0,3900
lZxOWpwZ,3900,7/30/2019,8900,lZxOWpwZ,28400,more than downpayment,more than downpayment,0,3900
lZxOWpwZ,3900,8/28/2019,8900,lZxOWpwZ,32300,more than downpayment,more than downpayment,0,3900
lZxOWpwZ,3900,9/24/2019,8900,lZxOWpwZ,36200,more than downpayment,more than downpayment,0,3900
lZxOWpwZ,3900,10/31/2019,8900,lZxOWpwZ,40100,more than downpayment,more than downpayment,0,3900
lZxOWpwZ,3900,11/25/2019,8900,lZxOWpwZ,44000,more than downpayment,more than downpayment,0,3900
lZxOWpwZ,3900,12/31/2019,8900,lZxOWpwZ,47900,more than downpayment,more than downpayment,0,3900
lZxOWpwZ,3900,1/29/2020,8900,lZxOWpwZ,51800,more than downpayment,more than downpayment,0,3900
m0dAvec2,10000,6/1/2017,10000,,10000,equal to downpayment,,10000,0
m0dAvec2,3000,9/30/2017,10000,m0dAvec2,13000,more than downpayment,equal to downpayment,0,3000
m0dAvec2,3000,1/15/2018,10000,m0dAvec2,16000,more than downpayment,more than downpayment,0,3000
m0dAvec2,24000,4/16/2018,10000,m0dAvec2,40000,more than downpayment,more than downpayment,0,24000
M2DE6SpJ,8900,2/25/2019,8900,,8900,equal to downpayment,,8900,0
M2DE6SpJ,3900,3/25/2019,8900,M2DE6SpJ,12800,more than downpayment,equal to downpayment,0,3900
M2DE6SpJ,3900,4/18/2019,8900,M2DE6SpJ,16700,more than downpayment,more than downpayment,0,3900
M2DE6SpJ,3900,6/1/2019,8900,M2DE6SpJ,20600,more than downpayment,more than downpayment,0,3900
M2DE6SpJ,3900,7/1/2019,8900,M2DE6SpJ,24500,more than downpayment,more than downpayment,0,3900
M2DE6SpJ,3900,8/2/2019,8900,M2DE6SpJ,28400,more than downpayment,more than downpayment,0,3900
M2DE6SpJ,3900,9/4/2019,8900,M2DE6SpJ,32300,more than downpayment,more than downpayment,0,3900
M2DE6SpJ,3900,10/2/2019,8900,M2DE6SpJ,36200,more than downpayment,more than downpayment,0,3900
M2DE6SpJ,4000,11/5/2019,8900,M2DE6SpJ,40200,more than downpayment,more than downpayment,0,4000
M2DE6SpJ,3900,12/3/2019,8900,M2DE6SpJ,44100,more than downpayment,more than downpayment,0,3900
M2DE6SpJ,3900,1/2/2020,8900,M2DE6SpJ,48000,more than downpayment,more than downpayment,0,3900
M2DE6SpJ,3900,2/4/2020,8900,M2DE6SpJ,51900,more than downpayment,more than downpayment,0,3900
m3g2OoUu,10000,11/27/2018,10000,,10000,equal to downpayment,,10000,0
m3g2OoUu,4500,1/4/2019,10000,m3g2OoUu,14500,more than downpayment,equal to downpayment,0,4500
m3g2OoUu,4500,2/4/2019,10000,m3g2OoUu,19000,more than downpayment,more than downpayment,0,4500
m3g2OoUu,4500,3/5/2019,10000,m3g2OoUu,23500,more than downpayment,more than downpayment,0,4500
m3g2OoUu,4500,4/4/2019,10000,m3g2OoUu,28000,more than downpayment,more than downpayment,0,4500
m3g2OoUu,4500,5/1/2019,10000,m3g2OoUu,32500,more than downpayment,more than downpayment,0,4500
m3g2OoUu,4500,6/3/2019,10000,m3g2OoUu,37000,more than downpayment,more than downpayment,0,4500
m3g2OoUu,4500,7/3/2019,10000,m3g2OoUu,41500,more than downpayment,more than downpayment,0,4500
m3g2OoUu,4500,8/3/2019,10000,m3g2OoUu,46000,more than downpayment,more than downpayment,0,4500
m3g2OoUu,4500,9/4/2019,10000,m3g2OoUu,50500,more than downpayment,more than downpayment,0,4500
m3g2OoUu,4500,10/5/2019,10000,m3g2OoUu,55000,more than downpayment,more than downpayment,0,4500
m3g2OoUu,4500,11/5/2019,10000,m3g2OoUu,59500,more than downpayment,more than downpayment,0,4500
m3g2OoUu,4500,12/5/2019,10000,m3g2OoUu,64000,more than downpayment,more than downpayment,0,4500
M3PXK9OP,9900,11/22/2019,9900,,9900,equal to downpayment,,9900,0
M3PXK9OP,3900,2/6/2020,9900,M3PXK9OP,13800,more than downpayment,equal to downpayment,0,3900
M4CR2PZ5,50000,7/25/2019,26250,,50000,more than downpayment,,26250,23750
M4CR2PZ5,18000,9/11/2019,26250,M4CR2PZ5,68000,more than downpayment,more than downpayment,0,18000
M4CR2PZ5,18000,10/16/2019,26250,M4CR2PZ5,86000,more than downpayment,more than downpayment,0,18000
M4CR2PZ5,18000,11/19/2019,26250,M4CR2PZ5,104000,more than downpayment,more than downpayment,0,18000
M4CR2PZ5,1000,1/3/2020,26250,M4CR2PZ5,105000,more than downpayment,more than downpayment,0,1000
M4jOGM8q,8900,5/2/2019,8900,,8900,equal to downpayment,,8900,0
M4jOGM8q,5000,6/4/2019,8900,M4jOGM8q,13900,more than downpayment,equal to downpayment,0,5000
M4jOGM8q,5000,7/6/2019,8900,M4jOGM8q,18900,more than downpayment,more than downpayment,0,5000
M4jOGM8q,5000,8/7/2019,8900,M4jOGM8q,23900,more than downpayment,more than downpayment,0,5000
M4jOGM8q,4000,9/9/2019,8900,M4jOGM8q,27900,more than downpayment,more than downpayment,0,4000
M4jOGM8q,5000,10/9/2019,8900,M4jOGM8q,32900,more than downpayment,more than downpayment,0,5000
M4jOGM8q,3900,11/9/2019,8900,M4jOGM8q,36800,more than downpayment,more than downpayment,0,3900
M4jOGM8q,3900,12/11/2019,8900,M4jOGM8q,40700,more than downpayment,more than downpayment,0,3900
M4jOGM8q,4000,2/8/2020,8900,M4jOGM8q,44700,more than downpayment,more than downpayment,0,4000
M4SMVVRL,8900,4/8/2019,8900,,8900,equal to downpayment,,8900,0
M4SMVVRL,3900,5/28/2019,8900,M4SMVVRL,12800,more than downpayment,equal to downpayment,0,3900
M4SMVVRL,3900,7/6/2019,8900,M4SMVVRL,16700,more than downpayment,more than downpayment,0,3900
M4SMVVRL,3400,7/31/2019,8900,M4SMVVRL,20100,more than downpayment,more than downpayment,0,3400
M4SMVVRL,400,8/26/2019,8900,M4SMVVRL,20500,more than downpayment,more than downpayment,0,400
M4SMVVRL,500,8/28/2019,8900,M4SMVVRL,21000,more than downpayment,more than downpayment,0,500
M4SMVVRL,400,10/17/2019,8900,M4SMVVRL,21400,more than downpayment,more than downpayment,0,400
M4SMVVRL,10900,11/12/2019,8900,M4SMVVRL,32300,more than downpayment,more than downpayment,0,10900
M4SMVVRL,3700,2/4/2020,8900,M4SMVVRL,36000,more than downpayment,more than downpayment,0,3700
M5VMDVAF,13800,11/8/2019,9900,,13800,more than downpayment,,9900,3900
M5VMDVAF,3900,12/26/2019,9900,M5VMDVAF,17700,more than downpayment,more than downpayment,0,3900
M5VMDVAF,3900,1/25/2020,9900,M5VMDVAF,21600,more than downpayment,more than downpayment,0,3900
M61GDY6W,8900,10/16/2019,8900,,8900,equal to downpayment,,8900,0
m6HZ0mvz,17700,6/14/2019,9900,,17700,more than downpayment,,9900,7800
m6HZ0mvz,3900,9/5/2019,9900,m6HZ0mvz,21600,more than downpayment,more than downpayment,0,3900
m6HZ0mvz,3900,11/8/2019,9900,m6HZ0mvz,25500,more than downpayment,more than downpayment,0,3900
M72AA541,9900,12/1/2019,9900,,9900,equal to downpayment,,9900,0
M7DDGMPZ,23400,10/14/2019,23400,,23400,equal to downpayment,,23400,0
M7DDGMPZ,7300,11/25/2019,23400,M7DDGMPZ,30700,more than downpayment,equal to downpayment,0,7300
M7DDGMPZ,3900,12/20/2019,23400,M7DDGMPZ,34600,more than downpayment,more than downpayment,0,3900
M7DDGMPZ,3400,12/25/2019,23400,M7DDGMPZ,38000,more than downpayment,more than downpayment,0,3400
M7DDGMPZ,7300,1/24/2020,23400,M7DDGMPZ,45300,more than downpayment,more than downpayment,0,7300
M8AL3ZWQ,9900,10/24/2019,9900,,9900,equal to downpayment,,9900,0
M8AL3ZWQ,3900,12/21/2019,9900,M8AL3ZWQ,13800,more than downpayment,equal to downpayment,0,3900
M8AL3ZWQ,3900,1/27/2020,9900,M8AL3ZWQ,17700,more than downpayment,more than downpayment,0,3900
M8GGQ3TC,10000,10/14/2019,9900,,10000,more than downpayment,,9900,100
M8GGQ3TC,3999,12/7/2019,9900,M8GGQ3TC,13999,more than downpayment,more than downpayment,0,3999
M8GGQ3TC,3999,1/9/2020,9900,M8GGQ3TC,17998,more than downpayment,more than downpayment,0,3999
M8GGQ3TC,3999,2/9/2020,9900,M8GGQ3TC,21997,more than downpayment,more than downpayment,0,3999
M8HV7Z56,8900,12/20/2019,8900,,8900,equal to downpayment,,8900,0
M8tTOMf4,10000,6/19/2017,10000,,10000,equal to downpayment,,10000,0
M8tTOMf4,3000,9/16/2017,10000,M8tTOMf4,13000,more than downpayment,equal to downpayment,0,3000
M8tTOMf4,1300,11/2/2017,10000,M8tTOMf4,14300,more than downpayment,more than downpayment,0,1300
M8tTOMf4,1500,11/13/2017,10000,M8tTOMf4,15800,more than downpayment,more than downpayment,0,1500
M8tTOMf4,500,11/18/2017,10000,M8tTOMf4,16300,more than downpayment,more than downpayment,0,500
M8tTOMf4,1500,2/15/2018,10000,M8tTOMf4,17800,more than downpayment,more than downpayment,0,1500
M8XCUF4N,9900,11/12/2019,9900,,9900,equal to downpayment,,9900,0
M8XCUF4N,3900,1/6/2020,9900,M8XCUF4N,13800,more than downpayment,equal to downpayment,0,3900
M8XCUF4N,3900,2/4/2020,9900,M8XCUF4N,17700,more than downpayment,more than downpayment,0,3900
M92AGHDP,9900,12/23/2019,9900,,9900,equal to downpayment,,9900,0
m9N50rBo,8900,4/2/2019,8900,,8900,equal to downpayment,,8900,0
m9N50rBo,3900,5/4/2019,8900,m9N50rBo,12800,more than downpayment,equal to downpayment,0,3900
m9N50rBo,3900,6/4/2019,8900,m9N50rBo,16700,more than downpayment,more than downpayment,0,3900
m9N50rBo,3900,7/5/2019,8900,m9N50rBo,20600,more than downpayment,more than downpayment,0,3900
m9N50rBo,3900,8/5/2019,8900,m9N50rBo,24500,more than downpayment,more than downpayment,0,3900
m9N50rBo,3900,9/5/2019,8900,m9N50rBo,28400,more than downpayment,more than downpayment,0,3900
m9N50rBo,3900,10/5/2019,8900,m9N50rBo,32300,more than downpayment,more than downpayment,0,3900
m9N50rBo,3900,11/8/2019,8900,m9N50rBo,36200,more than downpayment,more than downpayment,0,3900
m9N50rBo,3900,12/6/2019,8900,m9N50rBo,40100,more than downpayment,more than downpayment,0,3900
m9N50rBo,3900,1/7/2020,8900,m9N50rBo,44000,more than downpayment,more than downpayment,0,3900
m9N50rBo,3900,2/7/2020,8900,m9N50rBo,47900,more than downpayment,more than downpayment,0,3900
M9RWPQ8I,9900,11/13/2019,9900,,9900,equal to downpayment,,9900,0
M9RWPQ8I,400,1/23/2020,9900,M9RWPQ8I,10300,more than downpayment,equal to downpayment,0,400
M9RWPQ8I,3500,1/31/2020,9900,M9RWPQ8I,13800,more than downpayment,more than downpayment,0,3500
MAI9J2C1,9900,7/31/2019,9900,,9900,equal to downpayment,,9900,0
MAI9J2C1,3900,9/2/2019,9900,MAI9J2C1,13800,more than downpayment,equal to downpayment,0,3900
MAI9J2C1,3900,10/4/2019,9900,MAI9J2C1,17700,more than downpayment,more than downpayment,0,3900
MAI9J2C1,3900,11/1/2019,9900,MAI9J2C1,21600,more than downpayment,more than downpayment,0,3900
MAI9J2C1,3900,12/2/2019,9900,MAI9J2C1,25500,more than downpayment,more than downpayment,0,3900
MAI9J2C1,3900,12/28/2019,9900,MAI9J2C1,29400,more than downpayment,more than downpayment,0,3900
MAI9J2C1,3900,1/30/2020,9900,MAI9J2C1,33300,more than downpayment,more than downpayment,0,3900
MamX4RrV,8900,12/14/2018,8900,,8900,equal to downpayment,,8900,0
MamX4RrV,3900,1/5/2019,8900,MamX4RrV,12800,more than downpayment,equal to downpayment,0,3900
MamX4RrV,3900,2/21/2019,8900,MamX4RrV,16700,more than downpayment,more than downpayment,0,3900
MamX4RrV,3900,3/21/2019,8900,MamX4RrV,20600,more than downpayment,more than downpayment,0,3900
MamX4RrV,3900,4/17/2019,8900,MamX4RrV,24500,more than downpayment,more than downpayment,0,3900
MamX4RrV,4000,5/23/2019,8900,MamX4RrV,28500,more than downpayment,more than downpayment,0,4000
MamX4RrV,1000,6/21/2019,8900,MamX4RrV,29500,more than downpayment,more than downpayment,0,1000
MamX4RrV,1500,6/29/2019,8900,MamX4RrV,31000,more than downpayment,more than downpayment,0,1500
MamX4RrV,1400,7/1/2019,8900,MamX4RrV,32400,more than downpayment,more than downpayment,0,1400
MamX4RrV,4000,7/30/2019,8900,MamX4RrV,36400,more than downpayment,more than downpayment,0,4000
MamX4RrV,4000,8/24/2019,8900,MamX4RrV,40400,more than downpayment,more than downpayment,0,4000
MamX4RrV,4000,9/26/2019,8900,MamX4RrV,44400,more than downpayment,more than downpayment,0,4000
MamX4RrV,4000,10/24/2019,8900,MamX4RrV,48400,more than downpayment,more than downpayment,0,4000
MamX4RrV,3600,11/25/2019,8900,MamX4RrV,52000,more than downpayment,more than downpayment,0,3600
MamX4RrV,4000,12/26/2019,8900,MamX4RrV,56000,more than downpayment,more than downpayment,0,4000
MamX4RrV,4000,1/23/2020,8900,MamX4RrV,60000,more than downpayment,more than downpayment,0,4000
MbimZCMK,9900,6/28/2019,9900,,9900,equal to downpayment,,9900,0
MbimZCMK,1200,8/16/2019,9900,MbimZCMK,11100,more than downpayment,equal to downpayment,0,1200
MbimZCMK,1500,8/23/2019,9900,MbimZCMK,12600,more than downpayment,more than downpayment,0,1500
MbimZCMK,1200,8/27/2019,9900,MbimZCMK,13800,more than downpayment,more than downpayment,0,1200
MbimZCMK,3900,9/19/2019,9900,MbimZCMK,17700,more than downpayment,more than downpayment,0,3900
MbimZCMK,3900,10/20/2019,9900,MbimZCMK,21600,more than downpayment,more than downpayment,0,3900
MbimZCMK,3900,12/12/2019,9900,MbimZCMK,25500,more than downpayment,more than downpayment,0,3900
MbimZCMK,3900,12/23/2019,9900,MbimZCMK,29400,more than downpayment,more than downpayment,0,3900
MbimZCMK,3900,1/23/2020,9900,MbimZCMK,33300,more than downpayment,more than downpayment,0,3900
MbQZD6k3,10000,11/30/2018,10000,,10000,equal to downpayment,,10000,0
MbQZD6k3,4500,1/16/2019,10000,MbQZD6k3,14500,more than downpayment,equal to downpayment,0,4500
MbQZD6k3,4500,2/15/2019,10000,MbQZD6k3,19000,more than downpayment,more than downpayment,0,4500
MbQZD6k3,4500,3/22/2019,10000,MbQZD6k3,23500,more than downpayment,more than downpayment,0,4500
MbQZD6k3,4500,4/16/2019,10000,MbQZD6k3,28000,more than downpayment,more than downpayment,0,4500
MbQZD6k3,4500,5/18/2019,10000,MbQZD6k3,32500,more than downpayment,more than downpayment,0,4500
MbQZD6k3,4500,6/25/2019,10000,MbQZD6k3,37000,more than downpayment,more than downpayment,0,4500
MbQZD6k3,4500,7/25/2019,10000,MbQZD6k3,41500,more than downpayment,more than downpayment,0,4500
MbQZD6k3,4500,8/24/2019,10000,MbQZD6k3,46000,more than downpayment,more than downpayment,0,4500
MbQZD6k3,4500,9/24/2019,10000,MbQZD6k3,50500,more than downpayment,more than downpayment,0,4500
MbQZD6k3,4500,10/24/2019,10000,MbQZD6k3,55000,more than downpayment,more than downpayment,0,4500
MbQZD6k3,4500,11/25/2019,10000,MbQZD6k3,59500,more than downpayment,more than downpayment,0,4500
MbQZD6k3,4500,12/21/2019,10000,MbQZD6k3,64000,more than downpayment,more than downpayment,0,4500
MC9VU9OT,9900,1/31/2020,8900,,9900,more than downpayment,,8900,1000
McCVcJLY,10000,7/31/2018,10000,,10000,equal to downpayment,,10000,0
McCVcJLY,10000,8/30/2018,10000,McCVcJLY,20000,more than downpayment,equal to downpayment,0,10000
McCVcJLY,7000,10/13/2018,10000,McCVcJLY,27000,more than downpayment,more than downpayment,0,7000
McCVcJLY,2000,1/18/2019,10000,McCVcJLY,29000,more than downpayment,more than downpayment,0,2000
McCVcJLY,4000,2/6/2019,10000,McCVcJLY,33000,more than downpayment,more than downpayment,0,4000
McCVcJLY,3000,3/18/2019,10000,McCVcJLY,36000,more than downpayment,more than downpayment,0,3000
McCVcJLY,3000,4/6/2019,10000,McCVcJLY,39000,more than downpayment,more than downpayment,0,3000
McCVcJLY,3000,5/3/2019,10000,McCVcJLY,42000,more than downpayment,more than downpayment,0,3000
McCVcJLY,3000,11/20/2019,10000,McCVcJLY,45000,more than downpayment,more than downpayment,0,3000
MCOJEBAY,9900,8/15/2019,9900,,9900,equal to downpayment,,9900,0
MCOJEBAY,3900,10/8/2019,9900,MCOJEBAY,13800,more than downpayment,equal to downpayment,0,3900
MCOJEBAY,3900,11/6/2019,9900,MCOJEBAY,17700,more than downpayment,more than downpayment,0,3900
MCOJEBAY,3900,12/11/2019,9900,MCOJEBAY,21600,more than downpayment,more than downpayment,0,3900
MCOJEBAY,3900,1/18/2020,9900,MCOJEBAY,25500,more than downpayment,more than downpayment,0,3900
mcv23ud0,8900,5/13/2019,8900,,8900,equal to downpayment,,8900,0
MCW9WSXH,5000,1/1/2020,4999,,5000,more than downpayment,,4999,1
MCW9WSXH,3100,2/5/2020,4999,MCW9WSXH,8100,more than downpayment,more than downpayment,0,3100
mCWllWOc,8900,1/30/2019,8900,,8900,equal to downpayment,,8900,0
mCWllWOc,3900,3/4/2019,8900,mCWllWOc,12800,more than downpayment,equal to downpayment,0,3900
mCWllWOc,3900,4/8/2019,8900,mCWllWOc,16700,more than downpayment,more than downpayment,0,3900
mCWllWOc,3900,5/4/2019,8900,mCWllWOc,20600,more than downpayment,more than downpayment,0,3900
mCWllWOc,3900,6/6/2019,8900,mCWllWOc,24500,more than downpayment,more than downpayment,0,3900
mCWllWOc,3900,7/8/2019,8900,mCWllWOc,28400,more than downpayment,more than downpayment,0,3900
mCWllWOc,3900,8/5/2019,8900,mCWllWOc,32300,more than downpayment,more than downpayment,0,3900
mCWllWOc,3900,9/9/2019,8900,mCWllWOc,36200,more than downpayment,more than downpayment,0,3900
mCWllWOc,3900,10/14/2019,8900,mCWllWOc,40100,more than downpayment,more than downpayment,0,3900
mCWllWOc,3900,11/17/2019,8900,mCWllWOc,44000,more than downpayment,more than downpayment,0,3900
mCWllWOc,3900,12/4/2019,8900,mCWllWOc,47900,more than downpayment,more than downpayment,0,3900
mCWllWOc,3900,1/7/2020,8900,mCWllWOc,51800,more than downpayment,more than downpayment,0,3900
mCWllWOc,3900,2/7/2020,8900,mCWllWOc,55700,more than downpayment,more than downpayment,0,3900
MD2VPA3S,9900,1/18/2020,9900,,9900,equal to downpayment,,9900,0
mDJMgb2W,8900,4/1/2019,8900,,8900,equal to downpayment,,8900,0
mDJMgb2W,4000,5/11/2019,8900,mDJMgb2W,12900,more than downpayment,equal to downpayment,0,4000
mDJMgb2W,4000,5/21/2019,8900,mDJMgb2W,16900,more than downpayment,more than downpayment,0,4000
mDJMgb2W,3900,6/24/2019,8900,mDJMgb2W,20800,more than downpayment,more than downpayment,0,3900
mDJMgb2W,4000,7/25/2019,8900,mDJMgb2W,24800,more than downpayment,more than downpayment,0,4000
mDJMgb2W,3900,8/23/2019,8900,mDJMgb2W,28700,more than downpayment,more than downpayment,0,3900
mDJMgb2W,3900,9/25/2019,8900,mDJMgb2W,32600,more than downpayment,more than downpayment,0,3900
mDJMgb2W,3900,10/26/2019,8900,mDJMgb2W,36500,more than downpayment,more than downpayment,0,3900
mDJMgb2W,3900,11/28/2019,8900,mDJMgb2W,40400,more than downpayment,more than downpayment,0,3900
mDJMgb2W,3900,12/27/2019,8900,mDJMgb2W,44300,more than downpayment,more than downpayment,0,3900
mDJMgb2W,3900,1/28/2020,8900,mDJMgb2W,48200,more than downpayment,more than downpayment,0,3900
MGW7JY1I,9900,2/4/2020,9900,,9900,equal to downpayment,,9900,0
MGZW9RU2,5000,1/6/2020,9900,,5000,less than downpayment,,5000,0
MII5NZIT,9900,1/24/2020,9900,,9900,equal to downpayment,,9900,0
mIWOg6T9,10000,8/18/2017,10000,,10000,equal to downpayment,,10000,0
mIWOg6T9,2000,10/3/2017,10000,mIWOg6T9,12000,more than downpayment,equal to downpayment,0,2000
mIWOg6T9,2000,11/2/2017,10000,mIWOg6T9,14000,more than downpayment,more than downpayment,0,2000
mIWOg6T9,2000,12/7/2017,10000,mIWOg6T9,16000,more than downpayment,more than downpayment,0,2000
mIWOg6T9,2000,1/8/2018,10000,mIWOg6T9,18000,more than downpayment,more than downpayment,0,2000
mIWOg6T9,4000,3/6/2018,10000,mIWOg6T9,22000,more than downpayment,more than downpayment,0,4000
mIWOg6T9,1000,4/28/2018,10000,mIWOg6T9,23000,more than downpayment,more than downpayment,0,1000
mIWOg6T9,2000,9/1/2018,10000,mIWOg6T9,25000,more than downpayment,more than downpayment,0,2000
mIWOg6T9,2000,10/18/2018,10000,mIWOg6T9,27000,more than downpayment,more than downpayment,0,2000
mIWOg6T9,2000,11/12/2018,10000,mIWOg6T9,29000,more than downpayment,more than downpayment,0,2000
mIWOg6T9,6000,1/31/2019,10000,mIWOg6T9,35000,more than downpayment,more than downpayment,0,6000
mIWOg6T9,10000,3/15/2019,10000,mIWOg6T9,45000,more than downpayment,more than downpayment,0,10000
mJc7PmAN,8900,2/5/2019,8900,,8900,equal to downpayment,,8900,0
mJc7PmAN,3900,3/25/2019,8900,mJc7PmAN,12800,more than downpayment,equal to downpayment,0,3900
mJc7PmAN,3900,4/26/2019,8900,mJc7PmAN,16700,more than downpayment,more than downpayment,0,3900
mJc7PmAN,3900,5/24/2019,8900,mJc7PmAN,20600,more than downpayment,more than downpayment,0,3900
mJc7PmAN,3900,6/24/2019,8900,mJc7PmAN,24500,more than downpayment,more than downpayment,0,3900
mJc7PmAN,3900,7/19/2019,8900,mJc7PmAN,28400,more than downpayment,more than downpayment,0,3900
mJc7PmAN,3900,8/24/2019,8900,mJc7PmAN,32300,more than downpayment,more than downpayment,0,3900
mJc7PmAN,7800,9/25/2019,8900,mJc7PmAN,40100,more than downpayment,more than downpayment,0,7800
mJc7PmAN,3900,11/22/2019,8900,mJc7PmAN,44000,more than downpayment,more than downpayment,0,3900
mJc7PmAN,3900,12/26/2019,8900,mJc7PmAN,47900,more than downpayment,more than downpayment,0,3900
mJc7PmAN,3900,1/26/2020,8900,mJc7PmAN,51800,more than downpayment,more than downpayment,0,3900
mjIWCiIk,10500,9/30/2017,10000,,10500,more than downpayment,,10000,500
mjIWCiIk,4500,10/31/2017,10000,mjIWCiIk,15000,more than downpayment,more than downpayment,0,4500
mjIWCiIk,4500,12/4/2017,10000,mjIWCiIk,19500,more than downpayment,more than downpayment,0,4500
mjIWCiIk,4500,12/29/2017,10000,mjIWCiIk,24000,more than downpayment,more than downpayment,0,4500
mjIWCiIk,4500,2/3/2018,10000,mjIWCiIk,28500,more than downpayment,more than downpayment,0,4500
mjIWCiIk,4500,3/4/2018,10000,mjIWCiIk,33000,more than downpayment,more than downpayment,0,4500
mjIWCiIk,4500,5/7/2018,10000,mjIWCiIk,37500,more than downpayment,more than downpayment,0,4500
mjIWCiIk,4500,6/18/2018,10000,mjIWCiIk,42000,more than downpayment,more than downpayment,0,4500
mjIWCiIk,4500,7/28/2018,10000,mjIWCiIk,46500,more than downpayment,more than downpayment,0,4500
mjIWCiIk,4500,10/5/2018,10000,mjIWCiIk,51000,more than downpayment,more than downpayment,0,4500
mjIWCiIk,4500,11/2/2018,10000,mjIWCiIk,55500,more than downpayment,more than downpayment,0,4500
mjIWCiIk,9000,11/12/2018,10000,mjIWCiIk,64500,more than downpayment,more than downpayment,0,9000
MjRjbbT6,8900,7/15/2019,9900,,8900,less than downpayment,,8900,0
MjRjbbT6,1000,8/14/2019,9900,MjRjbbT6,9900,equal to downpayment,less than downpayment,1000,0
MjRjbbT6,4900,9/15/2019,9900,MjRjbbT6,14800,more than downpayment,equal to downpayment,0,4900
MjRjbbT6,3900,10/11/2019,9900,MjRjbbT6,18700,more than downpayment,more than downpayment,0,3900
MjRjbbT6,2900,12/2/2019,9900,MjRjbbT6,21600,more than downpayment,more than downpayment,0,2900
MjRjbbT6,1000,12/3/2019,9900,MjRjbbT6,22600,more than downpayment,more than downpayment,0,1000
MjRjbbT6,3900,12/20/2019,9900,MjRjbbT6,26500,more than downpayment,more than downpayment,0,3900
MjRjbbT6,3900,1/14/2020,9900,MjRjbbT6,30400,more than downpayment,more than downpayment,0,3900
mKqBVzib,10000,12/19/2018,10000,,10000,equal to downpayment,,10000,0
mKqBVzib,4500,1/30/2019,10000,mKqBVzib,14500,more than downpayment,equal to downpayment,0,4500
mKqBVzib,4500,3/4/2019,10000,mKqBVzib,19000,more than downpayment,more than downpayment,0,4500
mKqBVzib,4500,3/28/2019,10000,mKqBVzib,23500,more than downpayment,more than downpayment,0,4500
mKqBVzib,4500,4/30/2019,10000,mKqBVzib,28000,more than downpayment,more than downpayment,0,4500
mKqBVzib,4500,6/1/2019,10000,mKqBVzib,32500,more than downpayment,more than downpayment,0,4500
mKqBVzib,4500,7/5/2019,10000,mKqBVzib,37000,more than downpayment,more than downpayment,0,4500
mKqBVzib,4500,7/27/2019,10000,mKqBVzib,41500,more than downpayment,more than downpayment,0,4500
mKqBVzib,4500,9/6/2019,10000,mKqBVzib,46000,more than downpayment,more than downpayment,0,4500
mKqBVzib,9700,1/25/2020,10000,mKqBVzib,55700,more than downpayment,more than downpayment,0,9700
mkzAfz7W,10000,4/8/2019,8900,,10000,more than downpayment,,8900,1100
mkzAfz7W,10000,5/27/2019,8900,mkzAfz7W,20000,more than downpayment,more than downpayment,0,10000
mkzAfz7W,700,8/20/2019,8900,mkzAfz7W,20700,more than downpayment,more than downpayment,0,700
mkzAfz7W,4500,9/21/2019,8900,mkzAfz7W,25200,more than downpayment,more than downpayment,0,4500
mkzAfz7W,8000,11/14/2019,8900,mkzAfz7W,33200,more than downpayment,more than downpayment,0,8000
mkzAfz7W,5000,12/12/2019,8900,mkzAfz7W,38200,more than downpayment,more than downpayment,0,5000
mkzAfz7W,2500,2/8/2020,8900,mkzAfz7W,40700,more than downpayment,more than downpayment,0,2500
ML8944Q9,9900,11/11/2019,9900,,9900,equal to downpayment,,9900,0
ML8944Q9,2500,11/27/2019,9900,ML8944Q9,12400,more than downpayment,equal to downpayment,0,2500
ML8944Q9,1400,12/16/2019,9900,ML8944Q9,13800,more than downpayment,more than downpayment,0,1400
ML8944Q9,3900,1/1/2020,9900,ML8944Q9,17700,more than downpayment,more than downpayment,0,3900
ML8944Q9,3900,2/2/2020,9900,ML8944Q9,21600,more than downpayment,more than downpayment,0,3900
mLol9GWB,8900,2/18/2019,8900,,8900,equal to downpayment,,8900,0
mLol9GWB,3900,4/25/2019,8900,mLol9GWB,12800,more than downpayment,equal to downpayment,0,3900
mLol9GWB,1000,4/30/2019,8900,mLol9GWB,13800,more than downpayment,more than downpayment,0,1000
mLol9GWB,2000,12/21/2019,8900,mLol9GWB,15800,more than downpayment,more than downpayment,0,2000
mlYjhRWD,9900,8/9/2019,8900,,9900,more than downpayment,,8900,1000
mlYjhRWD,3900,9/24/2019,8900,mlYjhRWD,13800,more than downpayment,more than downpayment,0,3900
mlYjhRWD,3000,11/4/2019,8900,mlYjhRWD,16800,more than downpayment,more than downpayment,0,3000
mlYjhRWD,5000,11/29/2019,8900,mlYjhRWD,21800,more than downpayment,more than downpayment,0,5000
mlYjhRWD,6000,1/22/2020,8900,mlYjhRWD,27800,more than downpayment,more than downpayment,0,6000
mlYjhRWD,1000,1/30/2020,8900,mlYjhRWD,28800,more than downpayment,more than downpayment,0,1000
MNAQGB26,9900,9/23/2019,9900,,9900,equal to downpayment,,9900,0
MNAQGB26,4000,11/16/2019,9900,MNAQGB26,13900,more than downpayment,equal to downpayment,0,4000
MNAQGB26,3800,1/10/2020,9900,MNAQGB26,17700,more than downpayment,more than downpayment,0,3800
MNAQGB26,4000,1/30/2020,9900,MNAQGB26,21700,more than downpayment,more than downpayment,0,4000
mNNhoE4b,8900,2/22/2019,8900,,8900,equal to downpayment,,8900,0
mNNhoE4b,8000,3/9/2019,8900,mNNhoE4b,16900,more than downpayment,equal to downpayment,0,8000
mNNhoE4b,8000,5/1/2019,8900,mNNhoE4b,24900,more than downpayment,more than downpayment,0,8000
mNNhoE4b,4000,7/1/2019,8900,mNNhoE4b,28900,more than downpayment,more than downpayment,0,4000
mNNhoE4b,4000,8/6/2019,8900,mNNhoE4b,32900,more than downpayment,more than downpayment,0,4000
mNNhoE4b,4000,9/6/2019,8900,mNNhoE4b,36900,more than downpayment,more than downpayment,0,4000
mNNhoE4b,5000,10/8/2019,8900,mNNhoE4b,41900,more than downpayment,more than downpayment,0,5000
mNNhoE4b,5000,12/3/2019,8900,mNNhoE4b,46900,more than downpayment,more than downpayment,0,5000
mNNhoE4b,4000,1/3/2020,8900,mNNhoE4b,50900,more than downpayment,more than downpayment,0,4000
MNX2VT8X,9900,8/25/2019,9900,,9900,equal to downpayment,,9900,0
MNX2VT8X,4000,11/27/2019,9900,MNX2VT8X,13900,more than downpayment,equal to downpayment,0,4000
MNX2VT8X,3800,11/29/2019,9900,MNX2VT8X,17700,more than downpayment,more than downpayment,0,3800
MNX2VT8X,4000,12/25/2019,9900,MNX2VT8X,21700,more than downpayment,more than downpayment,0,4000
MNX2VT8X,3800,1/30/2020,9900,MNX2VT8X,25500,more than downpayment,more than downpayment,0,3800
mnz5U0Gy,9900,7/12/2019,9900,,9900,equal to downpayment,,9900,0
mnz5U0Gy,3900,8/21/2019,9900,mnz5U0Gy,13800,more than downpayment,equal to downpayment,0,3900
mnz5U0Gy,3900,9/25/2019,9900,mnz5U0Gy,17700,more than downpayment,more than downpayment,0,3900
mnz5U0Gy,3900,10/30/2019,9900,mnz5U0Gy,21600,more than downpayment,more than downpayment,0,3900
mnz5U0Gy,3900,11/27/2019,9900,mnz5U0Gy,25500,more than downpayment,more than downpayment,0,3900
mnz5U0Gy,3900,12/22/2019,9900,mnz5U0Gy,29400,more than downpayment,more than downpayment,0,3900
mnz5U0Gy,3900,2/1/2020,9900,mnz5U0Gy,33300,more than downpayment,more than downpayment,0,3900
MNZxwbUC,10000,7/24/2017,10000,,10000,equal to downpayment,,10000,0
MNZxwbUC,3000,11/6/2017,10000,MNZxwbUC,13000,more than downpayment,equal to downpayment,0,3000
MNZxwbUC,3000,1/5/2018,10000,MNZxwbUC,16000,more than downpayment,more than downpayment,0,3000
MNZxwbUC,3000,3/7/2018,10000,MNZxwbUC,19000,more than downpayment,more than downpayment,0,3000
MNZxwbUC,3000,4/8/2018,10000,MNZxwbUC,22000,more than downpayment,more than downpayment,0,3000
MNZxwbUC,3000,5/8/2018,10000,MNZxwbUC,25000,more than downpayment,more than downpayment,0,3000
MNZxwbUC,3000,6/7/2018,10000,MNZxwbUC,28000,more than downpayment,more than downpayment,0,3000
MNZxwbUC,3000,7/9/2018,10000,MNZxwbUC,31000,more than downpayment,more than downpayment,0,3000
MNZxwbUC,3000,8/8/2018,10000,MNZxwbUC,34000,more than downpayment,more than downpayment,0,3000
MNZxwbUC,3000,8/20/2018,10000,MNZxwbUC,37000,more than downpayment,more than downpayment,0,3000
MNZxwbUC,3000,9/6/2018,10000,MNZxwbUC,40000,more than downpayment,more than downpayment,0,3000
MNZxwbUC,2000,10/9/2018,10000,MNZxwbUC,42000,more than downpayment,more than downpayment,0,2000
MNZxwbUC,3000,11/8/2018,10000,MNZxwbUC,45000,more than downpayment,more than downpayment,0,3000
MO88EE3I,9900,11/18/2019,9900,,9900,equal to downpayment,,9900,0
MO88EE3I,3900,1/12/2020,9900,MO88EE3I,13800,more than downpayment,equal to downpayment,0,3900
MPBTOVNR,5000,10/11/2019,9900,,5000,less than downpayment,,5000,0
MPBTOVNR,3000,10/21/2019,9900,MPBTOVNR,8000,less than downpayment,less than downpayment,3000,0
MPBTOVNR,1900,10/23/2019,9900,MPBTOVNR,9900,equal to downpayment,less than downpayment,1900,0
MpsLKbKr,9900,5/14/2019,8900,,9900,more than downpayment,,8900,1000
MpsLKbKr,4000,6/24/2019,8900,MpsLKbKr,13900,more than downpayment,more than downpayment,0,4000
MpsLKbKr,3900,7/29/2019,8900,MpsLKbKr,17800,more than downpayment,more than downpayment,0,3900
MpsLKbKr,3900,8/23/2019,8900,MpsLKbKr,21700,more than downpayment,more than downpayment,0,3900
MpsLKbKr,3900,9/27/2019,8900,MpsLKbKr,25600,more than downpayment,more than downpayment,0,3900
MpsLKbKr,3900,10/24/2019,8900,MpsLKbKr,29500,more than downpayment,more than downpayment,0,3900
MpsLKbKr,3900,11/22/2019,8900,MpsLKbKr,33400,more than downpayment,more than downpayment,0,3900
MpsLKbKr,3900,12/26/2019,8900,MpsLKbKr,37300,more than downpayment,more than downpayment,0,3900
MpsLKbKr,3900,1/27/2020,8900,MpsLKbKr,41200,more than downpayment,more than downpayment,0,3900
MpYpaRCI,8900,5/7/2019,8900,,8900,equal to downpayment,,8900,0
MpYpaRCI,3900,6/3/2019,8900,MpYpaRCI,12800,more than downpayment,equal to downpayment,0,3900
MpYpaRCI,3900,6/24/2019,8900,MpYpaRCI,16700,more than downpayment,more than downpayment,0,3900
MpYpaRCI,3900,7/23/2019,8900,MpYpaRCI,20600,more than downpayment,more than downpayment,0,3900
MpYpaRCI,3900,8/27/2019,8900,MpYpaRCI,24500,more than downpayment,more than downpayment,0,3900
MpYpaRCI,3900,10/5/2019,8900,MpYpaRCI,28400,more than downpayment,more than downpayment,0,3900
MpYpaRCI,3900,11/5/2019,8900,MpYpaRCI,32300,more than downpayment,more than downpayment,0,3900
MpYpaRCI,3900,12/6/2019,8900,MpYpaRCI,36200,more than downpayment,more than downpayment,0,3900
MpYpaRCI,3900,1/8/2020,8900,MpYpaRCI,40100,more than downpayment,more than downpayment,0,3900
MpYpaRCI,3900,2/8/2020,8900,MpYpaRCI,44000,more than downpayment,more than downpayment,0,3900
mqOqH7kD,9000,7/25/2019,8900,,9000,more than downpayment,,8900,100
mqOqH7kD,4000,9/19/2019,8900,mqOqH7kD,13000,more than downpayment,more than downpayment,0,4000
mqOqH7kD,4000,10/21/2019,8900,mqOqH7kD,17000,more than downpayment,more than downpayment,0,4000
mqOqH7kD,4000,11/19/2019,8900,mqOqH7kD,21000,more than downpayment,more than downpayment,0,4000
mqOqH7kD,3900,12/23/2019,8900,mqOqH7kD,24900,more than downpayment,more than downpayment,0,3900
mqOqH7kD,4000,1/21/2020,8900,mqOqH7kD,28900,more than downpayment,more than downpayment,0,4000
mRfgrgoA,8900,8/30/2019,8900,,8900,equal to downpayment,,8900,0
mRfgrgoA,1000,10/10/2019,8900,mRfgrgoA,9900,more than downpayment,equal to downpayment,0,1000
mRfgrgoA,4000,10/29/2019,8900,mRfgrgoA,13900,more than downpayment,more than downpayment,0,4000
mRfgrgoA,4000,11/28/2019,8900,mRfgrgoA,17900,more than downpayment,more than downpayment,0,4000
mRfgrgoA,3900,12/19/2019,8900,mRfgrgoA,21800,more than downpayment,more than downpayment,0,3900
mRfgrgoA,3900,1/30/2020,8900,mRfgrgoA,25700,more than downpayment,more than downpayment,0,3900
mroo5TLJ,8900,7/23/2019,8900,,8900,equal to downpayment,,8900,0
mroo5TLJ,4000,9/3/2019,8900,mroo5TLJ,12900,more than downpayment,equal to downpayment,0,4000
mroo5TLJ,4000,9/28/2019,8900,mroo5TLJ,16900,more than downpayment,more than downpayment,0,4000
mroo5TLJ,2500,11/29/2019,8900,mroo5TLJ,19400,more than downpayment,more than downpayment,0,2500
mroo5TLJ,1200,12/9/2019,8900,mroo5TLJ,20600,more than downpayment,more than downpayment,0,1200
mroo5TLJ,500,1/9/2020,8900,mroo5TLJ,21100,more than downpayment,more than downpayment,0,500
MRT3L8RM,1070,11/25/2019,8900,,1070,less than downpayment,,1070,0
MRUA36HF,8900,12/9/2019,8900,,8900,equal to downpayment,,8900,0
MS1F67S8,8900,2/3/2020,8900,,8900,equal to downpayment,,8900,0
MSFN57TT,4900,2/5/2020,7900,,4900,less than downpayment,,4900,0
MSFN57TT,3000,2/7/2020,7900,MSFN57TT,7900,equal to downpayment,less than downpayment,3000,0
MTDEU1ZR,9900,11/26/2019,9900,,9900,equal to downpayment,,9900,0
MTDEU1ZR,3900,2/5/2020,9900,MTDEU1ZR,13800,more than downpayment,equal to downpayment,0,3900
mtegp4I5,10000,11/27/2018,10000,,10000,equal to downpayment,,10000,0
mtegp4I5,4500,12/24/2018,10000,mtegp4I5,14500,more than downpayment,equal to downpayment,0,4500
mtegp4I5,4500,1/21/2019,10000,mtegp4I5,19000,more than downpayment,more than downpayment,0,4500
mtegp4I5,4500,2/23/2019,10000,mtegp4I5,23500,more than downpayment,more than downpayment,0,4500
MU7UANM2,9900,9/2/2019,9900,,9900,equal to downpayment,,9900,0
MU7UANM2,5000,11/4/2019,9900,MU7UANM2,14900,more than downpayment,equal to downpayment,0,5000
MU7UANM2,5000,12/4/2019,9900,MU7UANM2,19900,more than downpayment,more than downpayment,0,5000
MU7UANM2,5000,1/3/2020,9900,MU7UANM2,24900,more than downpayment,more than downpayment,0,5000
MU7UANM2,5000,2/4/2020,9900,MU7UANM2,29900,more than downpayment,more than downpayment,0,5000
MuFWH47k,10000,9/26/2018,10000,,10000,equal to downpayment,,10000,0
MuFWH47k,4500,10/11/2018,10000,MuFWH47k,14500,more than downpayment,equal to downpayment,0,4500
MuFWH47k,5000,11/2/2018,10000,MuFWH47k,19500,more than downpayment,more than downpayment,0,5000
MuFWH47k,5000,12/4/2018,10000,MuFWH47k,24500,more than downpayment,more than downpayment,0,5000
MuFWH47k,6000,1/3/2019,10000,MuFWH47k,30500,more than downpayment,more than downpayment,0,6000
MuFWH47k,8500,2/6/2019,10000,MuFWH47k,39000,more than downpayment,more than downpayment,0,8500
MuFWH47k,4500,4/2/2019,10000,MuFWH47k,43500,more than downpayment,more than downpayment,0,4500
MuFWH47k,4500,5/16/2019,10000,MuFWH47k,48000,more than downpayment,more than downpayment,0,4500
MuFWH47k,4500,7/1/2019,10000,MuFWH47k,52500,more than downpayment,more than downpayment,0,4500
MuFWH47k,4500,8/5/2019,10000,MuFWH47k,57000,more than downpayment,more than downpayment,0,4500
MuFWH47k,7000,10/11/2019,10000,MuFWH47k,64000,more than downpayment,more than downpayment,0,7000
MUWRZ23D,9900,1/6/2020,9900,,9900,equal to downpayment,,9900,0
MvHCtLOA,9900,12/12/2018,9900,,9900,equal to downpayment,,9900,0
MvHCtLOA,4500,1/26/2019,9900,MvHCtLOA,14400,more than downpayment,equal to downpayment,0,4500
MvHCtLOA,4500,2/22/2019,9900,MvHCtLOA,18900,more than downpayment,more than downpayment,0,4500
MvHCtLOA,4500,3/26/2019,9900,MvHCtLOA,23400,more than downpayment,more than downpayment,0,4500
MvHCtLOA,4500,4/29/2019,9900,MvHCtLOA,27900,more than downpayment,more than downpayment,0,4500
MvHCtLOA,4500,5/29/2019,9900,MvHCtLOA,32400,more than downpayment,more than downpayment,0,4500
MvHCtLOA,4500,6/30/2019,9900,MvHCtLOA,36900,more than downpayment,more than downpayment,0,4500
MvHCtLOA,4500,8/1/2019,9900,MvHCtLOA,41400,more than downpayment,more than downpayment,0,4500
MvHCtLOA,4500,8/28/2019,9900,MvHCtLOA,45900,more than downpayment,more than downpayment,0,4500
MvHCtLOA,4500,10/2/2019,9900,MvHCtLOA,50400,more than downpayment,more than downpayment,0,4500
MvHCtLOA,4500,11/3/2019,9900,MvHCtLOA,54900,more than downpayment,more than downpayment,0,4500
MvHCtLOA,4500,12/2/2019,9900,MvHCtLOA,59400,more than downpayment,more than downpayment,0,4500
MvHCtLOA,4500,1/8/2020,9900,MvHCtLOA,63900,more than downpayment,more than downpayment,0,4500
MvHCtLOA,4500,2/6/2020,9900,MvHCtLOA,68400,more than downpayment,more than downpayment,0,4500
MVIB1V4R,9900,8/8/2019,8900,,9900,more than downpayment,,8900,1000
MVIB1V4R,5000,10/11/2019,8900,MVIB1V4R,14900,more than downpayment,more than downpayment,0,5000
MVIB1V4R,5000,11/11/2019,8900,MVIB1V4R,19900,more than downpayment,more than downpayment,0,5000
MVIB1V4R,5000,12/10/2019,8900,MVIB1V4R,24900,more than downpayment,more than downpayment,0,5000
MVIB1V4R,5000,1/11/2020,8900,MVIB1V4R,29900,more than downpayment,more than downpayment,0,5000
MWZIHW6A,1594,10/14/2019,9900,,1594,less than downpayment,,1594,0
mXyQgbri,20000,11/29/2018,9900,,20000,more than downpayment,,9900,10100
mXyQgbri,4500,2/22/2019,9900,mXyQgbri,24500,more than downpayment,more than downpayment,0,4500
mXyQgbri,4000,5/9/2019,9900,mXyQgbri,28500,more than downpayment,more than downpayment,0,4000
mXyQgbri,5000,6/3/2019,9900,mXyQgbri,33500,more than downpayment,more than downpayment,0,5000
mXyQgbri,5000,7/2/2019,9900,mXyQgbri,38500,more than downpayment,more than downpayment,0,5000
mXyQgbri,4500,7/26/2019,9900,mXyQgbri,43000,more than downpayment,more than downpayment,0,4500
mXyQgbri,8000,10/5/2019,9900,mXyQgbri,51000,more than downpayment,more than downpayment,0,8000
mXyQgbri,4500,12/20/2019,9900,mXyQgbri,55500,more than downpayment,more than downpayment,0,4500
Mylxqrh4,10500,8/5/2017,10000,,10500,more than downpayment,,10000,500
Mylxqrh4,3500,9/16/2017,10000,Mylxqrh4,14000,more than downpayment,more than downpayment,0,3500
Mylxqrh4,2200,2/19/2018,10000,Mylxqrh4,16200,more than downpayment,more than downpayment,0,2200
Mylxqrh4,5000,5/4/2018,10000,Mylxqrh4,21200,more than downpayment,more than downpayment,0,5000
Mylxqrh4,800,4/1/2019,10000,Mylxqrh4,22000,more than downpayment,more than downpayment,0,800
Mylxqrh4,500,4/20/2019,10000,Mylxqrh4,22500,more than downpayment,more than downpayment,0,500
Mylxqrh4,1000,5/9/2019,10000,Mylxqrh4,23500,more than downpayment,more than downpayment,0,1000
Mylxqrh4,1500,5/29/2019,10000,Mylxqrh4,25000,more than downpayment,more than downpayment,0,1500
Mylxqrh4,1500,7/4/2019,10000,Mylxqrh4,26500,more than downpayment,more than downpayment,0,1500
MZ4SHMLN,8900,12/6/2019,8900,,8900,equal to downpayment,,8900,0
MZ4SHMLN,3900,2/4/2020,8900,MZ4SHMLN,12800,more than downpayment,equal to downpayment,0,3900
MZlkX693,9000,7/16/2019,8900,,9000,more than downpayment,,8900,100
MZlkX693,3900,9/14/2019,8900,MZlkX693,12900,more than downpayment,more than downpayment,0,3900
MZlkX693,3900,10/17/2019,8900,MZlkX693,16800,more than downpayment,more than downpayment,0,3900
MZlkX693,3900,11/28/2019,8900,MZlkX693,20700,more than downpayment,more than downpayment,0,3900
MZlkX693,3900,12/28/2019,8900,MZlkX693,24600,more than downpayment,more than downpayment,0,3900
MZlkX693,3900,1/29/2020,8900,MZlkX693,28500,more than downpayment,more than downpayment,0,3900
N1JJY6DQ,4000,9/21/2019,9900,,4000,less than downpayment,,4000,0
N1JJY6DQ,1000,9/23/2019,9900,N1JJY6DQ,5000,less than downpayment,less than downpayment,1000,0
N1JJY6DQ,1000,9/26/2019,9900,N1JJY6DQ,6000,less than downpayment,less than downpayment,1000,0
N1JJY6DQ,3900,10/4/2019,9900,N1JJY6DQ,9900,equal to downpayment,less than downpayment,3900,0
N1JJY6DQ,2400,12/12/2019,9900,N1JJY6DQ,12300,more than downpayment,equal to downpayment,0,2400
N1JJY6DQ,4000,1/9/2020,9900,N1JJY6DQ,16300,more than downpayment,more than downpayment,0,4000
N1JJY6DQ,200,1/24/2020,9900,N1JJY6DQ,16500,more than downpayment,more than downpayment,0,200
N1N6YAWI,8900,1/10/2020,9900,,8900,less than downpayment,,8900,0
N1N6YAWI,1000,1/13/2020,9900,N1N6YAWI,9900,equal to downpayment,less than downpayment,1000,0
N2PAI58R,9900,10/29/2019,9900,,9900,equal to downpayment,,9900,0
N2PAI58R,3900,11/26/2019,9900,N2PAI58R,13800,more than downpayment,equal to downpayment,0,3900
N2PAI58R,3900,12/26/2019,9900,N2PAI58R,17700,more than downpayment,more than downpayment,0,3900
N2PAI58R,4000,1/25/2020,9900,N2PAI58R,21700,more than downpayment,more than downpayment,0,4000
n2ySvm5q,9900,11/10/2018,9900,,9900,equal to downpayment,,9900,0
n2ySvm5q,4500,2/22/2019,9900,n2ySvm5q,14400,more than downpayment,equal to downpayment,0,4500
N3S59ZJ4,8900,10/18/2019,8900,,8900,equal to downpayment,,8900,0
N3S59ZJ4,3000,11/30/2019,8900,N3S59ZJ4,11900,more than downpayment,equal to downpayment,0,3000
N3S59ZJ4,900,12/12/2019,8900,N3S59ZJ4,12800,more than downpayment,more than downpayment,0,900
N3S59ZJ4,2000,12/31/2019,8900,N3S59ZJ4,14800,more than downpayment,more than downpayment,0,2000
N3S59ZJ4,1900,1/15/2020,8900,N3S59ZJ4,16700,more than downpayment,more than downpayment,0,1900
N3S59ZJ4,1000,2/8/2020,8900,N3S59ZJ4,17700,more than downpayment,more than downpayment,0,1000
N3YATL4R,9900,1/3/2020,9900,,9900,equal to downpayment,,9900,0
N4CT5TXH,9900,1/2/2020,9900,,9900,equal to downpayment,,9900,0
N4CT5TXH,3900,2/3/2020,9900,N4CT5TXH,13800,more than downpayment,equal to downpayment,0,3900
N5LRQJVY,10000,12/26/2019,9900,,10000,more than downpayment,,9900,100
N6A7XJ52,9900,11/18/2019,9900,,9900,equal to downpayment,,9900,0
N6A7XJ52,3900,2/5/2020,9900,N6A7XJ52,13800,more than downpayment,equal to downpayment,0,3900
N6KLRPYS,9900,6/29/2019,8900,,9900,more than downpayment,,8900,1000
N7FZ4WX8,10000,9/9/2019,8900,,10000,more than downpayment,,8900,1100
N7FZ4WX8,3900,10/31/2019,8900,N7FZ4WX8,13900,more than downpayment,more than downpayment,0,3900
N7FZ4WX8,2800,1/4/2020,8900,N7FZ4WX8,16700,more than downpayment,more than downpayment,0,2800
N7FZ4WX8,3900,1/28/2020,8900,N7FZ4WX8,20600,more than downpayment,more than downpayment,0,3900
N7LMLC1C,8900,11/5/2019,8900,,8900,equal to downpayment,,8900,0
N7LMLC1C,3900,12/5/2019,8900,N7LMLC1C,12800,more than downpayment,equal to downpayment,0,3900
N81KZZTH,1594,10/14/2019,1594,,1594,equal to downpayment,,1594,0
N81KZZTH,3100,11/27/2019,1594,N81KZZTH,4694,more than downpayment,equal to downpayment,0,3100
N81KZZTH,3100,12/31/2019,1594,N81KZZTH,7794,more than downpayment,more than downpayment,0,3100
N81KZZTH,3100,1/27/2020,1594,N81KZZTH,10894,more than downpayment,more than downpayment,0,3100
N8KBgSB0,9900,11/2/2018,9900,,9900,equal to downpayment,,9900,0
N8KBgSB0,4500,12/22/2018,9900,N8KBgSB0,14400,more than downpayment,equal to downpayment,0,4500
N8KBgSB0,4500,2/5/2019,9900,N8KBgSB0,18900,more than downpayment,more than downpayment,0,4500
N8KBgSB0,2000,5/28/2019,9900,N8KBgSB0,20900,more than downpayment,more than downpayment,0,2000
N8KBgSB0,4500,12/11/2019,9900,N8KBgSB0,25400,more than downpayment,more than downpayment,0,4500
N9FH42RU,8900,12/9/2019,8900,,8900,equal to downpayment,,8900,0
N9NQ8FZ9,8900,1/25/2020,8900,,8900,equal to downpayment,,8900,0
n9OSE2ZE,8900,4/12/2019,8900,,8900,equal to downpayment,,8900,0
n9OSE2ZE,3900,5/28/2019,8900,n9OSE2ZE,12800,more than downpayment,equal to downpayment,0,3900
n9OSE2ZE,3900,6/29/2019,8900,n9OSE2ZE,16700,more than downpayment,more than downpayment,0,3900
n9OSE2ZE,3900,8/2/2019,8900,n9OSE2ZE,20600,more than downpayment,more than downpayment,0,3900
n9OSE2ZE,3900,8/27/2019,8900,n9OSE2ZE,24500,more than downpayment,more than downpayment,0,3900
n9OSE2ZE,3900,9/28/2019,8900,n9OSE2ZE,28400,more than downpayment,more than downpayment,0,3900
n9OSE2ZE,3900,11/19/2019,8900,n9OSE2ZE,32300,more than downpayment,more than downpayment,0,3900
n9OSE2ZE,3900,12/4/2019,8900,n9OSE2ZE,36200,more than downpayment,more than downpayment,0,3900
n9OSE2ZE,3900,1/16/2020,8900,n9OSE2ZE,40100,more than downpayment,more than downpayment,0,3900
n9Svip3y,10000,6/22/2017,10000,,10000,equal to downpayment,,10000,0
n9Svip3y,5000,2/26/2018,10000,n9Svip3y,15000,more than downpayment,equal to downpayment,0,5000
n9Svip3y,5000,4/12/2018,10000,n9Svip3y,20000,more than downpayment,more than downpayment,0,5000
NA4Y3AV5,8900,2/7/2020,8900,,8900,equal to downpayment,,8900,0
na83bbfM,8900,5/6/2019,8900,,8900,equal to downpayment,,8900,0
na83bbfM,3900,5/28/2019,8900,na83bbfM,12800,more than downpayment,equal to downpayment,0,3900
na83bbfM,3900,7/6/2019,8900,na83bbfM,16700,more than downpayment,more than downpayment,0,3900
na83bbfM,3900,8/9/2019,8900,na83bbfM,20600,more than downpayment,more than downpayment,0,3900
na83bbfM,3900,9/6/2019,8900,na83bbfM,24500,more than downpayment,more than downpayment,0,3900
na83bbfM,3900,10/1/2019,8900,na83bbfM,28400,more than downpayment,more than downpayment,0,3900
na83bbfM,3900,11/7/2019,8900,na83bbfM,32300,more than downpayment,more than downpayment,0,3900
na83bbfM,7800,12/2/2019,8900,na83bbfM,40100,more than downpayment,more than downpayment,0,7800
nAum57q4,7920,5/20/2017,10000,,7920,less than downpayment,,7920,0
nAum57q4,3170,6/14/2017,10000,nAum57q4,11090,more than downpayment,less than downpayment,2080,1090
nAum57q4,3170,7/22/2017,10000,nAum57q4,14260,more than downpayment,more than downpayment,0,3170
nAum57q4,6400,11/7/2017,10000,nAum57q4,20660,more than downpayment,more than downpayment,0,6400
nAum57q4,3200,12/31/2017,10000,nAum57q4,23860,more than downpayment,more than downpayment,0,3200
nAum57q4,3200,2/13/2018,10000,nAum57q4,27060,more than downpayment,more than downpayment,0,3200
nAum57q4,6400,2/24/2018,10000,nAum57q4,33460,more than downpayment,more than downpayment,0,6400
nAum57q4,3200,3/27/2018,10000,nAum57q4,36660,more than downpayment,more than downpayment,0,3200
nAum57q4,3200,4/18/2018,10000,nAum57q4,39860,more than downpayment,more than downpayment,0,3200
nAum57q4,3000,5/23/2018,10000,nAum57q4,42860,more than downpayment,more than downpayment,0,3000
nAum57q4,2140,6/25/2018,10000,nAum57q4,45000,more than downpayment,more than downpayment,0,2140
nAum57q4,200,6/4/2019,10000,nAum57q4,45200,more than downpayment,more than downpayment,0,200
NaWVUQMr,10000,11/28/2018,10000,,10000,equal to downpayment,,10000,0
NaWVUQMr,4500,1/5/2019,10000,NaWVUQMr,14500,more than downpayment,equal to downpayment,0,4500
NaWVUQMr,4500,2/5/2019,10000,NaWVUQMr,19000,more than downpayment,more than downpayment,0,4500
NaWVUQMr,4500,3/5/2019,10000,NaWVUQMr,23500,more than downpayment,more than downpayment,0,4500
NaWVUQMr,4500,4/5/2019,10000,NaWVUQMr,28000,more than downpayment,more than downpayment,0,4500
NaWVUQMr,4500,5/4/2019,10000,NaWVUQMr,32500,more than downpayment,more than downpayment,0,4500
NaWVUQMr,4500,6/14/2019,10000,NaWVUQMr,37000,more than downpayment,more than downpayment,0,4500
NaWVUQMr,4500,7/9/2019,10000,NaWVUQMr,41500,more than downpayment,more than downpayment,0,4500
NaWVUQMr,4500,8/7/2019,10000,NaWVUQMr,46000,more than downpayment,more than downpayment,0,4500
NaWVUQMr,4500,10/1/2019,10000,NaWVUQMr,50500,more than downpayment,more than downpayment,0,4500
NaWVUQMr,9000,11/30/2019,10000,NaWVUQMr,59500,more than downpayment,more than downpayment,0,9000
NaWVUQMr,4500,1/31/2020,10000,NaWVUQMr,64000,more than downpayment,more than downpayment,0,4500
NB3VVRFG,9900,11/22/2019,9900,,9900,equal to downpayment,,9900,0
NBIH9ZJT,5000,1/17/2020,4999,,5000,more than downpayment,,4999,1
NBVUObbW,25000,2/14/2019,0,,25000,more than downpayment,,0,25000
NBVUObbW,5000,3/14/2019,0,NBVUObbW,30000,more than downpayment,more than downpayment,0,5000
NBVUObbW,10000,4/10/2019,0,NBVUObbW,40000,more than downpayment,more than downpayment,0,10000
NBVUObbW,10000,5/12/2019,0,NBVUObbW,50000,more than downpayment,more than downpayment,0,10000
NBVUObbW,4000,6/8/2019,0,NBVUObbW,54000,more than downpayment,more than downpayment,0,4000
nC8yGx5b,8900,3/20/2019,8900,,8900,equal to downpayment,,8900,0
nC8yGx5b,4000,4/16/2019,8900,nC8yGx5b,12900,more than downpayment,equal to downpayment,0,4000
nC8yGx5b,4000,5/27/2019,8900,nC8yGx5b,16900,more than downpayment,more than downpayment,0,4000
nC8yGx5b,3000,6/20/2019,8900,nC8yGx5b,19900,more than downpayment,more than downpayment,0,3000
nC8yGx5b,1000,6/24/2019,8900,nC8yGx5b,20900,more than downpayment,more than downpayment,0,1000
nC8yGx5b,4000,7/25/2019,8900,nC8yGx5b,24900,more than downpayment,more than downpayment,0,4000
nC8yGx5b,4000,8/26/2019,8900,nC8yGx5b,28900,more than downpayment,more than downpayment,0,4000
nC8yGx5b,3900,9/24/2019,8900,nC8yGx5b,32800,more than downpayment,more than downpayment,0,3900
nC8yGx5b,4000,10/25/2019,8900,nC8yGx5b,36800,more than downpayment,more than downpayment,0,4000
nC8yGx5b,4000,11/21/2019,8900,nC8yGx5b,40800,more than downpayment,more than downpayment,0,4000
nC8yGx5b,2000,12/25/2019,8900,nC8yGx5b,42800,more than downpayment,more than downpayment,0,2000
nC8yGx5b,2000,12/29/2019,8900,nC8yGx5b,44800,more than downpayment,more than downpayment,0,2000
nC8yGx5b,4000,1/21/2020,8900,nC8yGx5b,48800,more than downpayment,more than downpayment,0,4000
NCBC5VKG,1600,10/14/2019,1594,,1600,more than downpayment,,1594,6
NCBC5VKG,3100,12/5/2019,1594,NCBC5VKG,4700,more than downpayment,more than downpayment,0,3100
NCBC5VKG,3100,1/8/2020,1594,NCBC5VKG,7800,more than downpayment,more than downpayment,0,3100
NcVePuZ9,8900,2/4/2019,8900,,8900,equal to downpayment,,8900,0
NcVePuZ9,3900,3/5/2019,8900,NcVePuZ9,12800,more than downpayment,equal to downpayment,0,3900
NcVePuZ9,3900,4/4/2019,8900,NcVePuZ9,16700,more than downpayment,more than downpayment,0,3900
NcVePuZ9,3900,5/4/2019,8900,NcVePuZ9,20600,more than downpayment,more than downpayment,0,3900
NcVePuZ9,3900,6/4/2019,8900,NcVePuZ9,24500,more than downpayment,more than downpayment,0,3900
NcVePuZ9,3900,7/4/2019,8900,NcVePuZ9,28400,more than downpayment,more than downpayment,0,3900
NcVePuZ9,3900,8/5/2019,8900,NcVePuZ9,32300,more than downpayment,more than downpayment,0,3900
NcVePuZ9,3900,9/4/2019,8900,NcVePuZ9,36200,more than downpayment,more than downpayment,0,3900
NcVePuZ9,3900,10/4/2019,8900,NcVePuZ9,40100,more than downpayment,more than downpayment,0,3900
NcVePuZ9,3900,11/5/2019,8900,NcVePuZ9,44000,more than downpayment,more than downpayment,0,3900
NcVePuZ9,3900,12/5/2019,8900,NcVePuZ9,47900,more than downpayment,more than downpayment,0,3900
NcVePuZ9,3900,1/7/2020,8900,NcVePuZ9,51800,more than downpayment,more than downpayment,0,3900
NcVePuZ9,3900,2/7/2020,8900,NcVePuZ9,55700,more than downpayment,more than downpayment,0,3900
ND9D781U,9900,6/7/2019,8900,,9900,more than downpayment,,8900,1000
ND9D781U,4000,7/5/2019,8900,ND9D781U,13900,more than downpayment,more than downpayment,0,4000
ND9D781U,4000,8/5/2019,8900,ND9D781U,17900,more than downpayment,more than downpayment,0,4000
ND9D781U,4000,9/6/2019,8900,ND9D781U,21900,more than downpayment,more than downpayment,0,4000
ND9D781U,4000,10/4/2019,8900,ND9D781U,25900,more than downpayment,more than downpayment,0,4000
ND9D781U,4000,11/9/2019,8900,ND9D781U,29900,more than downpayment,more than downpayment,0,4000
ND9D781U,3900,12/6/2019,8900,ND9D781U,33800,more than downpayment,more than downpayment,0,3900
ND9D781U,3900,1/7/2020,8900,ND9D781U,37700,more than downpayment,more than downpayment,0,3900
ND9D781U,3900,2/4/2020,8900,ND9D781U,41600,more than downpayment,more than downpayment,0,3900
NDD3Zlh2,9900,6/13/2019,8900,,9900,more than downpayment,,8900,1000
NDD3Zlh2,3900,9/26/2019,8900,NDD3Zlh2,13800,more than downpayment,more than downpayment,0,3900
NDD3Zlh2,3900,10/29/2019,8900,NDD3Zlh2,17700,more than downpayment,more than downpayment,0,3900
NDD3Zlh2,3900,12/2/2019,8900,NDD3Zlh2,21600,more than downpayment,more than downpayment,0,3900
NDD3Zlh2,3900,1/3/2020,8900,NDD3Zlh2,25500,more than downpayment,more than downpayment,0,3900
NDD3Zlh2,3900,1/28/2020,8900,NDD3Zlh2,29400,more than downpayment,more than downpayment,0,3900
NDrn2H6q,10000,2/21/2019,10000,,10000,equal to downpayment,,10000,0
NDrn2H6q,4500,3/25/2019,10000,NDrn2H6q,14500,more than downpayment,equal to downpayment,0,4500
NDrn2H6q,4500,4/5/2019,10000,NDrn2H6q,19000,more than downpayment,more than downpayment,0,4500
NDrn2H6q,13500,4/30/2019,10000,NDrn2H6q,32500,more than downpayment,more than downpayment,0,13500
NDrn2H6q,9000,10/6/2019,10000,NDrn2H6q,41500,more than downpayment,more than downpayment,0,9000
NDrn2H6q,4500,12/17/2019,10000,NDrn2H6q,46000,more than downpayment,more than downpayment,0,4500
NDrn2H6q,3200,12/23/2019,10000,NDrn2H6q,49200,more than downpayment,more than downpayment,0,3200
NDrn2H6q,1300,1/10/2020,10000,NDrn2H6q,50500,more than downpayment,more than downpayment,0,1300
NDrn2H6q,2200,1/25/2020,10000,NDrn2H6q,52700,more than downpayment,more than downpayment,0,2200
nEv3klCQ,10000,11/30/2018,10000,,10000,equal to downpayment,,10000,0
nEv3klCQ,4500,1/17/2019,10000,nEv3klCQ,14500,more than downpayment,equal to downpayment,0,4500
nEv3klCQ,4500,3/8/2019,10000,nEv3klCQ,19000,more than downpayment,more than downpayment,0,4500
nEv3klCQ,4500,3/22/2019,10000,nEv3klCQ,23500,more than downpayment,more than downpayment,0,4500
nEv3klCQ,4500,4/14/2019,10000,nEv3klCQ,28000,more than downpayment,more than downpayment,0,4500
nEv3klCQ,4500,5/25/2019,10000,nEv3klCQ,32500,more than downpayment,more than downpayment,0,4500
nEv3klCQ,4500,6/26/2019,10000,nEv3klCQ,37000,more than downpayment,more than downpayment,0,4500
nezbIaXp,10000,7/8/2017,10000,,10000,equal to downpayment,,10000,0
nezbIaXp,5000,8/8/2017,10000,nezbIaXp,15000,more than downpayment,equal to downpayment,0,5000
nezbIaXp,3500,9/25/2017,10000,nezbIaXp,18500,more than downpayment,more than downpayment,0,3500
nezbIaXp,3500,10/18/2017,10000,nezbIaXp,22000,more than downpayment,more than downpayment,0,3500
nezbIaXp,3500,11/15/2017,10000,nezbIaXp,25500,more than downpayment,more than downpayment,0,3500
nezbIaXp,7000,1/16/2018,10000,nezbIaXp,32500,more than downpayment,more than downpayment,0,7000
nezbIaXp,3500,2/21/2018,10000,nezbIaXp,36000,more than downpayment,more than downpayment,0,3500
nezbIaXp,3500,3/23/2018,10000,nezbIaXp,39500,more than downpayment,more than downpayment,0,3500
nezbIaXp,3500,4/18/2018,10000,nezbIaXp,43000,more than downpayment,more than downpayment,0,3500
nezbIaXp,2000,5/17/2018,10000,nezbIaXp,45000,more than downpayment,more than downpayment,0,2000
ng7pwkpu,12800,5/3/2019,8900,,12800,more than downpayment,,8900,3900
ng7pwkpu,3900,6/17/2019,8900,ng7pwkpu,16700,more than downpayment,more than downpayment,0,3900
ng7pwkpu,3900,7/18/2019,8900,ng7pwkpu,20600,more than downpayment,more than downpayment,0,3900
ng7pwkpu,3900,8/17/2019,8900,ng7pwkpu,24500,more than downpayment,more than downpayment,0,3900
ng7pwkpu,3900,10/29/2019,8900,ng7pwkpu,28400,more than downpayment,more than downpayment,0,3900
ng7pwkpu,3900,11/20/2019,8900,ng7pwkpu,32300,more than downpayment,more than downpayment,0,3900
nGcTnVhD,9900,10/31/2018,9900,,9900,equal to downpayment,,9900,0
nGcTnVhD,4500,12/10/2018,9900,nGcTnVhD,14400,more than downpayment,equal to downpayment,0,4500
nGcTnVhD,6000,1/7/2019,9900,nGcTnVhD,20400,more than downpayment,more than downpayment,0,6000
nGcTnVhD,4500,2/5/2019,9900,nGcTnVhD,24900,more than downpayment,more than downpayment,0,4500
nGcTnVhD,4500,3/5/2019,9900,nGcTnVhD,29400,more than downpayment,more than downpayment,0,4500
nGcTnVhD,4500,4/1/2019,9900,nGcTnVhD,33900,more than downpayment,more than downpayment,0,4500
nGcTnVhD,4500,5/6/2019,9900,nGcTnVhD,38400,more than downpayment,more than downpayment,0,4500
nGcTnVhD,4500,6/27/2019,9900,nGcTnVhD,42900,more than downpayment,more than downpayment,0,4500
nGcTnVhD,4500,7/9/2019,9900,nGcTnVhD,47400,more than downpayment,more than downpayment,0,4500
nGcTnVhD,4500,8/13/2019,9900,nGcTnVhD,51900,more than downpayment,more than downpayment,0,4500
nGcTnVhD,5000,8/28/2019,9900,nGcTnVhD,56900,more than downpayment,more than downpayment,0,5000
nGcTnVhD,4600,10/3/2019,9900,nGcTnVhD,61500,more than downpayment,more than downpayment,0,4600
nGcTnVhD,2400,11/1/2019,9900,nGcTnVhD,63900,more than downpayment,more than downpayment,0,2400
NHL7JQZC,9900,11/3/2019,9900,,9900,equal to downpayment,,9900,0
NHL7JQZC,3900,12/13/2019,9900,NHL7JQZC,13800,more than downpayment,equal to downpayment,0,3900
NHL7JQZC,3900,1/15/2020,9900,NHL7JQZC,17700,more than downpayment,more than downpayment,0,3900
NHSMSUPO,9900,7/31/2019,9900,,9900,equal to downpayment,,9900,0
NHSMSUPO,3900,9/28/2019,9900,NHSMSUPO,13800,more than downpayment,equal to downpayment,0,3900
NHSMSUPO,3900,10/31/2019,9900,NHSMSUPO,17700,more than downpayment,more than downpayment,0,3900
NHSMSUPO,3900,12/4/2019,9900,NHSMSUPO,21600,more than downpayment,more than downpayment,0,3900
NHSMSUPO,3900,1/9/2020,9900,NHSMSUPO,25500,more than downpayment,more than downpayment,0,3900
NHSMSUPO,3900,1/31/2020,9900,NHSMSUPO,29400,more than downpayment,more than downpayment,0,3900
NIGOA1S7,8900,12/23/2019,8900,,8900,equal to downpayment,,8900,0
NIW9DNTW,9900,1/2/2020,9900,,9900,equal to downpayment,,9900,0
nj1CYk1K,10000,11/13/2018,9900,,10000,more than downpayment,,9900,100
nj1CYk1K,4500,2/24/2019,9900,nj1CYk1K,14500,more than downpayment,more than downpayment,0,4500
nj1CYk1K,4500,3/5/2019,9900,nj1CYk1K,19000,more than downpayment,more than downpayment,0,4500
nj1CYk1K,4500,3/17/2019,9900,nj1CYk1K,23500,more than downpayment,more than downpayment,0,4500
nj1CYk1K,4500,4/26/2019,9900,nj1CYk1K,28000,more than downpayment,more than downpayment,0,4500
NJ53Z9SS,9900,11/5/2019,9900,,9900,equal to downpayment,,9900,0
NJ53Z9SS,3900,12/26/2019,9900,NJ53Z9SS,13800,more than downpayment,equal to downpayment,0,3900
NJ53Z9SS,3900,1/25/2020,9900,NJ53Z9SS,17700,more than downpayment,more than downpayment,0,3900
NJCCL33S,9900,7/2/2019,9900,,9900,equal to downpayment,,9900,0
NJCCL33S,4000,7/23/2019,9900,NJCCL33S,13900,more than downpayment,equal to downpayment,0,4000
NJCCL33S,4000,9/3/2019,9900,NJCCL33S,17900,more than downpayment,more than downpayment,0,4000
NJCCL33S,3900,10/5/2019,9900,NJCCL33S,21800,more than downpayment,more than downpayment,0,3900
NJCCL33S,3900,11/4/2019,9900,NJCCL33S,25700,more than downpayment,more than downpayment,0,3900
NJCCL33S,3700,1/30/2020,9900,NJCCL33S,29400,more than downpayment,more than downpayment,0,3700
NKIYP3IQ,9900,1/2/2020,9900,,9900,equal to downpayment,,9900,0
NKMJPO1G,9900,8/31/2019,9900,,9900,equal to downpayment,,9900,0
NKMJPO1G,3900,10/31/2019,9900,NKMJPO1G,13800,more than downpayment,equal to downpayment,0,3900
NKMJPO1G,3900,11/26/2019,9900,NKMJPO1G,17700,more than downpayment,more than downpayment,0,3900
NKMJPO1G,3900,1/15/2020,9900,NKMJPO1G,21600,more than downpayment,more than downpayment,0,3900
NKMJPO1G,3900,2/6/2020,9900,NKMJPO1G,25500,more than downpayment,more than downpayment,0,3900
nLClbNiX,8900,1/29/2019,8900,,8900,equal to downpayment,,8900,0
nLClbNiX,3900,3/8/2019,8900,nLClbNiX,12800,more than downpayment,equal to downpayment,0,3900
nLClbNiX,3900,4/6/2019,8900,nLClbNiX,16700,more than downpayment,more than downpayment,0,3900
nLClbNiX,3200,5/6/2019,8900,nLClbNiX,19900,more than downpayment,more than downpayment,0,3200
nLClbNiX,700,5/8/2019,8900,nLClbNiX,20600,more than downpayment,more than downpayment,0,700
nLClbNiX,3900,6/7/2019,8900,nLClbNiX,24500,more than downpayment,more than downpayment,0,3900
nLClbNiX,4000,7/5/2019,8900,nLClbNiX,28500,more than downpayment,more than downpayment,0,4000
nLClbNiX,3900,8/7/2019,8900,nLClbNiX,32400,more than downpayment,more than downpayment,0,3900
nLClbNiX,3900,9/6/2019,8900,nLClbNiX,36300,more than downpayment,more than downpayment,0,3900
nLClbNiX,3800,10/8/2019,8900,nLClbNiX,40100,more than downpayment,more than downpayment,0,3800
nLClbNiX,3900,11/6/2019,8900,nLClbNiX,44000,more than downpayment,more than downpayment,0,3900
nLClbNiX,3900,12/6/2019,8900,nLClbNiX,47900,more than downpayment,more than downpayment,0,3900
nLClbNiX,3900,1/29/2020,8900,nLClbNiX,51800,more than downpayment,more than downpayment,0,3900
Nlr01XbU,8900,8/26/2019,8900,,8900,equal to downpayment,,8900,0
Nlr01XbU,1100,10/10/2019,8900,Nlr01XbU,10000,more than downpayment,equal to downpayment,0,1100
Nlr01XbU,600,10/14/2019,8900,Nlr01XbU,10600,more than downpayment,more than downpayment,0,600
Nlr01XbU,1000,10/16/2019,8900,Nlr01XbU,11600,more than downpayment,more than downpayment,0,1000
Nlr01XbU,1500,10/22/2019,8900,Nlr01XbU,13100,more than downpayment,more than downpayment,0,1500
Nlr01XbU,600,10/23/2019,8900,Nlr01XbU,13700,more than downpayment,more than downpayment,0,600
Nlr01XbU,400,10/30/2019,8900,Nlr01XbU,14100,more than downpayment,more than downpayment,0,400
Nlr01XbU,1000,10/31/2019,8900,Nlr01XbU,15100,more than downpayment,more than downpayment,0,1000
Nlr01XbU,1000,11/12/2019,8900,Nlr01XbU,16100,more than downpayment,more than downpayment,0,1000
Nlr01XbU,300,11/14/2019,8900,Nlr01XbU,16400,more than downpayment,more than downpayment,0,300
Nlr01XbU,1000,11/20/2019,8900,Nlr01XbU,17400,more than downpayment,more than downpayment,0,1000
Nlr01XbU,1600,11/24/2019,8900,Nlr01XbU,19000,more than downpayment,more than downpayment,0,1600
Nlr01XbU,600,12/1/2019,8900,Nlr01XbU,19600,more than downpayment,more than downpayment,0,600
Nlr01XbU,1100,12/9/2019,8900,Nlr01XbU,20700,more than downpayment,more than downpayment,0,1100
Nlr01XbU,1500,12/13/2019,8900,Nlr01XbU,22200,more than downpayment,more than downpayment,0,1500
Nlr01XbU,1000,12/21/2019,8900,Nlr01XbU,23200,more than downpayment,more than downpayment,0,1000
Nlr01XbU,3000,12/30/2019,8900,Nlr01XbU,26200,more than downpayment,more than downpayment,0,3000
Nlr01XbU,1200,1/14/2020,8900,Nlr01XbU,27400,more than downpayment,more than downpayment,0,1200
Nlr01XbU,400,1/21/2020,8900,Nlr01XbU,27800,more than downpayment,more than downpayment,0,400
NmRxnkex,10000,5/22/2019,8900,,10000,more than downpayment,,8900,1100
NmRxnkex,3900,7/17/2019,8900,NmRxnkex,13900,more than downpayment,more than downpayment,0,3900
NmRxnkex,3900,8/27/2019,8900,NmRxnkex,17800,more than downpayment,more than downpayment,0,3900
NmRxnkex,3900,9/27/2019,8900,NmRxnkex,21700,more than downpayment,more than downpayment,0,3900
NmRxnkex,3900,10/31/2019,8900,NmRxnkex,25600,more than downpayment,more than downpayment,0,3900
NmRxnkex,2800,12/6/2019,8900,NmRxnkex,28400,more than downpayment,more than downpayment,0,2800
NmRxnkex,3900,1/6/2020,8900,NmRxnkex,32300,more than downpayment,more than downpayment,0,3900
NmRxnkex,3900,1/28/2020,8900,NmRxnkex,36200,more than downpayment,more than downpayment,0,3900
NMS78W6Z,8900,1/31/2020,8900,,8900,equal to downpayment,,8900,0
NMSGTDDF,8900,10/8/2019,8900,,8900,equal to downpayment,,8900,0
NMSGTDDF,3900,11/12/2019,8900,NMSGTDDF,12800,more than downpayment,equal to downpayment,0,3900
NMSGTDDF,3900,12/8/2019,8900,NMSGTDDF,16700,more than downpayment,more than downpayment,0,3900
NMSGTDDF,3900,1/16/2020,8900,NMSGTDDF,20600,more than downpayment,more than downpayment,0,3900
NN3TN9H3,9900,11/5/2019,9900,,9900,equal to downpayment,,9900,0
NN3TN9H3,3900,12/14/2019,9900,NN3TN9H3,13800,more than downpayment,equal to downpayment,0,3900
NN3TN9H3,3900,1/15/2020,9900,NN3TN9H3,17700,more than downpayment,more than downpayment,0,3900
NN84L1P9,9900,7/26/2019,9900,,9900,equal to downpayment,,9900,0
NN84L1P9,3900,9/5/2019,9900,NN84L1P9,13800,more than downpayment,equal to downpayment,0,3900
NN84L1P9,1000,2/1/2020,9900,NN84L1P9,14800,more than downpayment,more than downpayment,0,1000
NN96P8QL,9900,12/12/2019,9900,,9900,equal to downpayment,,9900,0
NN96P8QL,5000,2/1/2020,9900,NN96P8QL,14900,more than downpayment,equal to downpayment,0,5000
NNAAV23A,9900,1/30/2020,9900,,9900,equal to downpayment,,9900,0
NOCDU5XI,9900,10/9/2019,9900,,9900,equal to downpayment,,9900,0
NOCDU5XI,3900,12/5/2019,9900,NOCDU5XI,13800,more than downpayment,equal to downpayment,0,3900
NOCDU5XI,3900,1/10/2020,9900,NOCDU5XI,17700,more than downpayment,more than downpayment,0,3900
NOCDU5XI,3900,2/6/2020,9900,NOCDU5XI,21600,more than downpayment,more than downpayment,0,3900
NOX7YO5C,3900,2/3/2020,9900,,3900,less than downpayment,,3900,0
NPIAKTX6,8400,11/6/2019,9900,,8400,less than downpayment,,8400,0
NPIAKTX6,1500,11/16/2019,9900,NPIAKTX6,9900,equal to downpayment,less than downpayment,1500,0
NPIAKTX6,3900,1/15/2020,9900,NPIAKTX6,13800,more than downpayment,equal to downpayment,0,3900
NPizJEK0,9900,6/10/2019,8900,,9900,more than downpayment,,8900,1000
NPizJEK0,3900,8/7/2019,8900,NPizJEK0,13800,more than downpayment,more than downpayment,0,3900
NPizJEK0,3900,9/8/2019,8900,NPizJEK0,17700,more than downpayment,more than downpayment,0,3900
NPizJEK0,3900,10/8/2019,8900,NPizJEK0,21600,more than downpayment,more than downpayment,0,3900
NPizJEK0,3900,11/5/2019,8900,NPizJEK0,25500,more than downpayment,more than downpayment,0,3900
NPizJEK0,2450,12/9/2019,8900,NPizJEK0,27950,more than downpayment,more than downpayment,0,2450
NPizJEK0,1400,12/16/2019,8900,NPizJEK0,29350,more than downpayment,more than downpayment,0,1400
NPizJEK0,3900,12/22/2019,8900,NPizJEK0,33250,more than downpayment,more than downpayment,0,3900
NPizJEK0,3900,2/7/2020,8900,NPizJEK0,37150,more than downpayment,more than downpayment,0,3900
npo6q7Le,20000,2/4/2019,8900,,20000,more than downpayment,,8900,11100
npo6q7Le,20000,2/28/2019,8900,npo6q7Le,40000,more than downpayment,more than downpayment,0,20000
npo6q7Le,4000,12/5/2019,8900,npo6q7Le,44000,more than downpayment,more than downpayment,0,4000
npo6q7Le,3900,12/31/2019,8900,npo6q7Le,47900,more than downpayment,more than downpayment,0,3900
npo6q7Le,3900,1/29/2020,8900,npo6q7Le,51800,more than downpayment,more than downpayment,0,3900
NQBTVK12,9900,7/12/2019,9900,,9900,equal to downpayment,,9900,0
NQBTVK12,3900,8/24/2019,9900,NQBTVK12,13800,more than downpayment,equal to downpayment,0,3900
NQBTVK12,3900,9/27/2019,9900,NQBTVK12,17700,more than downpayment,more than downpayment,0,3900
NQBTVK12,3900,11/4/2019,9900,NQBTVK12,21600,more than downpayment,more than downpayment,0,3900
NQBTVK12,3900,12/10/2019,9900,NQBTVK12,25500,more than downpayment,more than downpayment,0,3900
NQBTVK12,7800,1/29/2020,9900,NQBTVK12,33300,more than downpayment,more than downpayment,0,7800
nqzgEG3D,9900,6/20/2019,9900,,9900,equal to downpayment,,9900,0
nqzgEG3D,3900,8/6/2019,9900,nqzgEG3D,13800,more than downpayment,equal to downpayment,0,3900
nqzgEG3D,3900,9/5/2019,9900,nqzgEG3D,17700,more than downpayment,more than downpayment,0,3900
nqzgEG3D,3900,10/7/2019,9900,nqzgEG3D,21600,more than downpayment,more than downpayment,0,3900
nqzgEG3D,3900,11/6/2019,9900,nqzgEG3D,25500,more than downpayment,more than downpayment,0,3900
nqzgEG3D,3900,12/11/2019,9900,nqzgEG3D,29400,more than downpayment,more than downpayment,0,3900
nqzgEG3D,3900,1/4/2020,9900,nqzgEG3D,33300,more than downpayment,more than downpayment,0,3900
nqzgEG3D,3900,2/5/2020,9900,nqzgEG3D,37200,more than downpayment,more than downpayment,0,3900
nR4CaXTF,10000,5/29/2019,8900,,10000,more than downpayment,,8900,1100
nR4CaXTF,5000,7/15/2019,8900,nR4CaXTF,15000,more than downpayment,more than downpayment,0,5000
nR4CaXTF,5000,8/19/2019,8900,nR4CaXTF,20000,more than downpayment,more than downpayment,0,5000
nR4CaXTF,4000,9/28/2019,8900,nR4CaXTF,24000,more than downpayment,more than downpayment,0,4000
nR4CaXTF,6000,10/14/2019,8900,nR4CaXTF,30000,more than downpayment,more than downpayment,0,6000
nR4CaXTF,2300,1/17/2020,8900,nR4CaXTF,32300,more than downpayment,more than downpayment,0,2300
nR4CaXTF,3900,1/29/2020,8900,nR4CaXTF,36200,more than downpayment,more than downpayment,0,3900
NS7FG8IL,6000,10/27/2019,9900,,6000,less than downpayment,,6000,0
NS7FG8IL,3900,11/3/2019,9900,NS7FG8IL,9900,equal to downpayment,less than downpayment,3900,0
NS7FG8IL,2600,12/31/2019,9900,NS7FG8IL,12500,more than downpayment,equal to downpayment,0,2600
NS7FG8IL,1300,1/14/2020,9900,NS7FG8IL,13800,more than downpayment,more than downpayment,0,1300
NS7FG8IL,450,1/23/2020,9900,NS7FG8IL,14250,more than downpayment,more than downpayment,0,450
NS7FG8IL,300,1/30/2020,9900,NS7FG8IL,14550,more than downpayment,more than downpayment,0,300
NS7FG8IL,1000,2/7/2020,9900,NS7FG8IL,15550,more than downpayment,more than downpayment,0,1000
NS7FG8IL,2150,2/8/2020,9900,NS7FG8IL,17700,more than downpayment,more than downpayment,0,2150
NS7FG8IL,130,2/9/2020,9900,NS7FG8IL,17830,more than downpayment,more than downpayment,0,130
NsdBTRwD,9900,6/11/2019,9900,,9900,equal to downpayment,,9900,0
NsdBTRwD,3900,6/26/2019,9900,NsdBTRwD,13800,more than downpayment,equal to downpayment,0,3900
NsdBTRwD,3400,7/25/2019,9900,NsdBTRwD,17200,more than downpayment,more than downpayment,0,3400
NsdBTRwD,3900,8/27/2019,9900,NsdBTRwD,21100,more than downpayment,more than downpayment,0,3900
NsdBTRwD,500,10/1/2019,9900,NsdBTRwD,21600,more than downpayment,more than downpayment,0,500
NsdBTRwD,3900,10/25/2019,9900,NsdBTRwD,25500,more than downpayment,more than downpayment,0,3900
NsdBTRwD,3900,11/26/2019,9900,NsdBTRwD,29400,more than downpayment,more than downpayment,0,3900
NsdBTRwD,3900,12/26/2019,9900,NsdBTRwD,33300,more than downpayment,more than downpayment,0,3900
NsdBTRwD,3900,2/3/2020,9900,NsdBTRwD,37200,more than downpayment,more than downpayment,0,3900
NSQD7RUP,1594,10/14/2019,1594,,1594,equal to downpayment,,1594,0
NSQD7RUP,3100,12/19/2019,1594,NSQD7RUP,4694,more than downpayment,equal to downpayment,0,3100
NSQD7RUP,3100,1/20/2020,1594,NSQD7RUP,7794,more than downpayment,more than downpayment,0,3100
NT97vet9,9900,6/3/2019,9900,,9900,equal to downpayment,,9900,0
nTvSAIUD,10000,8/14/2018,10000,,10000,equal to downpayment,,10000,0
nTvSAIUD,5000,9/12/2018,10000,nTvSAIUD,15000,more than downpayment,equal to downpayment,0,5000
nTvSAIUD,5000,9/26/2018,10000,nTvSAIUD,20000,more than downpayment,more than downpayment,0,5000
nTvSAIUD,5000,10/17/2018,10000,nTvSAIUD,25000,more than downpayment,more than downpayment,0,5000
nTvSAIUD,5000,11/15/2018,10000,nTvSAIUD,30000,more than downpayment,more than downpayment,0,5000
nTvSAIUD,5000,12/15/2018,10000,nTvSAIUD,35000,more than downpayment,more than downpayment,0,5000
nTvSAIUD,5000,1/18/2019,10000,nTvSAIUD,40000,more than downpayment,more than downpayment,0,5000
nTvSAIUD,5000,2/14/2019,10000,nTvSAIUD,45000,more than downpayment,more than downpayment,0,5000
nTvSAIUD,4500,3/14/2019,10000,nTvSAIUD,49500,more than downpayment,more than downpayment,0,4500
nTvSAIUD,4500,4/10/2019,10000,nTvSAIUD,54000,more than downpayment,more than downpayment,0,4500
nTvSAIUD,4500,5/14/2019,10000,nTvSAIUD,58500,more than downpayment,more than downpayment,0,4500
nTvSAIUD,5000,6/14/2019,10000,nTvSAIUD,63500,more than downpayment,more than downpayment,0,5000
nTvSAIUD,500,6/20/2019,10000,nTvSAIUD,64000,more than downpayment,more than downpayment,0,500
NUGMLJFE,9900,6/29/2019,1999,,9900,more than downpayment,,1999,7901
NUGMLJFE,2000,10/10/2019,1999,NUGMLJFE,11900,more than downpayment,more than downpayment,0,2000
NUGMLJFE,2000,11/25/2019,1999,NUGMLJFE,13900,more than downpayment,more than downpayment,0,2000
NUGMLJFE,2000,1/28/2020,1999,NUGMLJFE,15900,more than downpayment,more than downpayment,0,2000
nvWKyx7G,8900,5/16/2019,8900,,8900,equal to downpayment,,8900,0
nvWKyx7G,3900,6/21/2019,8900,nvWKyx7G,12800,more than downpayment,equal to downpayment,0,3900
nvWKyx7G,3900,7/22/2019,8900,nvWKyx7G,16700,more than downpayment,more than downpayment,0,3900
nvWKyx7G,3900,8/22/2019,8900,nvWKyx7G,20600,more than downpayment,more than downpayment,0,3900
nvWKyx7G,3900,9/25/2019,8900,nvWKyx7G,24500,more than downpayment,more than downpayment,0,3900
nvWKyx7G,3900,10/26/2019,8900,nvWKyx7G,28400,more than downpayment,more than downpayment,0,3900
nvWKyx7G,3900,11/28/2019,8900,nvWKyx7G,32300,more than downpayment,more than downpayment,0,3900
nvWKyx7G,3900,12/31/2019,8900,nvWKyx7G,36200,more than downpayment,more than downpayment,0,3900
nvWKyx7G,3900,2/7/2020,8900,nvWKyx7G,40100,more than downpayment,more than downpayment,0,3900
Nw0IVIYR,8900,4/17/2019,8900,,8900,equal to downpayment,,8900,0
Nw0IVIYR,7800,6/14/2019,8900,Nw0IVIYR,16700,more than downpayment,equal to downpayment,0,7800
Nw0IVIYR,3900,7/4/2019,8900,Nw0IVIYR,20600,more than downpayment,more than downpayment,0,3900
Nw0IVIYR,3900,8/20/2019,8900,Nw0IVIYR,24500,more than downpayment,more than downpayment,0,3900
Nw0IVIYR,3900,9/11/2019,8900,Nw0IVIYR,28400,more than downpayment,more than downpayment,0,3900
Nw0IVIYR,3900,10/14/2019,8900,Nw0IVIYR,32300,more than downpayment,more than downpayment,0,3900
Nw0IVIYR,3900,11/10/2019,8900,Nw0IVIYR,36200,more than downpayment,more than downpayment,0,3900
Nw0IVIYR,3900,1/1/2020,8900,Nw0IVIYR,40100,more than downpayment,more than downpayment,0,3900
NW2QLFWJ,10000,10/18/2019,9900,,10000,more than downpayment,,9900,100
NW2QLFWJ,5000,11/28/2019,9900,NW2QLFWJ,15000,more than downpayment,more than downpayment,0,5000
NW2QLFWJ,5000,12/24/2019,9900,NW2QLFWJ,20000,more than downpayment,more than downpayment,0,5000
NW2QLFWJ,4000,1/27/2020,9900,NW2QLFWJ,24000,more than downpayment,more than downpayment,0,4000
NWE1ADYX,6500,10/10/2019,9900,,6500,less than downpayment,,6500,0
NWE1ADYX,3400,10/11/2019,9900,NWE1ADYX,9900,equal to downpayment,less than downpayment,3400,0
NWE1ADYX,3900,12/6/2019,9900,NWE1ADYX,13800,more than downpayment,equal to downpayment,0,3900
NWE1ADYX,3900,1/9/2020,9900,NWE1ADYX,17700,more than downpayment,more than downpayment,0,3900
NWE1ADYX,1200,2/6/2020,9900,NWE1ADYX,18900,more than downpayment,more than downpayment,0,1200
NWYKIXL9,10000,6/29/2019,8900,,10000,more than downpayment,,8900,1100
NWYKIXL9,3900,8/8/2019,8900,NWYKIXL9,13900,more than downpayment,more than downpayment,0,3900
NWYKIXL9,3900,9/6/2019,8900,NWYKIXL9,17800,more than downpayment,more than downpayment,0,3900
NWYKIXL9,5000,10/4/2019,8900,NWYKIXL9,22800,more than downpayment,more than downpayment,0,5000
NWYKIXL9,3900,11/7/2019,8900,NWYKIXL9,26700,more than downpayment,more than downpayment,0,3900
NWYKIXL9,3900,12/7/2019,8900,NWYKIXL9,30600,more than downpayment,more than downpayment,0,3900
NWYKIXL9,3900,1/4/2020,8900,NWYKIXL9,34500,more than downpayment,more than downpayment,0,3900
NWYKIXL9,3900,2/5/2020,8900,NWYKIXL9,38400,more than downpayment,more than downpayment,0,3900
NX2lew2O,10000,11/7/2018,10000,,10000,equal to downpayment,,10000,0
NX2lew2O,4500,12/3/2018,10000,NX2lew2O,14500,more than downpayment,equal to downpayment,0,4500
NX2lew2O,4500,1/7/2019,10000,NX2lew2O,19000,more than downpayment,more than downpayment,0,4500
NX2lew2O,4500,2/6/2019,10000,NX2lew2O,23500,more than downpayment,more than downpayment,0,4500
NX2lew2O,4500,3/5/2019,10000,NX2lew2O,28000,more than downpayment,more than downpayment,0,4500
NX2lew2O,4500,4/5/2019,10000,NX2lew2O,32500,more than downpayment,more than downpayment,0,4500
NX2lew2O,4500,5/7/2019,10000,NX2lew2O,37000,more than downpayment,more than downpayment,0,4500
NX2lew2O,4500,6/6/2019,10000,NX2lew2O,41500,more than downpayment,more than downpayment,0,4500
NX2lew2O,4500,7/8/2019,10000,NX2lew2O,46000,more than downpayment,more than downpayment,0,4500
NX2lew2O,9000,9/2/2019,10000,NX2lew2O,55000,more than downpayment,more than downpayment,0,9000
NX2lew2O,5000,1/6/2020,10000,NX2lew2O,60000,more than downpayment,more than downpayment,0,5000
NX2lew2O,2000,1/21/2020,10000,NX2lew2O,62000,more than downpayment,more than downpayment,0,2000
NX2lew2O,1000,2/3/2020,10000,NX2lew2O,63000,more than downpayment,more than downpayment,0,1000
NX2lew2O,500,2/6/2020,10000,NX2lew2O,63500,more than downpayment,more than downpayment,0,500
NXB3KFOF,9000,12/27/2019,8900,,9000,more than downpayment,,8900,100
NXB3KFOF,3900,2/6/2020,8900,NXB3KFOF,12900,more than downpayment,more than downpayment,0,3900
NXIEv9rC,10000,5/11/2019,10000,,10000,equal to downpayment,,10000,0
NXIhDLzf,9900,7/29/2019,9900,,9900,equal to downpayment,,9900,0
NXIhDLzf,3900,9/5/2019,9900,NXIhDLzf,13800,more than downpayment,equal to downpayment,0,3900
NXIhDLzf,3900,10/3/2019,9900,NXIhDLzf,17700,more than downpayment,more than downpayment,0,3900
NXIhDLzf,3900,11/4/2019,9900,NXIhDLzf,21600,more than downpayment,more than downpayment,0,3900
NXIhDLzf,3900,12/3/2019,9900,NXIhDLzf,25500,more than downpayment,more than downpayment,0,3900
NXIhDLzf,3900,1/4/2020,9900,NXIhDLzf,29400,more than downpayment,more than downpayment,0,3900
NXIhDLzf,3900,2/3/2020,9900,NXIhDLzf,33300,more than downpayment,more than downpayment,0,3900
NY57JZPY,5900,12/7/2019,9900,,5900,less than downpayment,,5900,0
nynYwmso,10000,9/19/2018,10000,,10000,equal to downpayment,,10000,0
nynYwmso,4500,10/24/2018,10000,nynYwmso,14500,more than downpayment,equal to downpayment,0,4500
nynYwmso,4500,11/26/2018,10000,nynYwmso,19000,more than downpayment,more than downpayment,0,4500
nynYwmso,4500,12/27/2018,10000,nynYwmso,23500,more than downpayment,more than downpayment,0,4500
nynYwmso,4500,2/6/2019,10000,nynYwmso,28000,more than downpayment,more than downpayment,0,4500
nynYwmso,4500,2/13/2019,10000,nynYwmso,32500,more than downpayment,more than downpayment,0,4500
nynYwmso,9000,4/28/2019,10000,nynYwmso,41500,more than downpayment,more than downpayment,0,9000
nynYwmso,4500,6/24/2019,10000,nynYwmso,46000,more than downpayment,more than downpayment,0,4500
nynYwmso,10000,9/5/2019,10000,nynYwmso,56000,more than downpayment,more than downpayment,0,10000
NYQ8YWZB,9900,11/12/2019,9900,,9900,equal to downpayment,,9900,0
NYQ8YWZB,3900,12/16/2019,9900,NYQ8YWZB,13800,more than downpayment,equal to downpayment,0,3900
NYQ8YWZB,4000,1/25/2020,9900,NYQ8YWZB,17800,more than downpayment,more than downpayment,0,4000
NYTQNIJL,2000,6/27/2019,1999,,2000,more than downpayment,,1999,1
NYTQNIJL,4000,7/25/2019,1999,NYTQNIJL,6000,more than downpayment,more than downpayment,0,4000
NYTQNIJL,4000,8/22/2019,1999,NYTQNIJL,10000,more than downpayment,more than downpayment,0,4000
NYTQNIJL,27981,9/25/2019,1999,NYTQNIJL,37981,more than downpayment,more than downpayment,0,27981
NZQF4RKZ,9900,12/31/2018,9900,,9900,equal to downpayment,,9900,0
NZQF4RKZ,13500,5/12/2019,9900,NZQF4RKZ,23400,more than downpayment,equal to downpayment,0,13500
NZQF4RKZ,9000,6/11/2019,9900,NZQF4RKZ,32400,more than downpayment,more than downpayment,0,9000
NZQF4RKZ,4500,7/31/2019,9900,NZQF4RKZ,36900,more than downpayment,more than downpayment,0,4500
NZQF4RKZ,9000,9/27/2019,9900,NZQF4RKZ,45900,more than downpayment,more than downpayment,0,9000
NZQF4RKZ,9000,11/26/2019,9900,NZQF4RKZ,54900,more than downpayment,more than downpayment,0,9000
NZQF4RKZ,9000,1/13/2020,9900,NZQF4RKZ,63900,more than downpayment,more than downpayment,0,9000
O1ED23P3,9900,1/13/2020,9900,,9900,equal to downpayment,,9900,0
O1ED23P3,260,2/5/2020,9900,O1ED23P3,10160,more than downpayment,equal to downpayment,0,260
O1GHEVHD,7900,10/7/2019,7900,,7900,equal to downpayment,,7900,0
O1GHEVHD,3100,1/7/2020,7900,O1GHEVHD,11000,more than downpayment,equal to downpayment,0,3100
O1WWNDNW,9900,2/7/2020,9900,,9900,equal to downpayment,,9900,0
O22OTGR7,9900,12/10/2019,9900,,9900,equal to downpayment,,9900,0
O22OTGR7,115600,1/24/2020,9900,O22OTGR7,125500,more than downpayment,equal to downpayment,0,115600
O24COCUD,9900,11/6/2019,9900,,9900,equal to downpayment,,9900,0
O24COCUD,500,1/24/2020,9900,O24COCUD,10400,more than downpayment,equal to downpayment,0,500
O24COCUD,500,1/30/2020,9900,O24COCUD,10900,more than downpayment,more than downpayment,0,500
O24COCUD,5000,2/6/2020,9900,O24COCUD,15900,more than downpayment,more than downpayment,0,5000
O37KFWBL,9900,8/14/2019,9900,,9900,equal to downpayment,,9900,0
O37KFWBL,3900,11/4/2019,9900,O37KFWBL,13800,more than downpayment,equal to downpayment,0,3900
O37KFWBL,3900,12/4/2019,9900,O37KFWBL,17700,more than downpayment,more than downpayment,0,3900
O37KFWBL,3900,1/4/2020,9900,O37KFWBL,21600,more than downpayment,more than downpayment,0,3900
O37KFWBL,3900,2/5/2020,9900,O37KFWBL,25500,more than downpayment,more than downpayment,0,3900
O3JX9LHP,9900,12/29/2019,9900,,9900,equal to downpayment,,9900,0
O5DXUN7Y,9900,10/4/2019,9900,,9900,equal to downpayment,,9900,0
O5DXUN7Y,2000,12/24/2019,9900,O5DXUN7Y,11900,more than downpayment,equal to downpayment,0,2000
O5DXUN7Y,2000,1/18/2020,9900,O5DXUN7Y,13900,more than downpayment,more than downpayment,0,2000
O5DXUN7Y,3900,1/21/2020,9900,O5DXUN7Y,17800,more than downpayment,more than downpayment,0,3900
O5OHEIJA,9900,11/6/2019,9900,,9900,equal to downpayment,,9900,0
O5OHEIJA,3900,1/4/2020,9900,O5OHEIJA,13800,more than downpayment,equal to downpayment,0,3900
O5OHEIJA,3900,1/25/2020,9900,O5OHEIJA,17700,more than downpayment,more than downpayment,0,3900
o6kL9Ggn,10000,1/29/2019,8900,,10000,more than downpayment,,8900,1100
o6kL9Ggn,8000,1/30/2019,8900,o6kL9Ggn,18000,more than downpayment,more than downpayment,0,8000
o6kL9Ggn,4000,2/16/2019,8900,o6kL9Ggn,22000,more than downpayment,more than downpayment,0,4000
o6kL9Ggn,4000,3/4/2019,8900,o6kL9Ggn,26000,more than downpayment,more than downpayment,0,4000
o6kL9Ggn,6000,3/15/2019,8900,o6kL9Ggn,32000,more than downpayment,more than downpayment,0,6000
o6kL9Ggn,4000,3/29/2019,8900,o6kL9Ggn,36000,more than downpayment,more than downpayment,0,4000
o6kL9Ggn,12000,4/2/2019,8900,o6kL9Ggn,48000,more than downpayment,more than downpayment,0,12000
o6kL9Ggn,12000,4/18/2019,8900,o6kL9Ggn,60000,more than downpayment,more than downpayment,0,12000
o6kL9Ggn,3000,5/4/2019,8900,o6kL9Ggn,63000,more than downpayment,more than downpayment,0,3000
o6kL9Ggn,8000,6/2/2019,8900,o6kL9Ggn,71000,more than downpayment,more than downpayment,0,8000
o6kL9Ggn,4000,9/22/2019,8900,o6kL9Ggn,75000,more than downpayment,more than downpayment,0,4000
o6kL9Ggn,3900,10/22/2019,8900,o6kL9Ggn,78900,more than downpayment,more than downpayment,0,3900
o6kL9Ggn,4000,11/22/2019,8900,o6kL9Ggn,82900,more than downpayment,more than downpayment,0,4000
o6kL9Ggn,4000,12/24/2019,8900,o6kL9Ggn,86900,more than downpayment,more than downpayment,0,4000
o6kL9Ggn,4000,1/22/2020,8900,o6kL9Ggn,90900,more than downpayment,more than downpayment,0,4000
O6VXVPU5,2000,6/29/2019,1999,,2000,more than downpayment,,1999,1
O6VXVPU5,2000,8/1/2019,1999,O6VXVPU5,4000,more than downpayment,more than downpayment,0,2000
O6VXVPU5,2000,9/12/2019,1999,O6VXVPU5,6000,more than downpayment,more than downpayment,0,2000
O6VXVPU5,2000,10/23/2019,1999,O6VXVPU5,8000,more than downpayment,more than downpayment,0,2000
O6VXVPU5,2000,11/20/2019,1999,O6VXVPU5,10000,more than downpayment,more than downpayment,0,2000
O6VXVPU5,2000,12/19/2019,1999,O6VXVPU5,12000,more than downpayment,more than downpayment,0,2000
O6VXVPU5,2000,1/21/2020,1999,O6VXVPU5,14000,more than downpayment,more than downpayment,0,2000
O71djpge,10000,11/3/2018,10000,,10000,equal to downpayment,,10000,0
O71djpge,4500,12/30/2018,10000,O71djpge,14500,more than downpayment,equal to downpayment,0,4500
O71djpge,4500,1/25/2019,10000,O71djpge,19000,more than downpayment,more than downpayment,0,4500
O71djpge,4500,2/25/2019,10000,O71djpge,23500,more than downpayment,more than downpayment,0,4500
O71djpge,4500,3/28/2019,10000,O71djpge,28000,more than downpayment,more than downpayment,0,4500
O71djpge,4500,4/29/2019,10000,O71djpge,32500,more than downpayment,more than downpayment,0,4500
O71djpge,4500,5/28/2019,10000,O71djpge,37000,more than downpayment,more than downpayment,0,4500
O71djpge,4500,6/26/2019,10000,O71djpge,41500,more than downpayment,more than downpayment,0,4500
O71djpge,4500,7/29/2019,10000,O71djpge,46000,more than downpayment,more than downpayment,0,4500
O71djpge,4500,8/27/2019,10000,O71djpge,50500,more than downpayment,more than downpayment,0,4500
O71djpge,4500,10/7/2019,10000,O71djpge,55000,more than downpayment,more than downpayment,0,4500
O71djpge,4500,11/29/2019,10000,O71djpge,59500,more than downpayment,more than downpayment,0,4500
O71djpge,1500,12/20/2019,10000,O71djpge,61000,more than downpayment,more than downpayment,0,1500
O71djpge,3000,1/14/2020,10000,O71djpge,64000,more than downpayment,more than downpayment,0,3000
O7EUCNLK,10000,7/12/2019,8900,,10000,more than downpayment,,8900,1100
O7EUCNLK,4000,8/12/2019,8900,O7EUCNLK,14000,more than downpayment,more than downpayment,0,4000
O7EUCNLK,4000,9/30/2019,8900,O7EUCNLK,18000,more than downpayment,more than downpayment,0,4000
O7EUCNLK,7980,11/18/2019,8900,O7EUCNLK,25980,more than downpayment,more than downpayment,0,7980
O7EUCNLK,3900,12/23/2019,8900,O7EUCNLK,29880,more than downpayment,more than downpayment,0,3900
O7EUCNLK,7998,1/27/2020,8900,O7EUCNLK,37878,more than downpayment,more than downpayment,0,7998
o7YXtfqD,8900,4/8/2019,8900,,8900,equal to downpayment,,8900,0
o7YXtfqD,4000,5/11/2019,8900,o7YXtfqD,12900,more than downpayment,equal to downpayment,0,4000
o7YXtfqD,3900,5/30/2019,8900,o7YXtfqD,16800,more than downpayment,more than downpayment,0,3900
o7YXtfqD,300,7/22/2019,8900,o7YXtfqD,17100,more than downpayment,more than downpayment,0,300
o7YXtfqD,4000,7/30/2019,8900,o7YXtfqD,21100,more than downpayment,more than downpayment,0,4000
o7YXtfqD,1900,8/28/2019,8900,o7YXtfqD,23000,more than downpayment,more than downpayment,0,1900
o7YXtfqD,2000,9/3/2019,8900,o7YXtfqD,25000,more than downpayment,more than downpayment,0,2000
o7YXtfqD,5000,10/3/2019,8900,o7YXtfqD,30000,more than downpayment,more than downpayment,0,5000
o7YXtfqD,2300,10/31/2019,8900,o7YXtfqD,32300,more than downpayment,more than downpayment,0,2300
o7YXtfqD,3900,12/17/2019,8900,o7YXtfqD,36200,more than downpayment,more than downpayment,0,3900
o7YXtfqD,3900,1/15/2020,8900,o7YXtfqD,40100,more than downpayment,more than downpayment,0,3900
o7YXtfqD,1000,1/31/2020,8900,o7YXtfqD,41100,more than downpayment,more than downpayment,0,1000
o7YXtfqD,1000,2/5/2020,8900,o7YXtfqD,42100,more than downpayment,more than downpayment,0,1000
O8NAMXSJ,8900,11/16/2019,8900,,8900,equal to downpayment,,8900,0
O8NAMXSJ,3900,12/26/2019,8900,O8NAMXSJ,12800,more than downpayment,equal to downpayment,0,3900
O8pAp9kE,9900,6/8/2019,9900,,9900,equal to downpayment,,9900,0
O8pAp9kE,4000,7/22/2019,9900,O8pAp9kE,13900,more than downpayment,equal to downpayment,0,4000
O8pAp9kE,4000,8/23/2019,9900,O8pAp9kE,17900,more than downpayment,more than downpayment,0,4000
O8pAp9kE,4000,9/24/2019,9900,O8pAp9kE,21900,more than downpayment,more than downpayment,0,4000
O8pAp9kE,4000,10/22/2019,9900,O8pAp9kE,25900,more than downpayment,more than downpayment,0,4000
O8pAp9kE,2700,11/23/2019,9900,O8pAp9kE,28600,more than downpayment,more than downpayment,0,2700
O8pAp9kE,1300,11/25/2019,9900,O8pAp9kE,29900,more than downpayment,more than downpayment,0,1300
O8pAp9kE,2000,12/26/2019,9900,O8pAp9kE,31900,more than downpayment,more than downpayment,0,2000
O8pAp9kE,1000,12/28/2019,9900,O8pAp9kE,32900,more than downpayment,more than downpayment,0,1000
O8pAp9kE,1000,12/30/2019,9900,O8pAp9kE,33900,more than downpayment,more than downpayment,0,1000
O8pAp9kE,2330,1/26/2020,9900,O8pAp9kE,36230,more than downpayment,more than downpayment,0,2330
O8pAp9kE,150,1/27/2020,9900,O8pAp9kE,36380,more than downpayment,more than downpayment,0,150
O8pAp9kE,1500,1/28/2020,9900,O8pAp9kE,37880,more than downpayment,more than downpayment,0,1500
O8pAp9kE,500,2/9/2020,9900,O8pAp9kE,38380,more than downpayment,more than downpayment,0,500
O8Q1EDEM,9900,12/21/2019,9900,,9900,equal to downpayment,,9900,0
O8W3QUTS,40,12/20/2019,8900,,40,less than downpayment,,40,0
o9RhmPXD,10000,8/20/2018,0,,10000,more than downpayment,,0,10000
o9RhmPXD,4500,9/23/2018,0,o9RhmPXD,14500,more than downpayment,more than downpayment,0,4500
o9RhmPXD,4500,10/25/2018,0,o9RhmPXD,19000,more than downpayment,more than downpayment,0,4500
o9RhmPXD,4500,11/29/2018,0,o9RhmPXD,23500,more than downpayment,more than downpayment,0,4500
o9RhmPXD,4500,12/29/2018,0,o9RhmPXD,28000,more than downpayment,more than downpayment,0,4500
o9RhmPXD,4500,1/24/2019,0,o9RhmPXD,32500,more than downpayment,more than downpayment,0,4500
o9RhmPXD,4500,2/25/2019,0,o9RhmPXD,37000,more than downpayment,more than downpayment,0,4500
o9RhmPXD,4500,3/26/2019,0,o9RhmPXD,41500,more than downpayment,more than downpayment,0,4500
o9RhmPXD,4500,4/26/2019,0,o9RhmPXD,46000,more than downpayment,more than downpayment,0,4500
o9RhmPXD,4500,5/28/2019,0,o9RhmPXD,50500,more than downpayment,more than downpayment,0,4500
o9RhmPXD,4500,6/27/2019,0,o9RhmPXD,55000,more than downpayment,more than downpayment,0,4500
o9RhmPXD,4500,7/29/2019,0,o9RhmPXD,59500,more than downpayment,more than downpayment,0,4500
o9RhmPXD,4500,8/30/2019,0,o9RhmPXD,64000,more than downpayment,more than downpayment,0,4500
O9T6AE24,9900,9/14/2019,9900,,9900,equal to downpayment,,9900,0
O9T6AE24,500,10/18/2019,9900,O9T6AE24,10400,more than downpayment,equal to downpayment,0,500
O9T6AE24,2000,10/23/2019,9900,O9T6AE24,12400,more than downpayment,more than downpayment,0,2000
O9T6AE24,1400,11/2/2019,9900,O9T6AE24,13800,more than downpayment,more than downpayment,0,1400
O9T6AE24,3900,12/14/2019,9900,O9T6AE24,17700,more than downpayment,more than downpayment,0,3900
O9T6AE24,3900,1/20/2020,9900,O9T6AE24,21600,more than downpayment,more than downpayment,0,3900
O9ZGFJJ2,8900,1/10/2020,9900,,8900,less than downpayment,,8900,0
O9ZGFJJ2,1000,1/30/2020,9900,O9ZGFJJ2,9900,equal to downpayment,less than downpayment,1000,0
OaANJn16,9600,8/20/2018,9900,,9600,less than downpayment,,9600,0
OaANJn16,9900,4/24/2019,9900,OaANJn16,19500,more than downpayment,less than downpayment,300,9600
OaANJn16,4500,5/24/2019,9900,OaANJn16,24000,more than downpayment,more than downpayment,0,4500
OaANJn16,4500,6/24/2019,9900,OaANJn16,28500,more than downpayment,more than downpayment,0,4500
OaANJn16,4500,7/27/2019,9900,OaANJn16,33000,more than downpayment,more than downpayment,0,4500
OaANJn16,4500,8/26/2019,9900,OaANJn16,37500,more than downpayment,more than downpayment,0,4500
OaANJn16,4500,9/24/2019,9900,OaANJn16,42000,more than downpayment,more than downpayment,0,4500
OaANJn16,4500,10/28/2019,9900,OaANJn16,46500,more than downpayment,more than downpayment,0,4500
OaANJn16,4500,11/25/2019,9900,OaANJn16,51000,more than downpayment,more than downpayment,0,4500
OaANJn16,4500,1/3/2020,9900,OaANJn16,55500,more than downpayment,more than downpayment,0,4500
OAWHGoRN,10000,6/4/2017,10000,,10000,equal to downpayment,,10000,0
OAWHGoRN,3000,7/3/2017,10000,OAWHGoRN,13000,more than downpayment,equal to downpayment,0,3000
OAWHGoRN,3000,8/1/2017,10000,OAWHGoRN,16000,more than downpayment,more than downpayment,0,3000
OAWHGoRN,3000,9/4/2017,10000,OAWHGoRN,19000,more than downpayment,more than downpayment,0,3000
OAWHGoRN,2000,10/4/2017,10000,OAWHGoRN,21000,more than downpayment,more than downpayment,0,2000
OAWHGoRN,2000,11/6/2017,10000,OAWHGoRN,23000,more than downpayment,more than downpayment,0,2000
OAWHGoRN,4000,12/11/2017,10000,OAWHGoRN,27000,more than downpayment,more than downpayment,0,4000
OAWHGoRN,2000,1/5/2018,10000,OAWHGoRN,29000,more than downpayment,more than downpayment,0,2000
OAWHGoRN,3000,3/8/2018,10000,OAWHGoRN,32000,more than downpayment,more than downpayment,0,3000
OAWHGoRN,3000,4/2/2018,10000,OAWHGoRN,35000,more than downpayment,more than downpayment,0,3000
OAWHGoRN,5000,8/20/2018,10000,OAWHGoRN,40000,more than downpayment,more than downpayment,0,5000
OBAQE3UO,8900,5/24/2019,8900,,8900,equal to downpayment,,8900,0
OBAQE3UO,3900,7/12/2019,8900,OBAQE3UO,12800,more than downpayment,equal to downpayment,0,3900
OBAQE3UO,3900,7/25/2019,8900,OBAQE3UO,16700,more than downpayment,more than downpayment,0,3900
OBAQE3UO,3900,9/5/2019,8900,OBAQE3UO,20600,more than downpayment,more than downpayment,0,3900
OBAQE3UO,3900,10/4/2019,8900,OBAQE3UO,24500,more than downpayment,more than downpayment,0,3900
OBAQE3UO,3900,10/28/2019,8900,OBAQE3UO,28400,more than downpayment,more than downpayment,0,3900
OBAQE3UO,3900,11/19/2019,8900,OBAQE3UO,32300,more than downpayment,more than downpayment,0,3900
OBAQE3UO,3900,12/18/2019,8900,OBAQE3UO,36200,more than downpayment,more than downpayment,0,3900
OBAQE3UO,3900,1/3/2020,8900,OBAQE3UO,40100,more than downpayment,more than downpayment,0,3900
OBAQE3UO,3900,1/29/2020,8900,OBAQE3UO,44000,more than downpayment,more than downpayment,0,3900
OBcdmMnv,4500,4/15/2019,8900,,4500,less than downpayment,,4500,0
OBlGouxa,9900,11/23/2018,9900,,9900,equal to downpayment,,9900,0
OBlGouxa,4100,11/29/2018,9900,OBlGouxa,14000,more than downpayment,equal to downpayment,0,4100
OBlGouxa,4500,12/24/2018,9900,OBlGouxa,18500,more than downpayment,more than downpayment,0,4500
OBlGouxa,4500,1/24/2019,9900,OBlGouxa,23000,more than downpayment,more than downpayment,0,4500
OBlGouxa,4500,2/21/2019,9900,OBlGouxa,27500,more than downpayment,more than downpayment,0,4500
OBlGouxa,4500,4/5/2019,9900,OBlGouxa,32000,more than downpayment,more than downpayment,0,4500
OBlGouxa,4500,4/28/2019,9900,OBlGouxa,36500,more than downpayment,more than downpayment,0,4500
OBlGouxa,12500,9/22/2019,9900,OBlGouxa,49000,more than downpayment,more than downpayment,0,12500
OBR6qiLC,10000,1/10/2019,10000,,10000,equal to downpayment,,10000,0
OBR6qiLC,4500,2/11/2019,10000,OBR6qiLC,14500,more than downpayment,equal to downpayment,0,4500
OBR6qiLC,2000,4/3/2019,10000,OBR6qiLC,16500,more than downpayment,more than downpayment,0,2000
OBR6qiLC,3000,4/25/2019,10000,OBR6qiLC,19500,more than downpayment,more than downpayment,0,3000
OBR6qiLC,2000,5/23/2019,10000,OBR6qiLC,21500,more than downpayment,more than downpayment,0,2000
OBR6qiLC,2000,5/30/2019,10000,OBR6qiLC,23500,more than downpayment,more than downpayment,0,2000
OBR6qiLC,2000,6/20/2019,10000,OBR6qiLC,25500,more than downpayment,more than downpayment,0,2000
Obw3tgsN,10000,9/26/2017,10000,,10000,equal to downpayment,,10000,0
Obw3tgsN,5000,11/16/2017,10000,Obw3tgsN,15000,more than downpayment,equal to downpayment,0,5000
Obw3tgsN,3500,12/31/2017,10000,Obw3tgsN,18500,more than downpayment,more than downpayment,0,3500
Obw3tgsN,5000,1/17/2018,10000,Obw3tgsN,23500,more than downpayment,more than downpayment,0,5000
Obw3tgsN,10000,2/13/2018,10000,Obw3tgsN,33500,more than downpayment,more than downpayment,0,10000
Obw3tgsN,3500,4/17/2018,10000,Obw3tgsN,37000,more than downpayment,more than downpayment,0,3500
Obw3tgsN,4000,5/26/2018,10000,Obw3tgsN,41000,more than downpayment,more than downpayment,0,4000
Obw3tgsN,4500,6/21/2018,10000,Obw3tgsN,45500,more than downpayment,more than downpayment,0,4500
Obw3tgsN,5000,8/31/2018,10000,Obw3tgsN,50500,more than downpayment,more than downpayment,0,5000
Obw3tgsN,1500,10/1/2018,10000,Obw3tgsN,52000,more than downpayment,more than downpayment,0,1500
oc6Ploq0,8900,2/4/2019,8900,,8900,equal to downpayment,,8900,0
oc6Ploq0,4000,3/14/2019,8900,oc6Ploq0,12900,more than downpayment,equal to downpayment,0,4000
oc6Ploq0,1000,3/27/2019,8900,oc6Ploq0,13900,more than downpayment,more than downpayment,0,1000
oc6Ploq0,3000,4/14/2019,8900,oc6Ploq0,16900,more than downpayment,more than downpayment,0,3000
oc6Ploq0,2000,4/30/2019,8900,oc6Ploq0,18900,more than downpayment,more than downpayment,0,2000
oc6Ploq0,4000,5/15/2019,8900,oc6Ploq0,22900,more than downpayment,more than downpayment,0,4000
oc6Ploq0,4000,6/13/2019,8900,oc6Ploq0,26900,more than downpayment,more than downpayment,0,4000
oc6Ploq0,4000,7/12/2019,8900,oc6Ploq0,30900,more than downpayment,more than downpayment,0,4000
oc6Ploq0,4000,8/15/2019,8900,oc6Ploq0,34900,more than downpayment,more than downpayment,0,4000
oc6Ploq0,4000,9/15/2019,8900,oc6Ploq0,38900,more than downpayment,more than downpayment,0,4000
oc6Ploq0,4000,10/14/2019,8900,oc6Ploq0,42900,more than downpayment,more than downpayment,0,4000
oc6Ploq0,4000,11/14/2019,8900,oc6Ploq0,46900,more than downpayment,more than downpayment,0,4000
oc6Ploq0,3500,12/15/2019,8900,oc6Ploq0,50400,more than downpayment,more than downpayment,0,3500
oc6Ploq0,3900,1/16/2020,8900,oc6Ploq0,54300,more than downpayment,more than downpayment,0,3900
OCTiWRix,9900,1/13/2019,8900,,9900,more than downpayment,,8900,1000
OCTiWRix,5900,2/13/2019,8900,OCTiWRix,15800,more than downpayment,more than downpayment,0,5900
OCTiWRix,3900,3/28/2019,8900,OCTiWRix,19700,more than downpayment,more than downpayment,0,3900
OCTiWRix,3900,4/25/2019,8900,OCTiWRix,23600,more than downpayment,more than downpayment,0,3900
OCTiWRix,4000,5/24/2019,8900,OCTiWRix,27600,more than downpayment,more than downpayment,0,4000
OCTiWRix,3900,6/27/2019,8900,OCTiWRix,31500,more than downpayment,more than downpayment,0,3900
OCTiWRix,3900,7/24/2019,8900,OCTiWRix,35400,more than downpayment,more than downpayment,0,3900
OCTiWRix,3900,8/28/2019,8900,OCTiWRix,39300,more than downpayment,more than downpayment,0,3900
OCTiWRix,3900,9/25/2019,8900,OCTiWRix,43200,more than downpayment,more than downpayment,0,3900
OCTiWRix,3900,10/25/2019,8900,OCTiWRix,47100,more than downpayment,more than downpayment,0,3900
OCTiWRix,3900,11/25/2019,8900,OCTiWRix,51000,more than downpayment,more than downpayment,0,3900
OCTiWRix,3900,1/6/2020,8900,OCTiWRix,54900,more than downpayment,more than downpayment,0,3900
OCTiWRix,3900,1/30/2020,8900,OCTiWRix,58800,more than downpayment,more than downpayment,0,3900
oCwKQ1DI,10000,3/7/2019,10000,,10000,equal to downpayment,,10000,0
OcXWFQ1e,8900,2/5/2019,8900,,8900,equal to downpayment,,8900,0
OcXWFQ1e,3900,3/14/2019,8900,OcXWFQ1e,12800,more than downpayment,equal to downpayment,0,3900
OcXWFQ1e,3900,4/16/2019,8900,OcXWFQ1e,16700,more than downpayment,more than downpayment,0,3900
OcXWFQ1e,3900,5/22/2019,8900,OcXWFQ1e,20600,more than downpayment,more than downpayment,0,3900
OcXWFQ1e,3900,6/28/2019,8900,OcXWFQ1e,24500,more than downpayment,more than downpayment,0,3900
OcXWFQ1e,3900,7/21/2019,8900,OcXWFQ1e,28400,more than downpayment,more than downpayment,0,3900
OcXWFQ1e,3900,8/19/2019,8900,OcXWFQ1e,32300,more than downpayment,more than downpayment,0,3900
OcXWFQ1e,3900,9/21/2019,8900,OcXWFQ1e,36200,more than downpayment,more than downpayment,0,3900
OcXWFQ1e,3900,10/24/2019,8900,OcXWFQ1e,40100,more than downpayment,more than downpayment,0,3900
OcXWFQ1e,3900,12/6/2019,8900,OcXWFQ1e,44000,more than downpayment,more than downpayment,0,3900
OcXWFQ1e,1950,12/30/2019,8900,OcXWFQ1e,45950,more than downpayment,more than downpayment,0,1950
OcXWFQ1e,1700,1/6/2020,8900,OcXWFQ1e,47650,more than downpayment,more than downpayment,0,1700
OcXWFQ1e,250,1/15/2020,8900,OcXWFQ1e,47900,more than downpayment,more than downpayment,0,250
OcXWFQ1e,3900,1/25/2020,8900,OcXWFQ1e,51800,more than downpayment,more than downpayment,0,3900
OdBsrxXH,8900,4/23/2019,8900,,8900,equal to downpayment,,8900,0
OdBsrxXH,3900,7/13/2019,8900,OdBsrxXH,12800,more than downpayment,equal to downpayment,0,3900
OdBsrxXH,3900,9/28/2019,8900,OdBsrxXH,16700,more than downpayment,more than downpayment,0,3900
OdBsrxXH,3990,11/25/2019,8900,OdBsrxXH,20690,more than downpayment,more than downpayment,0,3990
OdBsrxXH,2000,12/14/2019,8900,OdBsrxXH,22690,more than downpayment,more than downpayment,0,2000
OdBsrxXH,4000,12/23/2019,8900,OdBsrxXH,26690,more than downpayment,more than downpayment,0,4000
OdBsrxXH,4000,1/8/2020,8900,OdBsrxXH,30690,more than downpayment,more than downpayment,0,4000
OdBsrxXH,2000,1/20/2020,8900,OdBsrxXH,32690,more than downpayment,more than downpayment,0,2000
OdBsrxXH,2000,1/26/2020,8900,OdBsrxXH,34690,more than downpayment,more than downpayment,0,2000
OdBsrxXH,2000,1/30/2020,8900,OdBsrxXH,36690,more than downpayment,more than downpayment,0,2000
OdBsrxXH,5000,1/31/2020,8900,OdBsrxXH,41690,more than downpayment,more than downpayment,0,5000
OEAKAUFE,20000,9/11/2019,9900,,20000,more than downpayment,,9900,10100
OEAKAUFE,4000,12/8/2019,9900,OEAKAUFE,24000,more than downpayment,more than downpayment,0,4000
OEAKAUFE,4000,1/10/2020,9900,OEAKAUFE,28000,more than downpayment,more than downpayment,0,4000
OEAKAUFE,4000,2/8/2020,9900,OEAKAUFE,32000,more than downpayment,more than downpayment,0,4000
OEC6PCPR,9900,7/3/2019,9900,,9900,equal to downpayment,,9900,0
OEC6PCPR,3900,8/2/2019,9900,OEC6PCPR,13800,more than downpayment,equal to downpayment,0,3900
OEC6PCPR,3900,9/5/2019,9900,OEC6PCPR,17700,more than downpayment,more than downpayment,0,3900
OEC6PCPR,3900,10/1/2019,9900,OEC6PCPR,21600,more than downpayment,more than downpayment,0,3900
OEC6PCPR,3900,11/5/2019,9900,OEC6PCPR,25500,more than downpayment,more than downpayment,0,3900
OEC6PCPR,3900,12/5/2019,9900,OEC6PCPR,29400,more than downpayment,more than downpayment,0,3900
OEC6PCPR,3900,1/4/2020,9900,OEC6PCPR,33300,more than downpayment,more than downpayment,0,3900
OEC6PCPR,3900,2/5/2020,9900,OEC6PCPR,37200,more than downpayment,more than downpayment,0,3900
OEKAvFn4,10000,5/2/2019,10000,,10000,equal to downpayment,,10000,0
OEKAvFn4,4500,5/24/2019,10000,OEKAvFn4,14500,more than downpayment,equal to downpayment,0,4500
OEKAvFn4,4500,6/19/2019,10000,OEKAvFn4,19000,more than downpayment,more than downpayment,0,4500
OEKAvFn4,4500,7/19/2019,10000,OEKAvFn4,23500,more than downpayment,more than downpayment,0,4500
OEKAvFn4,4500,8/22/2019,10000,OEKAvFn4,28000,more than downpayment,more than downpayment,0,4500
OEKAvFn4,4500,9/24/2019,10000,OEKAvFn4,32500,more than downpayment,more than downpayment,0,4500
OG52TIL5,5000,12/18/2019,4999,,5000,more than downpayment,,4999,1
OG8Y1Q35,9900,1/2/2020,9900,,9900,equal to downpayment,,9900,0
ogOMLKGI,8900,1/9/2019,8900,,8900,equal to downpayment,,8900,0
ogOMLKGI,3900,2/20/2019,8900,ogOMLKGI,12800,more than downpayment,equal to downpayment,0,3900
ogOMLKGI,3900,3/28/2019,8900,ogOMLKGI,16700,more than downpayment,more than downpayment,0,3900
ogOMLKGI,3900,5/10/2019,8900,ogOMLKGI,20600,more than downpayment,more than downpayment,0,3900
ogOMLKGI,3900,5/30/2019,8900,ogOMLKGI,24500,more than downpayment,more than downpayment,0,3900
ogOMLKGI,2000,6/28/2019,8900,ogOMLKGI,26500,more than downpayment,more than downpayment,0,2000
ogOMLKGI,3000,8/4/2019,8900,ogOMLKGI,29500,more than downpayment,more than downpayment,0,3000
ogOMLKGI,2800,8/5/2019,8900,ogOMLKGI,32300,more than downpayment,more than downpayment,0,2800
ogOMLKGI,3900,8/31/2019,8900,ogOMLKGI,36200,more than downpayment,more than downpayment,0,3900
ogOMLKGI,3900,10/2/2019,8900,ogOMLKGI,40100,more than downpayment,more than downpayment,0,3900
ogOMLKGI,3900,11/2/2019,8900,ogOMLKGI,44000,more than downpayment,more than downpayment,0,3900
ogOMLKGI,3900,12/10/2019,8900,ogOMLKGI,47900,more than downpayment,more than downpayment,0,3900
ogOMLKGI,3900,1/1/2020,8900,ogOMLKGI,51800,more than downpayment,more than downpayment,0,3900
ogOMLKGI,3900,1/29/2020,8900,ogOMLKGI,55700,more than downpayment,more than downpayment,0,3900
oHKHSl3h,8900,8/3/2019,8900,,8900,equal to downpayment,,8900,0
oHKHSl3h,3900,10/2/2019,8900,oHKHSl3h,12800,more than downpayment,equal to downpayment,0,3900
oHKHSl3h,3900,11/7/2019,8900,oHKHSl3h,16700,more than downpayment,more than downpayment,0,3900
oHKHSl3h,3900,12/10/2019,8900,oHKHSl3h,20600,more than downpayment,more than downpayment,0,3900
oHKHSl3h,3900,1/6/2020,8900,oHKHSl3h,24500,more than downpayment,more than downpayment,0,3900
oHKHSl3h,3900,2/7/2020,8900,oHKHSl3h,28400,more than downpayment,more than downpayment,0,3900
OHZSGNRG,9900,7/12/2019,9900,,9900,equal to downpayment,,9900,0
OHZSGNRG,4000,10/14/2019,9900,OHZSGNRG,13900,more than downpayment,equal to downpayment,0,4000
OHZSGNRG,4000,11/12/2019,9900,OHZSGNRG,17900,more than downpayment,more than downpayment,0,4000
OHZSGNRG,4000,12/13/2019,9900,OHZSGNRG,21900,more than downpayment,more than downpayment,0,4000
OHZSGNRG,4000,1/15/2020,9900,OHZSGNRG,25900,more than downpayment,more than downpayment,0,4000
OIHR67F7,9900,7/11/2019,9900,,9900,equal to downpayment,,9900,0
OIHR67F7,3900,8/21/2019,9900,OIHR67F7,13800,more than downpayment,equal to downpayment,0,3900
OIHR67F7,4000,9/25/2019,9900,OIHR67F7,17800,more than downpayment,more than downpayment,0,4000
OIHR67F7,3000,10/28/2019,9900,OIHR67F7,20800,more than downpayment,more than downpayment,0,3000
OIHR67F7,900,10/30/2019,9900,OIHR67F7,21700,more than downpayment,more than downpayment,0,900
OIHR67F7,3900,11/26/2019,9900,OIHR67F7,25600,more than downpayment,more than downpayment,0,3900
OIHR67F7,3900,1/28/2020,9900,OIHR67F7,29500,more than downpayment,more than downpayment,0,3900
oIsGDiQ5,8900,8/5/2019,8900,,8900,equal to downpayment,,8900,0
oIsGDiQ5,3900,9/23/2019,8900,oIsGDiQ5,12800,more than downpayment,equal to downpayment,0,3900
oIsGDiQ5,3900,10/26/2019,8900,oIsGDiQ5,16700,more than downpayment,more than downpayment,0,3900
oIsGDiQ5,3300,11/27/2019,8900,oIsGDiQ5,20000,more than downpayment,more than downpayment,0,3300
oIsGDiQ5,600,11/28/2019,8900,oIsGDiQ5,20600,more than downpayment,more than downpayment,0,600
oIsGDiQ5,3900,12/26/2019,8900,oIsGDiQ5,24500,more than downpayment,more than downpayment,0,3900
oIsGDiQ5,3700,1/26/2020,8900,oIsGDiQ5,28200,more than downpayment,more than downpayment,0,3700
oIsGDiQ5,200,1/29/2020,8900,oIsGDiQ5,28400,more than downpayment,more than downpayment,0,200
OjYcfl6Q,10000,11/12/2018,10000,,10000,equal to downpayment,,10000,0
OjYcfl6Q,4500,12/12/2018,10000,OjYcfl6Q,14500,more than downpayment,equal to downpayment,0,4500
OjYcfl6Q,4500,1/13/2019,10000,OjYcfl6Q,19000,more than downpayment,more than downpayment,0,4500
OjYcfl6Q,4500,2/10/2019,10000,OjYcfl6Q,23500,more than downpayment,more than downpayment,0,4500
OjYcfl6Q,4500,3/15/2019,10000,OjYcfl6Q,28000,more than downpayment,more than downpayment,0,4500
OjYcfl6Q,4500,4/29/2019,10000,OjYcfl6Q,32500,more than downpayment,more than downpayment,0,4500
OjYcfl6Q,4500,5/14/2019,10000,OjYcfl6Q,37000,more than downpayment,more than downpayment,0,4500
OjYcfl6Q,4500,6/19/2019,10000,OjYcfl6Q,41500,more than downpayment,more than downpayment,0,4500
OjYcfl6Q,4500,7/22/2019,10000,OjYcfl6Q,46000,more than downpayment,more than downpayment,0,4500
OjYcfl6Q,4500,8/20/2019,10000,OjYcfl6Q,50500,more than downpayment,more than downpayment,0,4500
OjYcfl6Q,4500,9/17/2019,10000,OjYcfl6Q,55000,more than downpayment,more than downpayment,0,4500
OjYcfl6Q,4500,10/20/2019,10000,OjYcfl6Q,59500,more than downpayment,more than downpayment,0,4500
OjYcfl6Q,4500,11/18/2019,10000,OjYcfl6Q,64000,more than downpayment,more than downpayment,0,4500
okiDghI7,9900,8/26/2019,8900,,9900,more than downpayment,,8900,1000
OkPeUBrU,9900,6/14/2019,9900,,9900,equal to downpayment,,9900,0
OkPeUBrU,7800,8/23/2019,9900,OkPeUBrU,17700,more than downpayment,equal to downpayment,0,7800
OkPeUBrU,3900,10/15/2019,9900,OkPeUBrU,21600,more than downpayment,more than downpayment,0,3900
OkPeUBrU,3900,12/8/2019,9900,OkPeUBrU,25500,more than downpayment,more than downpayment,0,3900
OkPeUBrU,3900,12/31/2019,9900,OkPeUBrU,29400,more than downpayment,more than downpayment,0,3900
OkPeUBrU,3900,1/28/2020,9900,OkPeUBrU,33300,more than downpayment,more than downpayment,0,3900
okvAWsLE,10000,8/15/2017,10000,,10000,equal to downpayment,,10000,0
okvAWsLE,35000,9/24/2017,10000,okvAWsLE,45000,more than downpayment,equal to downpayment,0,35000
okvAWsLE,2500,10/12/2017,10000,okvAWsLE,47500,more than downpayment,more than downpayment,0,2500
OLOCkaz5,8900,11/1/2018,8900,,8900,equal to downpayment,,8900,0
OLOCkaz5,3900,12/20/2018,8900,OLOCkaz5,12800,more than downpayment,equal to downpayment,0,3900
OLOCkaz5,3900,1/21/2019,8900,OLOCkaz5,16700,more than downpayment,more than downpayment,0,3900
OLOCkaz5,3900,2/26/2019,8900,OLOCkaz5,20600,more than downpayment,more than downpayment,0,3900
OLOCkaz5,3900,3/25/2019,8900,OLOCkaz5,24500,more than downpayment,more than downpayment,0,3900
OLOCkaz5,3900,4/25/2019,8900,OLOCkaz5,28400,more than downpayment,more than downpayment,0,3900
OLOCkaz5,3900,5/25/2019,8900,OLOCkaz5,32300,more than downpayment,more than downpayment,0,3900
OLOCkaz5,3900,6/25/2019,8900,OLOCkaz5,36200,more than downpayment,more than downpayment,0,3900
OLOCkaz5,3900,7/25/2019,8900,OLOCkaz5,40100,more than downpayment,more than downpayment,0,3900
OLOCkaz5,3900,8/25/2019,8900,OLOCkaz5,44000,more than downpayment,more than downpayment,0,3900
OLOCkaz5,3900,9/25/2019,8900,OLOCkaz5,47900,more than downpayment,more than downpayment,0,3900
OLOCkaz5,3900,10/25/2019,8900,OLOCkaz5,51800,more than downpayment,more than downpayment,0,3900
OLOCkaz5,3900,11/25/2019,8900,OLOCkaz5,55700,more than downpayment,more than downpayment,0,3900
OLOCkaz5,3900,12/25/2019,8900,OLOCkaz5,59600,more than downpayment,more than downpayment,0,3900
OLOCkaz5,3900,1/25/2020,8900,OLOCkaz5,63500,more than downpayment,more than downpayment,0,3900
OLYNEr8e,9900,8/15/2019,9900,,9900,equal to downpayment,,9900,0
OLYNEr8e,3900,10/10/2019,9900,OLYNEr8e,13800,more than downpayment,equal to downpayment,0,3900
OLYNEr8e,3900,11/7/2019,9900,OLYNEr8e,17700,more than downpayment,more than downpayment,0,3900
OLYNEr8e,3900,12/9/2019,9900,OLYNEr8e,21600,more than downpayment,more than downpayment,0,3900
OLYNEr8e,3900,1/10/2020,9900,OLYNEr8e,25500,more than downpayment,more than downpayment,0,3900
OLYNEr8e,3900,2/8/2020,9900,OLYNEr8e,29400,more than downpayment,more than downpayment,0,3900
Om8EvFUV,8900,5/28/2019,8900,,8900,equal to downpayment,,8900,0
Om8EvFUV,3900,6/24/2019,8900,Om8EvFUV,12800,more than downpayment,equal to downpayment,0,3900
Om8EvFUV,3900,7/22/2019,8900,Om8EvFUV,16700,more than downpayment,more than downpayment,0,3900
Om8EvFUV,3900,8/21/2019,8900,Om8EvFUV,20600,more than downpayment,more than downpayment,0,3900
Om8EvFUV,3900,9/19/2019,8900,Om8EvFUV,24500,more than downpayment,more than downpayment,0,3900
Om8EvFUV,3900,10/23/2019,8900,Om8EvFUV,28400,more than downpayment,more than downpayment,0,3900
Om8EvFUV,3900,11/22/2019,8900,Om8EvFUV,32300,more than downpayment,more than downpayment,0,3900
Om8EvFUV,3900,12/21/2019,8900,Om8EvFUV,36200,more than downpayment,more than downpayment,0,3900
Om8EvFUV,3900,1/24/2020,8900,Om8EvFUV,40100,more than downpayment,more than downpayment,0,3900
OmbFEXmo,9900,11/16/2018,9900,,9900,equal to downpayment,,9900,0
OmbFEXmo,4500,2/4/2019,9900,OmbFEXmo,14400,more than downpayment,equal to downpayment,0,4500
oMHmVkJU,8900,4/19/2019,8900,,8900,equal to downpayment,,8900,0
oMHmVkJU,3900,6/5/2019,8900,oMHmVkJU,12800,more than downpayment,equal to downpayment,0,3900
oMHmVkJU,3900,7/6/2019,8900,oMHmVkJU,16700,more than downpayment,more than downpayment,0,3900
oMHmVkJU,3900,8/5/2019,8900,oMHmVkJU,20600,more than downpayment,more than downpayment,0,3900
oMHmVkJU,3900,9/5/2019,8900,oMHmVkJU,24500,more than downpayment,more than downpayment,0,3900
oMHmVkJU,3900,10/4/2019,8900,oMHmVkJU,28400,more than downpayment,more than downpayment,0,3900
oMHmVkJU,3900,11/3/2019,8900,oMHmVkJU,32300,more than downpayment,more than downpayment,0,3900
oMHmVkJU,3900,12/22/2019,8900,oMHmVkJU,36200,more than downpayment,more than downpayment,0,3900
oMHmVkJU,3900,1/24/2020,8900,oMHmVkJU,40100,more than downpayment,more than downpayment,0,3900
OmmHAMGe,9900,6/26/2019,8900,,9900,more than downpayment,,8900,1000
OmmHAMGe,3900,7/29/2019,8900,OmmHAMGe,13800,more than downpayment,more than downpayment,0,3900
OmmHAMGe,3900,8/30/2019,8900,OmmHAMGe,17700,more than downpayment,more than downpayment,0,3900
OmmHAMGe,3900,11/29/2019,8900,OmmHAMGe,21600,more than downpayment,more than downpayment,0,3900
OmmHAMGe,6800,2/3/2020,8900,OmmHAMGe,28400,more than downpayment,more than downpayment,0,6800
OMWN8XCE,8900,8/11/2019,8900,,8900,equal to downpayment,,8900,0
OMWN8XCE,4000,9/26/2019,8900,OMWN8XCE,12900,more than downpayment,equal to downpayment,0,4000
OMWN8XCE,3900,10/25/2019,8900,OMWN8XCE,16800,more than downpayment,more than downpayment,0,3900
OMWN8XCE,3900,11/28/2019,8900,OMWN8XCE,20700,more than downpayment,more than downpayment,0,3900
ONA89Q47,8900,11/1/2019,8900,,8900,equal to downpayment,,8900,0
ONA89Q47,3900,12/3/2019,8900,ONA89Q47,12800,more than downpayment,equal to downpayment,0,3900
ONA89Q47,3900,12/27/2019,8900,ONA89Q47,16700,more than downpayment,more than downpayment,0,3900
ONA89Q47,3900,2/3/2020,8900,ONA89Q47,20600,more than downpayment,more than downpayment,0,3900
Onr2XiSF,9900,7/16/2019,9900,,9900,equal to downpayment,,9900,0
Onr2XiSF,3900,9/4/2019,9900,Onr2XiSF,13800,more than downpayment,equal to downpayment,0,3900
Onr2XiSF,3900,10/24/2019,9900,Onr2XiSF,17700,more than downpayment,more than downpayment,0,3900
Onr2XiSF,3900,11/7/2019,9900,Onr2XiSF,21600,more than downpayment,more than downpayment,0,3900
Onr2XiSF,3900,12/6/2019,9900,Onr2XiSF,25500,more than downpayment,more than downpayment,0,3900
Onr2XiSF,3900,1/10/2020,9900,Onr2XiSF,29400,more than downpayment,more than downpayment,0,3900
ooAUPOxN,10000,8/3/2018,10000,,10000,equal to downpayment,,10000,0
ooAUPOxN,4500,9/14/2018,10000,ooAUPOxN,14500,more than downpayment,equal to downpayment,0,4500
ooAUPOxN,4500,10/15/2018,10000,ooAUPOxN,19000,more than downpayment,more than downpayment,0,4500
ooAUPOxN,4500,11/9/2018,10000,ooAUPOxN,23500,more than downpayment,more than downpayment,0,4500
ooAUPOxN,4500,12/12/2018,10000,ooAUPOxN,28000,more than downpayment,more than downpayment,0,4500
ooAUPOxN,4500,1/15/2019,10000,ooAUPOxN,32500,more than downpayment,more than downpayment,0,4500
ooAUPOxN,4500,2/15/2019,10000,ooAUPOxN,37000,more than downpayment,more than downpayment,0,4500
ooAUPOxN,4500,3/15/2019,10000,ooAUPOxN,41500,more than downpayment,more than downpayment,0,4500
ooAUPOxN,4500,4/14/2019,10000,ooAUPOxN,46000,more than downpayment,more than downpayment,0,4500
ooAUPOxN,4500,5/15/2019,10000,ooAUPOxN,50500,more than downpayment,more than downpayment,0,4500
ooAUPOxN,4500,6/14/2019,10000,ooAUPOxN,55000,more than downpayment,more than downpayment,0,4500
ooAUPOxN,4500,7/14/2019,10000,ooAUPOxN,59500,more than downpayment,more than downpayment,0,4500
ooAUPOxN,4500,8/15/2019,10000,ooAUPOxN,64000,more than downpayment,more than downpayment,0,4500
OODOYEHN,9900,7/17/2019,9900,,9900,equal to downpayment,,9900,0
OODOYEHN,4000,9/28/2019,9900,OODOYEHN,13900,more than downpayment,equal to downpayment,0,4000
OODOYEHN,3999,10/29/2019,9900,OODOYEHN,17899,more than downpayment,more than downpayment,0,3999
OODOYEHN,3999,12/16/2019,9900,OODOYEHN,21898,more than downpayment,more than downpayment,0,3999
OODOYEHN,3900,1/13/2020,9900,OODOYEHN,25798,more than downpayment,more than downpayment,0,3900
OODOYEHN,3900,1/27/2020,9900,OODOYEHN,29698,more than downpayment,more than downpayment,0,3900
OoLX1VMD,9900,7/18/2019,9900,,9900,equal to downpayment,,9900,0
OoLX1VMD,3900,9/10/2019,9900,OoLX1VMD,13800,more than downpayment,equal to downpayment,0,3900
OoLX1VMD,3900,10/4/2019,9900,OoLX1VMD,17700,more than downpayment,more than downpayment,0,3900
OoLX1VMD,3900,11/7/2019,9900,OoLX1VMD,21600,more than downpayment,more than downpayment,0,3900
OoLX1VMD,3900,12/12/2019,9900,OoLX1VMD,25500,more than downpayment,more than downpayment,0,3900
OoLX1VMD,3000,1/3/2020,9900,OoLX1VMD,28500,more than downpayment,more than downpayment,0,3000
OoLX1VMD,900,1/6/2020,9900,OoLX1VMD,29400,more than downpayment,more than downpayment,0,900
OoLX1VMD,3900,2/5/2020,9900,OoLX1VMD,33300,more than downpayment,more than downpayment,0,3900
opbyfdsf,10200,9/20/2017,10000,,10200,more than downpayment,,10000,200
opbyfdsf,4100,10/24/2017,10000,opbyfdsf,14300,more than downpayment,more than downpayment,0,4100
opbyfdsf,4000,12/1/2017,10000,opbyfdsf,18300,more than downpayment,more than downpayment,0,4000
opbyfdsf,4000,12/23/2017,10000,opbyfdsf,22300,more than downpayment,more than downpayment,0,4000
opbyfdsf,4000,2/17/2018,10000,opbyfdsf,26300,more than downpayment,more than downpayment,0,4000
opbyfdsf,4000,3/13/2018,10000,opbyfdsf,30300,more than downpayment,more than downpayment,0,4000
opbyfdsf,4000,4/5/2018,10000,opbyfdsf,34300,more than downpayment,more than downpayment,0,4000
opbyfdsf,4000,5/11/2018,10000,opbyfdsf,38300,more than downpayment,more than downpayment,0,4000
opbyfdsf,4000,6/9/2018,10000,opbyfdsf,42300,more than downpayment,more than downpayment,0,4000
opbyfdsf,2000,7/3/2018,10000,opbyfdsf,44300,more than downpayment,more than downpayment,0,2000
opbyfdsf,700,7/20/2018,10000,opbyfdsf,45000,more than downpayment,more than downpayment,0,700
OPlAx4Ij,9000,1/23/2019,8900,,9000,more than downpayment,,8900,100
OPlAx4Ij,4000,2/24/2019,8900,OPlAx4Ij,13000,more than downpayment,more than downpayment,0,4000
OPlAx4Ij,4000,3/26/2019,8900,OPlAx4Ij,17000,more than downpayment,more than downpayment,0,4000
OPlAx4Ij,8000,5/28/2019,8900,OPlAx4Ij,25000,more than downpayment,more than downpayment,0,8000
OPlAx4Ij,4000,7/2/2019,8900,OPlAx4Ij,29000,more than downpayment,more than downpayment,0,4000
OPlAx4Ij,8000,9/15/2019,8900,OPlAx4Ij,37000,more than downpayment,more than downpayment,0,8000
OPlAx4Ij,4000,10/25/2019,8900,OPlAx4Ij,41000,more than downpayment,more than downpayment,0,4000
OPlAx4Ij,3000,10/27/2019,8900,OPlAx4Ij,44000,more than downpayment,more than downpayment,0,3000
OPlAx4Ij,1000,10/28/2019,8900,OPlAx4Ij,45000,more than downpayment,more than downpayment,0,1000
OPlAx4Ij,4000,11/28/2019,8900,OPlAx4Ij,49000,more than downpayment,more than downpayment,0,4000
OPlAx4Ij,4000,12/30/2019,8900,OPlAx4Ij,53000,more than downpayment,more than downpayment,0,4000
OPlAx4Ij,4000,1/27/2020,8900,OPlAx4Ij,57000,more than downpayment,more than downpayment,0,4000
OPNUjgt2,8900,5/2/2019,8900,,8900,equal to downpayment,,8900,0
OPNUjgt2,3900,5/24/2019,8900,OPNUjgt2,12800,more than downpayment,equal to downpayment,0,3900
OPNUjgt2,3900,6/24/2019,8900,OPNUjgt2,16700,more than downpayment,more than downpayment,0,3900
OPNUjgt2,3900,7/25/2019,8900,OPNUjgt2,20600,more than downpayment,more than downpayment,0,3900
OPNUjgt2,3900,9/1/2019,8900,OPNUjgt2,24500,more than downpayment,more than downpayment,0,3900
OPNUjgt2,3900,11/13/2019,8900,OPNUjgt2,28400,more than downpayment,more than downpayment,0,3900
OPNUjgt2,3900,12/5/2019,8900,OPNUjgt2,32300,more than downpayment,more than downpayment,0,3900
OPNUjgt2,3900,1/14/2020,8900,OPNUjgt2,36200,more than downpayment,more than downpayment,0,3900
OPNUjgt2,3900,2/3/2020,8900,OPNUjgt2,40100,more than downpayment,more than downpayment,0,3900
OpWieH0m,9900,10/30/2018,9900,,9900,equal to downpayment,,9900,0
OpWieH0m,4500,12/11/2018,9900,OpWieH0m,14400,more than downpayment,equal to downpayment,0,4500
OpWieH0m,4500,1/7/2019,9900,OpWieH0m,18900,more than downpayment,more than downpayment,0,4500
OpWieH0m,4500,2/18/2019,9900,OpWieH0m,23400,more than downpayment,more than downpayment,0,4500
OpWieH0m,4600,4/16/2019,9900,OpWieH0m,28000,more than downpayment,more than downpayment,0,4600
OpWieH0m,8900,5/13/2019,9900,OpWieH0m,36900,more than downpayment,more than downpayment,0,8900
OpWieH0m,4500,6/19/2019,9900,OpWieH0m,41400,more than downpayment,more than downpayment,0,4500
OpWieH0m,4500,7/16/2019,9900,OpWieH0m,45900,more than downpayment,more than downpayment,0,4500
OpWieH0m,5000,8/8/2019,9900,OpWieH0m,50900,more than downpayment,more than downpayment,0,5000
OpWieH0m,4500,8/31/2019,9900,OpWieH0m,55400,more than downpayment,more than downpayment,0,4500
OpWieH0m,4500,10/16/2019,9900,OpWieH0m,59900,more than downpayment,more than downpayment,0,4500
OpWieH0m,4000,11/22/2019,9900,OpWieH0m,63900,more than downpayment,more than downpayment,0,4000
ORD9dyyq,11900,6/12/2019,26250,,11900,less than downpayment,,11900,0
ORD9dyyq,3900,7/19/2019,26250,ORD9dyyq,15800,less than downpayment,less than downpayment,3900,0
ORD9dyyq,11250,7/25/2019,26250,ORD9dyyq,27050,more than downpayment,less than downpayment,10450,800
ORD9dyyq,26250,8/29/2019,26250,ORD9dyyq,53300,more than downpayment,more than downpayment,0,26250
ORD9dyyq,25250,10/2/2019,26250,ORD9dyyq,78550,more than downpayment,more than downpayment,0,25250
ORD9dyyq,29500,11/1/2019,26250,ORD9dyyq,108050,more than downpayment,more than downpayment,0,29500
oRKqOkEK,8900,5/27/2019,8900,,8900,equal to downpayment,,8900,0
oRKqOkEK,3900,7/25/2019,8900,oRKqOkEK,12800,more than downpayment,equal to downpayment,0,3900
oRKqOkEK,3900,8/17/2019,8900,oRKqOkEK,16700,more than downpayment,more than downpayment,0,3900
oRKqOkEK,1000,9/9/2019,8900,oRKqOkEK,17700,more than downpayment,more than downpayment,0,1000
oRKqOkEK,2900,9/22/2019,8900,oRKqOkEK,20600,more than downpayment,more than downpayment,0,2900
oRKqOkEK,1300,10/12/2019,8900,oRKqOkEK,21900,more than downpayment,more than downpayment,0,1300
oRKqOkEK,800,10/15/2019,8900,oRKqOkEK,22700,more than downpayment,more than downpayment,0,800
oRKqOkEK,1800,10/26/2019,8900,oRKqOkEK,24500,more than downpayment,more than downpayment,0,1800
oRKqOkEK,2600,11/17/2019,8900,oRKqOkEK,27100,more than downpayment,more than downpayment,0,2600
oRKqOkEK,1300,11/26/2019,8900,oRKqOkEK,28400,more than downpayment,more than downpayment,0,1300
oRKqOkEK,3900,12/25/2019,8900,oRKqOkEK,32300,more than downpayment,more than downpayment,0,3900
oRKqOkEK,3900,1/19/2020,8900,oRKqOkEK,36200,more than downpayment,more than downpayment,0,3900
oRKqOkEK,2000,1/28/2020,8900,oRKqOkEK,38200,more than downpayment,more than downpayment,0,2000
OS7HE1QL,9900,10/22/2019,9900,,9900,equal to downpayment,,9900,0
OS7HE1QL,3900,12/26/2019,9900,OS7HE1QL,13800,more than downpayment,equal to downpayment,0,3900
OS7HE1QL,3900,1/28/2020,9900,OS7HE1QL,17700,more than downpayment,more than downpayment,0,3900
otKaD9OA,9900,6/17/2019,8900,,9900,more than downpayment,,8900,1000
otKaD9OA,3900,8/5/2019,8900,otKaD9OA,13800,more than downpayment,more than downpayment,0,3900
otKaD9OA,3900,9/5/2019,8900,otKaD9OA,17700,more than downpayment,more than downpayment,0,3900
otKaD9OA,3900,10/5/2019,8900,otKaD9OA,21600,more than downpayment,more than downpayment,0,3900
otKaD9OA,3900,11/7/2019,8900,otKaD9OA,25500,more than downpayment,more than downpayment,0,3900
otKaD9OA,3900,12/6/2019,8900,otKaD9OA,29400,more than downpayment,more than downpayment,0,3900
otKaD9OA,3900,1/3/2020,8900,otKaD9OA,33300,more than downpayment,more than downpayment,0,3900
otKaD9OA,3900,2/6/2020,8900,otKaD9OA,37200,more than downpayment,more than downpayment,0,3900
OTUT8L2E,9900,9/30/2019,9900,,9900,equal to downpayment,,9900,0
OTUT8L2E,3900,1/1/2020,9900,OTUT8L2E,13800,more than downpayment,equal to downpayment,0,3900
OTUT8L2E,3900,2/5/2020,9900,OTUT8L2E,17700,more than downpayment,more than downpayment,0,3900
oUkAQMej,10000,7/13/2017,10000,,10000,equal to downpayment,,10000,0
oUkAQMej,2500,7/20/2017,10000,oUkAQMej,12500,more than downpayment,equal to downpayment,0,2500
oUkAQMej,3500,8/28/2017,10000,oUkAQMej,16000,more than downpayment,more than downpayment,0,3500
oUkAQMej,3500,12/19/2017,10000,oUkAQMej,19500,more than downpayment,more than downpayment,0,3500
oUkAQMej,2000,2/23/2018,10000,oUkAQMej,21500,more than downpayment,more than downpayment,0,2000
oUkAQMej,1500,3/1/2018,10000,oUkAQMej,23000,more than downpayment,more than downpayment,0,1500
oUkAQMej,1000,10/23/2018,10000,oUkAQMej,24000,more than downpayment,more than downpayment,0,1000
oUkAQMej,2000,12/14/2018,10000,oUkAQMej,26000,more than downpayment,more than downpayment,0,2000
oUkAQMej,2000,2/1/2019,10000,oUkAQMej,28000,more than downpayment,more than downpayment,0,2000
oUkAQMej,2000,5/4/2019,10000,oUkAQMej,30000,more than downpayment,more than downpayment,0,2000
oUkAQMej,2300,6/3/2019,10000,oUkAQMej,32300,more than downpayment,more than downpayment,0,2300
oUkAQMej,2000,2/7/2020,10000,oUkAQMej,34300,more than downpayment,more than downpayment,0,2000
OUMIOB1S,9900,6/8/2019,8900,,9900,more than downpayment,,8900,1000
OUMIOB1S,4000,6/29/2019,8900,OUMIOB1S,13900,more than downpayment,more than downpayment,0,4000
OUMIOB1S,3900,8/10/2019,8900,OUMIOB1S,17800,more than downpayment,more than downpayment,0,3900
OUMIOB1S,3900,9/7/2019,8900,OUMIOB1S,21700,more than downpayment,more than downpayment,0,3900
OUMIOB1S,3900,10/30/2019,8900,OUMIOB1S,25600,more than downpayment,more than downpayment,0,3900
OUMIOB1S,2800,11/29/2019,8900,OUMIOB1S,28400,more than downpayment,more than downpayment,0,2800
OUMIOB1S,3200,1/6/2020,8900,OUMIOB1S,31600,more than downpayment,more than downpayment,0,3200
OUMIOB1S,700,1/10/2020,8900,OUMIOB1S,32300,more than downpayment,more than downpayment,0,700
OUMIOB1S,3900,1/27/2020,8900,OUMIOB1S,36200,more than downpayment,more than downpayment,0,3900
OV77JKWQ,8900,10/2/2019,8900,,8900,equal to downpayment,,8900,0
OV77JKWQ,3900,11/17/2019,8900,OV77JKWQ,12800,more than downpayment,equal to downpayment,0,3900
OV77JKWQ,3900,12/19/2019,8900,OV77JKWQ,16700,more than downpayment,more than downpayment,0,3900
OV77JKWQ,3900,2/6/2020,8900,OV77JKWQ,20600,more than downpayment,more than downpayment,0,3900
OvDFU6pa,8900,4/26/2019,8900,,8900,equal to downpayment,,8900,0
OvDFU6pa,3900,5/29/2019,8900,OvDFU6pa,12800,more than downpayment,equal to downpayment,0,3900
OvDFU6pa,3900,6/26/2019,8900,OvDFU6pa,16700,more than downpayment,more than downpayment,0,3900
OvDFU6pa,3900,8/5/2019,8900,OvDFU6pa,20600,more than downpayment,more than downpayment,0,3900
OvDFU6pa,3900,9/5/2019,8900,OvDFU6pa,24500,more than downpayment,more than downpayment,0,3900
OvDFU6pa,3900,10/7/2019,8900,OvDFU6pa,28400,more than downpayment,more than downpayment,0,3900
OvDFU6pa,3900,11/6/2019,8900,OvDFU6pa,32300,more than downpayment,more than downpayment,0,3900
OvDFU6pa,3900,1/15/2020,8900,OvDFU6pa,36200,more than downpayment,more than downpayment,0,3900
OvDFU6pa,3900,2/4/2020,8900,OvDFU6pa,40100,more than downpayment,more than downpayment,0,3900
OWJ5LM3B,10000,9/20/2019,9900,,10000,more than downpayment,,9900,100
OXJTQ1QQ,9900,9/20/2019,9900,,9900,equal to downpayment,,9900,0
OXJTQ1QQ,1000,10/14/2019,9900,OXJTQ1QQ,10900,more than downpayment,equal to downpayment,0,1000
OXJTQ1QQ,3000,10/17/2019,9900,OXJTQ1QQ,13900,more than downpayment,more than downpayment,0,3000
OXJTQ1QQ,3900,11/1/2019,9900,OXJTQ1QQ,17800,more than downpayment,more than downpayment,0,3900
OXJTQ1QQ,3900,12/4/2019,9900,OXJTQ1QQ,21700,more than downpayment,more than downpayment,0,3900
OXJTQ1QQ,3900,1/6/2020,9900,OXJTQ1QQ,25600,more than downpayment,more than downpayment,0,3900
OXJTQ1QQ,3900,2/9/2020,9900,OXJTQ1QQ,29500,more than downpayment,more than downpayment,0,3900
OxNNInxY,10000,1/2/2019,9900,,10000,more than downpayment,,9900,100
OxNNInxY,4500,2/15/2019,9900,OxNNInxY,14500,more than downpayment,more than downpayment,0,4500
OxNNInxY,4500,5/7/2019,9900,OxNNInxY,19000,more than downpayment,more than downpayment,0,4500
OxNNInxY,6000,6/3/2019,9900,OxNNInxY,25000,more than downpayment,more than downpayment,0,6000
OxNNInxY,6000,6/24/2019,9900,OxNNInxY,31000,more than downpayment,more than downpayment,0,6000
OxNNInxY,6000,7/8/2019,9900,OxNNInxY,37000,more than downpayment,more than downpayment,0,6000
OxNNInxY,4500,8/26/2019,9900,OxNNInxY,41500,more than downpayment,more than downpayment,0,4500
OxNNInxY,4500,10/3/2019,9900,OxNNInxY,46000,more than downpayment,more than downpayment,0,4500
OxNNInxY,4500,10/31/2019,9900,OxNNInxY,50500,more than downpayment,more than downpayment,0,4500
OxNNInxY,4500,12/4/2019,9900,OxNNInxY,55000,more than downpayment,more than downpayment,0,4500
OxNNInxY,4500,12/30/2019,9900,OxNNInxY,59500,more than downpayment,more than downpayment,0,4500
OxNNInxY,4500,1/29/2020,9900,OxNNInxY,64000,more than downpayment,more than downpayment,0,4500
OY2K6S9A,9900,1/15/2020,9900,,9900,equal to downpayment,,9900,0
OY4AQMlN,10000,6/25/2019,8900,,10000,more than downpayment,,8900,1100
OY4AQMlN,8000,7/24/2019,8900,OY4AQMlN,18000,more than downpayment,more than downpayment,0,8000
OY4AQMlN,4000,8/26/2019,8900,OY4AQMlN,22000,more than downpayment,more than downpayment,0,4000
OY4AQMlN,4000,9/25/2019,8900,OY4AQMlN,26000,more than downpayment,more than downpayment,0,4000
OY4AQMlN,4000,11/1/2019,8900,OY4AQMlN,30000,more than downpayment,more than downpayment,0,4000
OY4AQMlN,2000,1/27/2020,8900,OY4AQMlN,32000,more than downpayment,more than downpayment,0,2000
OZKKU7XV,15000,11/11/2019,9900,,15000,more than downpayment,,9900,5100
OZKKU7XV,2700,1/21/2020,9900,OZKKU7XV,17700,more than downpayment,more than downpayment,0,2700
OzxAaaU1,9900,8/26/2019,9900,,9900,equal to downpayment,,9900,0
OzxAaaU1,3900,11/2/2019,9900,OzxAaaU1,13800,more than downpayment,equal to downpayment,0,3900
OzxAaaU1,3900,12/9/2019,9900,OzxAaaU1,17700,more than downpayment,more than downpayment,0,3900
OzxAaaU1,3900,1/3/2020,9900,OzxAaaU1,21600,more than downpayment,more than downpayment,0,3900
OzxAaaU1,3900,2/6/2020,9900,OzxAaaU1,25500,more than downpayment,more than downpayment,0,3900
P07clxAV,8900,8/6/2019,8900,,8900,equal to downpayment,,8900,0
P07clxAV,4000,8/31/2019,8900,P07clxAV,12900,more than downpayment,equal to downpayment,0,4000
P07clxAV,4000,10/2/2019,8900,P07clxAV,16900,more than downpayment,more than downpayment,0,4000
P07clxAV,4000,11/5/2019,8900,P07clxAV,20900,more than downpayment,more than downpayment,0,4000
P07clxAV,4000,12/2/2019,8900,P07clxAV,24900,more than downpayment,more than downpayment,0,4000
P07clxAV,4000,1/1/2020,8900,P07clxAV,28900,more than downpayment,more than downpayment,0,4000
P07clxAV,5000,2/7/2020,8900,P07clxAV,33900,more than downpayment,more than downpayment,0,5000
P12VVL3B,9900,10/8/2019,9900,,9900,equal to downpayment,,9900,0
P12VVL3B,3900,11/28/2019,9900,P12VVL3B,13800,more than downpayment,equal to downpayment,0,3900
P12VVL3B,3900,12/27/2019,9900,P12VVL3B,17700,more than downpayment,more than downpayment,0,3900
P12VVL3B,3900,1/27/2020,9900,P12VVL3B,21600,more than downpayment,more than downpayment,0,3900
P2LKYK6P,8900,1/15/2020,8900,,8900,equal to downpayment,,8900,0
p3wPqiXK,9000,4/18/2019,8900,,9000,more than downpayment,,8900,100
p3wPqiXK,3900,5/2/2019,8900,p3wPqiXK,12900,more than downpayment,more than downpayment,0,3900
p3wPqiXK,4000,5/31/2019,8900,p3wPqiXK,16900,more than downpayment,more than downpayment,0,4000
p3wPqiXK,3900,7/1/2019,8900,p3wPqiXK,20800,more than downpayment,more than downpayment,0,3900
p3wPqiXK,4000,8/5/2019,8900,p3wPqiXK,24800,more than downpayment,more than downpayment,0,4000
p3wPqiXK,4000,9/4/2019,8900,p3wPqiXK,28800,more than downpayment,more than downpayment,0,4000
p3wPqiXK,4000,10/4/2019,8900,p3wPqiXK,32800,more than downpayment,more than downpayment,0,4000
p3wPqiXK,4000,11/4/2019,8900,p3wPqiXK,36800,more than downpayment,more than downpayment,0,4000
p3wPqiXK,4000,12/3/2019,8900,p3wPqiXK,40800,more than downpayment,more than downpayment,0,4000
p3wPqiXK,4000,12/30/2019,8900,p3wPqiXK,44800,more than downpayment,more than downpayment,0,4000
p3wPqiXK,4000,2/4/2020,8900,p3wPqiXK,48800,more than downpayment,more than downpayment,0,4000
P44fWdYO,10000,9/12/2017,10000,,10000,equal to downpayment,,10000,0
P44fWdYO,2000,3/12/2018,10000,P44fWdYO,12000,more than downpayment,equal to downpayment,0,2000
P44fWdYO,1000,8/20/2018,10000,P44fWdYO,13000,more than downpayment,more than downpayment,0,1000
P44fWdYO,1000,10/11/2018,10000,P44fWdYO,14000,more than downpayment,more than downpayment,0,1000
P44fWdYO,4000,2/18/2019,10000,P44fWdYO,18000,more than downpayment,more than downpayment,0,4000
P44fWdYO,1000,4/16/2019,10000,P44fWdYO,19000,more than downpayment,more than downpayment,0,1000
P44fWdYO,1000,6/19/2019,10000,P44fWdYO,20000,more than downpayment,more than downpayment,0,1000
P44fWdYO,2000,9/23/2019,10000,P44fWdYO,22000,more than downpayment,more than downpayment,0,2000
P44fWdYO,2000,10/11/2019,10000,P44fWdYO,24000,more than downpayment,more than downpayment,0,2000
P44fWdYO,3060,11/22/2019,10000,P44fWdYO,27060,more than downpayment,more than downpayment,0,3060
P44fWdYO,5000,1/15/2020,10000,P44fWdYO,32060,more than downpayment,more than downpayment,0,5000
P4HB9KWP,10000,11/24/2019,9900,,10000,more than downpayment,,9900,100
P4HB9KWP,5000,2/4/2020,9900,P4HB9KWP,15000,more than downpayment,more than downpayment,0,5000
P4PNH6CF,8900,11/28/2019,8900,,8900,equal to downpayment,,8900,0
P4PNH6CF,3900,2/5/2020,8900,P4PNH6CF,12800,more than downpayment,equal to downpayment,0,3900
P4UT8X9N,1599,10/14/2019,1594,,1599,more than downpayment,,1594,5
P5RSApbz,8900,11/8/2018,8900,,8900,equal to downpayment,,8900,0
P5RSApbz,3900,1/3/2019,8900,P5RSApbz,12800,more than downpayment,equal to downpayment,0,3900
P5RSApbz,3900,2/11/2019,8900,P5RSApbz,16700,more than downpayment,more than downpayment,0,3900
P5RSApbz,3900,3/18/2019,8900,P5RSApbz,20600,more than downpayment,more than downpayment,0,3900
P5RSApbz,3900,4/9/2019,8900,P5RSApbz,24500,more than downpayment,more than downpayment,0,3900
P5RSApbz,3900,6/3/2019,8900,P5RSApbz,28400,more than downpayment,more than downpayment,0,3900
P5RSApbz,3900,7/3/2019,8900,P5RSApbz,32300,more than downpayment,more than downpayment,0,3900
P5RSApbz,3900,8/2/2019,8900,P5RSApbz,36200,more than downpayment,more than downpayment,0,3900
P5RSApbz,3900,8/26/2019,8900,P5RSApbz,40100,more than downpayment,more than downpayment,0,3900
P5RSApbz,3900,10/4/2019,8900,P5RSApbz,44000,more than downpayment,more than downpayment,0,3900
P5RSApbz,3900,11/29/2019,8900,P5RSApbz,47900,more than downpayment,more than downpayment,0,3900
P5RSApbz,3900,12/21/2019,8900,P5RSApbz,51800,more than downpayment,more than downpayment,0,3900
P5RSApbz,3900,1/28/2020,8900,P5RSApbz,55700,more than downpayment,more than downpayment,0,3900
p7BvqAOw,2000,7/1/2019,1999,,2000,more than downpayment,,1999,1
P7T62SI6,9900,9/14/2019,9900,,9900,equal to downpayment,,9900,0
P7T62SI6,3900,11/4/2019,9900,P7T62SI6,13800,more than downpayment,equal to downpayment,0,3900
P7T62SI6,3900,12/5/2019,9900,P7T62SI6,17700,more than downpayment,more than downpayment,0,3900
P7T62SI6,3900,1/4/2020,9900,P7T62SI6,21600,more than downpayment,more than downpayment,0,3900
P7T62SI6,3900,2/5/2020,9900,P7T62SI6,25500,more than downpayment,more than downpayment,0,3900
P91R3D9e,8900,4/17/2019,8900,,8900,equal to downpayment,,8900,0
P91R3D9e,3900,6/4/2019,8900,P91R3D9e,12800,more than downpayment,equal to downpayment,0,3900
P91R3D9e,3900,7/1/2019,8900,P91R3D9e,16700,more than downpayment,more than downpayment,0,3900
P91R3D9e,3900,8/7/2019,8900,P91R3D9e,20600,more than downpayment,more than downpayment,0,3900
P91R3D9e,3900,9/12/2019,8900,P91R3D9e,24500,more than downpayment,more than downpayment,0,3900
P91R3D9e,3900,10/7/2019,8900,P91R3D9e,28400,more than downpayment,more than downpayment,0,3900
P91R3D9e,3900,11/5/2019,8900,P91R3D9e,32300,more than downpayment,more than downpayment,0,3900
P91R3D9e,3900,12/5/2019,8900,P91R3D9e,36200,more than downpayment,more than downpayment,0,3900
P91R3D9e,3900,1/6/2020,8900,P91R3D9e,40100,more than downpayment,more than downpayment,0,3900
P91R3D9e,3900,2/5/2020,8900,P91R3D9e,44000,more than downpayment,more than downpayment,0,3900
p9Oq8dQ2,10500,11/29/2017,10000,,10500,more than downpayment,,10000,500
PA8DMVIM,10000,10/15/2019,8900,,10000,more than downpayment,,8900,1100
PA8DMVIM,20000,10/22/2019,8900,PA8DMVIM,30000,more than downpayment,more than downpayment,0,20000
PADWSYIU,10000,11/18/2019,9900,,10000,more than downpayment,,9900,100
pALR0G08,10000,1/9/2019,10000,,10000,equal to downpayment,,10000,0
pALR0G08,5000,1/27/2019,10000,pALR0G08,15000,more than downpayment,equal to downpayment,0,5000
pALR0G08,5000,2/27/2019,10000,pALR0G08,20000,more than downpayment,more than downpayment,0,5000
pALR0G08,5000,3/16/2019,10000,pALR0G08,25000,more than downpayment,more than downpayment,0,5000
pALR0G08,10000,5/22/2019,10000,pALR0G08,35000,more than downpayment,more than downpayment,0,10000
pALR0G08,5000,6/29/2019,10000,pALR0G08,40000,more than downpayment,more than downpayment,0,5000
pALR0G08,5000,7/17/2019,10000,pALR0G08,45000,more than downpayment,more than downpayment,0,5000
pALR0G08,5500,10/24/2019,10000,pALR0G08,50500,more than downpayment,more than downpayment,0,5500
pALR0G08,3100,1/14/2020,10000,pALR0G08,53600,more than downpayment,more than downpayment,0,3100
pALR0G08,4500,2/3/2020,10000,pALR0G08,58100,more than downpayment,more than downpayment,0,4500
PAod695m,10000,1/25/2019,10000,,10000,equal to downpayment,,10000,0
PAod695m,10000,2/10/2019,10000,PAod695m,20000,more than downpayment,equal to downpayment,0,10000
PAod695m,4500,3/25/2019,10000,PAod695m,24500,more than downpayment,more than downpayment,0,4500
PAod695m,4500,4/23/2019,10000,PAod695m,29000,more than downpayment,more than downpayment,0,4500
PAod695m,1000,8/7/2019,10000,PAod695m,30000,more than downpayment,more than downpayment,0,1000
PAod695m,3500,8/8/2019,10000,PAod695m,33500,more than downpayment,more than downpayment,0,3500
PAod695m,1200,8/29/2019,10000,PAod695m,34700,more than downpayment,more than downpayment,0,1200
PAod695m,2000,9/7/2019,10000,PAod695m,36700,more than downpayment,more than downpayment,0,2000
PAod695m,2000,10/7/2019,10000,PAod695m,38700,more than downpayment,more than downpayment,0,2000
PAod695m,1300,10/15/2019,10000,PAod695m,40000,more than downpayment,more than downpayment,0,1300
PAod695m,2300,11/3/2019,10000,PAod695m,42300,more than downpayment,more than downpayment,0,2300
PAod695m,4500,11/19/2019,10000,PAod695m,46800,more than downpayment,more than downpayment,0,4500
PAod695m,4500,12/20/2019,10000,PAod695m,51300,more than downpayment,more than downpayment,0,4500
PAVFYSKW,9900,11/13/2019,9900,,9900,equal to downpayment,,9900,0
pAyRRqh6,9900,11/6/2018,9900,,9900,equal to downpayment,,9900,0
pAyRRqh6,4500,1/29/2019,9900,pAyRRqh6,14400,more than downpayment,equal to downpayment,0,4500
pAyRRqh6,4500,2/27/2019,9900,pAyRRqh6,18900,more than downpayment,more than downpayment,0,4500
pAyRRqh6,4500,3/25/2019,9900,pAyRRqh6,23400,more than downpayment,more than downpayment,0,4500
pAyRRqh6,4500,5/6/2019,9900,pAyRRqh6,27900,more than downpayment,more than downpayment,0,4500
pAyRRqh6,4500,5/30/2019,9900,pAyRRqh6,32400,more than downpayment,more than downpayment,0,4500
pAyRRqh6,4500,7/5/2019,9900,pAyRRqh6,36900,more than downpayment,more than downpayment,0,4500
pAyRRqh6,4500,8/5/2019,9900,pAyRRqh6,41400,more than downpayment,more than downpayment,0,4500
pAyRRqh6,4500,9/6/2019,9900,pAyRRqh6,45900,more than downpayment,more than downpayment,0,4500
pAyRRqh6,4500,10/11/2019,9900,pAyRRqh6,50400,more than downpayment,more than downpayment,0,4500
pAyRRqh6,4500,11/6/2019,9900,pAyRRqh6,54900,more than downpayment,more than downpayment,0,4500
pAyRRqh6,4500,12/4/2019,9900,pAyRRqh6,59400,more than downpayment,more than downpayment,0,4500
pAyRRqh6,4500,1/4/2020,9900,pAyRRqh6,63900,more than downpayment,more than downpayment,0,4500
PBGOK4BJ,9900,11/2/2019,9900,,9900,equal to downpayment,,9900,0
PBGOK4BJ,3400,1/2/2020,9900,PBGOK4BJ,13300,more than downpayment,equal to downpayment,0,3400
PBGOK4BJ,500,1/8/2020,9900,PBGOK4BJ,13800,more than downpayment,more than downpayment,0,500
PBGOK4BJ,3900,1/31/2020,9900,PBGOK4BJ,17700,more than downpayment,more than downpayment,0,3900
PCP8JC94,9900,8/8/2019,8900,,9900,more than downpayment,,8900,1000
PCP8JC94,3900,10/3/2019,8900,PCP8JC94,13800,more than downpayment,more than downpayment,0,3900
PCP8JC94,3900,11/7/2019,8900,PCP8JC94,17700,more than downpayment,more than downpayment,0,3900
PCP8JC94,3900,12/8/2019,8900,PCP8JC94,21600,more than downpayment,more than downpayment,0,3900
PCP8JC94,3900,1/2/2020,8900,PCP8JC94,25500,more than downpayment,more than downpayment,0,3900
PDANALCR,1594,10/14/2019,1594,,1594,equal to downpayment,,1594,0
PDANALCR,3100,11/15/2019,1594,PDANALCR,4694,more than downpayment,equal to downpayment,0,3100
PDANALCR,3100,12/26/2019,1594,PDANALCR,7794,more than downpayment,more than downpayment,0,3100
PDANALCR,3100,1/14/2020,1594,PDANALCR,10894,more than downpayment,more than downpayment,0,3100
PDANALCR,3100,2/5/2020,1594,PDANALCR,13994,more than downpayment,more than downpayment,0,3100
PDLZ6KVO,9900,11/21/2019,9900,,9900,equal to downpayment,,9900,0
PDLZ6KVO,3900,1/31/2020,9900,PDLZ6KVO,13800,more than downpayment,equal to downpayment,0,3900
pEfcUZsv,10000,3/4/2019,10000,,10000,equal to downpayment,,10000,0
pEfcUZsv,4500,4/4/2019,10000,pEfcUZsv,14500,more than downpayment,equal to downpayment,0,4500
pEfcUZsv,4500,5/3/2019,10000,pEfcUZsv,19000,more than downpayment,more than downpayment,0,4500
pEfcUZsv,4500,6/7/2019,10000,pEfcUZsv,23500,more than downpayment,more than downpayment,0,4500
pEfcUZsv,4500,7/4/2019,10000,pEfcUZsv,28000,more than downpayment,more than downpayment,0,4500
pEfcUZsv,4500,8/5/2019,10000,pEfcUZsv,32500,more than downpayment,more than downpayment,0,4500
pEfcUZsv,4500,9/5/2019,10000,pEfcUZsv,37000,more than downpayment,more than downpayment,0,4500
pEfcUZsv,4500,10/5/2019,10000,pEfcUZsv,41500,more than downpayment,more than downpayment,0,4500
pEfcUZsv,4500,12/3/2019,10000,pEfcUZsv,46000,more than downpayment,more than downpayment,0,4500
pEfcUZsv,4500,1/5/2020,10000,pEfcUZsv,50500,more than downpayment,more than downpayment,0,4500
peG9gqkE,9900,12/28/2018,9900,,9900,equal to downpayment,,9900,0
peG9gqkE,4500,2/26/2019,9900,peG9gqkE,14400,more than downpayment,equal to downpayment,0,4500
peG9gqkE,4500,3/29/2019,9900,peG9gqkE,18900,more than downpayment,more than downpayment,0,4500
peG9gqkE,4500,4/21/2019,9900,peG9gqkE,23400,more than downpayment,more than downpayment,0,4500
peG9gqkE,3000,5/23/2019,9900,peG9gqkE,26400,more than downpayment,more than downpayment,0,3000
peG9gqkE,1500,5/27/2019,9900,peG9gqkE,27900,more than downpayment,more than downpayment,0,1500
peG9gqkE,4500,6/25/2019,9900,peG9gqkE,32400,more than downpayment,more than downpayment,0,4500
peG9gqkE,4500,7/26/2019,9900,peG9gqkE,36900,more than downpayment,more than downpayment,0,4500
peG9gqkE,4500,9/2/2019,9900,peG9gqkE,41400,more than downpayment,more than downpayment,0,4500
peG9gqkE,3500,9/26/2019,9900,peG9gqkE,44900,more than downpayment,more than downpayment,0,3500
peG9gqkE,1000,10/1/2019,9900,peG9gqkE,45900,more than downpayment,more than downpayment,0,1000
peG9gqkE,4500,10/29/2019,9900,peG9gqkE,50400,more than downpayment,more than downpayment,0,4500
peG9gqkE,4500,12/2/2019,9900,peG9gqkE,54900,more than downpayment,more than downpayment,0,4500
peG9gqkE,4500,12/29/2019,9900,peG9gqkE,59400,more than downpayment,more than downpayment,0,4500
peG9gqkE,4500,1/31/2020,9900,peG9gqkE,63900,more than downpayment,more than downpayment,0,4500
pEog1xnA,9900,11/6/2018,9900,,9900,equal to downpayment,,9900,0
pEog1xnA,4500,12/10/2018,9900,pEog1xnA,14400,more than downpayment,equal to downpayment,0,4500
pEog1xnA,4500,12/22/2018,9900,pEog1xnA,18900,more than downpayment,more than downpayment,0,4500
pEog1xnA,4500,2/5/2019,9900,pEog1xnA,23400,more than downpayment,more than downpayment,0,4500
pEog1xnA,4500,3/6/2019,9900,pEog1xnA,27900,more than downpayment,more than downpayment,0,4500
pEog1xnA,4500,5/7/2019,9900,pEog1xnA,32400,more than downpayment,more than downpayment,0,4500
pEog1xnA,9000,6/6/2019,9900,pEog1xnA,41400,more than downpayment,more than downpayment,0,9000
pEog1xnA,4500,7/2/2019,9900,pEog1xnA,45900,more than downpayment,more than downpayment,0,4500
pEog1xnA,4500,7/31/2019,9900,pEog1xnA,50400,more than downpayment,more than downpayment,0,4500
pEog1xnA,4500,9/1/2019,9900,pEog1xnA,54900,more than downpayment,more than downpayment,0,4500
pEog1xnA,9000,11/2/2019,9900,pEog1xnA,63900,more than downpayment,more than downpayment,0,9000
pEog1xnA,9000,1/3/2020,9900,pEog1xnA,72900,more than downpayment,more than downpayment,0,9000
PEscUqAt,10000,7/13/2018,10000,,10000,equal to downpayment,,10000,0
PEscUqAt,4500,8/15/2018,10000,PEscUqAt,14500,more than downpayment,equal to downpayment,0,4500
PEscUqAt,4500,9/15/2018,10000,PEscUqAt,19000,more than downpayment,more than downpayment,0,4500
PEscUqAt,4500,10/10/2018,10000,PEscUqAt,23500,more than downpayment,more than downpayment,0,4500
PEscUqAt,4500,11/10/2018,10000,PEscUqAt,28000,more than downpayment,more than downpayment,0,4500
PEscUqAt,4500,12/12/2018,10000,PEscUqAt,32500,more than downpayment,more than downpayment,0,4500
PEscUqAt,4500,1/15/2019,10000,PEscUqAt,37000,more than downpayment,more than downpayment,0,4500
PEscUqAt,4500,2/14/2019,10000,PEscUqAt,41500,more than downpayment,more than downpayment,0,4500
PEscUqAt,4500,3/11/2019,10000,PEscUqAt,46000,more than downpayment,more than downpayment,0,4500
PEscUqAt,4500,4/13/2019,10000,PEscUqAt,50500,more than downpayment,more than downpayment,0,4500
PEscUqAt,4500,5/12/2019,10000,PEscUqAt,55000,more than downpayment,more than downpayment,0,4500
PEscUqAt,4500,6/15/2019,10000,PEscUqAt,59500,more than downpayment,more than downpayment,0,4500
PEscUqAt,4500,7/14/2019,10000,PEscUqAt,64000,more than downpayment,more than downpayment,0,4500
PETMCGAH,9900,8/15/2019,9900,,9900,equal to downpayment,,9900,0
PETMCGAH,5000,10/23/2019,9900,PETMCGAH,14900,more than downpayment,equal to downpayment,0,5000
PETMCGAH,5000,11/25/2019,9900,PETMCGAH,19900,more than downpayment,more than downpayment,0,5000
PETMCGAH,5000,12/24/2019,9900,PETMCGAH,24900,more than downpayment,more than downpayment,0,5000
PETMCGAH,5000,1/22/2020,9900,PETMCGAH,29900,more than downpayment,more than downpayment,0,5000
PF636JVO,8900,11/4/2019,8900,,8900,equal to downpayment,,8900,0
PF636JVO,3900,1/4/2020,8900,PF636JVO,12800,more than downpayment,equal to downpayment,0,3900
PF636JVO,4000,2/6/2020,8900,PF636JVO,16800,more than downpayment,more than downpayment,0,4000
PG355R3M,9900,11/1/2019,9900,,9900,equal to downpayment,,9900,0
PG355R3M,3900,12/1/2019,9900,PG355R3M,13800,more than downpayment,equal to downpayment,0,3900
PG355R3M,3900,12/29/2019,9900,PG355R3M,17700,more than downpayment,more than downpayment,0,3900
PG355R3M,3900,1/28/2020,9900,PG355R3M,21600,more than downpayment,more than downpayment,0,3900
PG9A1Q2W,8900,8/28/2019,8900,,8900,equal to downpayment,,8900,0
pgSb1QN0,8900,4/8/2019,8900,,8900,equal to downpayment,,8900,0
pgSb1QN0,4000,5/13/2019,8900,pgSb1QN0,12900,more than downpayment,equal to downpayment,0,4000
pgSb1QN0,4000,6/14/2019,8900,pgSb1QN0,16900,more than downpayment,more than downpayment,0,4000
pgSb1QN0,3900,7/15/2019,8900,pgSb1QN0,20800,more than downpayment,more than downpayment,0,3900
pgSb1QN0,4000,8/26/2019,8900,pgSb1QN0,24800,more than downpayment,more than downpayment,0,4000
pgSb1QN0,3900,9/18/2019,8900,pgSb1QN0,28700,more than downpayment,more than downpayment,0,3900
pgSb1QN0,3900,10/18/2019,8900,pgSb1QN0,32600,more than downpayment,more than downpayment,0,3900
pgSb1QN0,3900,11/18/2019,8900,pgSb1QN0,36500,more than downpayment,more than downpayment,0,3900
pgSb1QN0,3900,12/18/2019,8900,pgSb1QN0,40400,more than downpayment,more than downpayment,0,3900
pgSb1QN0,2300,1/16/2020,8900,pgSb1QN0,42700,more than downpayment,more than downpayment,0,2300
pgSb1QN0,1000,1/24/2020,8900,pgSb1QN0,43700,more than downpayment,more than downpayment,0,1000
pgSb1QN0,300,1/27/2020,8900,pgSb1QN0,44000,more than downpayment,more than downpayment,0,300
PGYNJ4U3,10000,6/29/2019,8900,,10000,more than downpayment,,8900,1100
PGYNJ4U3,10000,8/20/2019,8900,PGYNJ4U3,20000,more than downpayment,more than downpayment,0,10000
PGYNJ4U3,5000,9/26/2019,8900,PGYNJ4U3,25000,more than downpayment,more than downpayment,0,5000
PGYNJ4U3,5000,10/21/2019,8900,PGYNJ4U3,30000,more than downpayment,more than downpayment,0,5000
PGYNJ4U3,5000,11/19/2019,8900,PGYNJ4U3,35000,more than downpayment,more than downpayment,0,5000
PGYNJ4U3,10000,12/17/2019,8900,PGYNJ4U3,45000,more than downpayment,more than downpayment,0,10000
PGYNJ4U3,20000,1/22/2020,8900,PGYNJ4U3,65000,more than downpayment,more than downpayment,0,20000
PHBIACOB,7900,1/14/2020,7900,,7900,equal to downpayment,,7900,0
PHe99MU0,10000,12/13/2017,10000,,10000,equal to downpayment,,10000,0
PHe99MU0,4400,2/27/2018,10000,PHe99MU0,14400,more than downpayment,equal to downpayment,0,4400
PHe99MU0,4500,4/10/2018,10000,PHe99MU0,18900,more than downpayment,more than downpayment,0,4500
PHVGXQAW,5000,1/15/2020,4999,,5000,more than downpayment,,4999,1
phzL74ek,8900,1/21/2019,8900,,8900,equal to downpayment,,8900,0
phzL74ek,3900,2/28/2019,8900,phzL74ek,12800,more than downpayment,equal to downpayment,0,3900
phzL74ek,3900,4/3/2019,8900,phzL74ek,16700,more than downpayment,more than downpayment,0,3900
phzL74ek,3900,4/24/2019,8900,phzL74ek,20600,more than downpayment,more than downpayment,0,3900
phzL74ek,3900,5/27/2019,8900,phzL74ek,24500,more than downpayment,more than downpayment,0,3900
phzL74ek,3900,6/21/2019,8900,phzL74ek,28400,more than downpayment,more than downpayment,0,3900
phzL74ek,3900,7/25/2019,8900,phzL74ek,32300,more than downpayment,more than downpayment,0,3900
phzL74ek,3900,8/28/2019,8900,phzL74ek,36200,more than downpayment,more than downpayment,0,3900
phzL74ek,3900,9/17/2019,8900,phzL74ek,40100,more than downpayment,more than downpayment,0,3900
phzL74ek,3900,10/29/2019,8900,phzL74ek,44000,more than downpayment,more than downpayment,0,3900
phzL74ek,3900,12/30/2019,8900,phzL74ek,47900,more than downpayment,more than downpayment,0,3900
phzL74ek,3900,1/8/2020,8900,phzL74ek,51800,more than downpayment,more than downpayment,0,3900
phzL74ek,3900,1/27/2020,8900,phzL74ek,55700,more than downpayment,more than downpayment,0,3900
pI0RzjUK,9900,11/7/2018,9900,,9900,equal to downpayment,,9900,0
pI0RzjUK,4500,12/1/2018,9900,pI0RzjUK,14400,more than downpayment,equal to downpayment,0,4500
pI0RzjUK,49500,12/21/2018,9900,pI0RzjUK,63900,more than downpayment,more than downpayment,0,49500
PI1F4IYB,9900,10/9/2019,9900,,9900,equal to downpayment,,9900,0
PI1F4IYB,3900,12/29/2019,9900,PI1F4IYB,13800,more than downpayment,equal to downpayment,0,3900
PI1F4IYB,3900,1/25/2020,9900,PI1F4IYB,17700,more than downpayment,more than downpayment,0,3900
PIBGUDQU,16966,9/7/2019,9900,,16966,more than downpayment,,9900,7066
PIBGUDQU,3900,11/19/2019,9900,PIBGUDQU,20866,more than downpayment,more than downpayment,0,3900
PIBGUDQU,3900,12/18/2019,9900,PIBGUDQU,24766,more than downpayment,more than downpayment,0,3900
PIBGUDQU,3900,1/18/2020,9900,PIBGUDQU,28666,more than downpayment,more than downpayment,0,3900
PJLXV8CX,9900,10/3/2019,9900,,9900,equal to downpayment,,9900,0
PJLXV8CX,4000,11/26/2019,9900,PJLXV8CX,13900,more than downpayment,equal to downpayment,0,4000
PJLXV8CX,4000,1/8/2020,9900,PJLXV8CX,17900,more than downpayment,more than downpayment,0,4000
PJLXV8CX,4000,1/29/2020,9900,PJLXV8CX,21900,more than downpayment,more than downpayment,0,4000
PJVWM7G3,9900,1/25/2020,9900,,9900,equal to downpayment,,9900,0
PK4IEKZA,8900,9/30/2019,8900,,8900,equal to downpayment,,8900,0
PK4IEKZA,3999,11/5/2019,8900,PK4IEKZA,12899,more than downpayment,equal to downpayment,0,3999
PK4IEKZA,3900,12/9/2019,8900,PK4IEKZA,16799,more than downpayment,more than downpayment,0,3900
PK4IEKZA,3900,1/5/2020,8900,PK4IEKZA,20699,more than downpayment,more than downpayment,0,3900
PK4IEKZA,3900,2/6/2020,8900,PK4IEKZA,24599,more than downpayment,more than downpayment,0,3900
PKppNZ5Y,9900,9/11/2019,9900,,9900,equal to downpayment,,9900,0
PKppNZ5Y,3900,10/24/2019,9900,PKppNZ5Y,13800,more than downpayment,equal to downpayment,0,3900
PKppNZ5Y,3900,11/21/2019,9900,PKppNZ5Y,17700,more than downpayment,more than downpayment,0,3900
PKppNZ5Y,3900,12/30/2019,9900,PKppNZ5Y,21600,more than downpayment,more than downpayment,0,3900
PKppNZ5Y,3900,1/21/2020,9900,PKppNZ5Y,25500,more than downpayment,more than downpayment,0,3900
pLAyyklz,25000,2/19/2019,8900,,25000,more than downpayment,,8900,16100
pLAyyklz,25000,7/16/2019,8900,pLAyyklz,50000,more than downpayment,more than downpayment,0,25000
pLAyyklz,3900,10/25/2019,8900,pLAyyklz,53900,more than downpayment,more than downpayment,0,3900
PLMBW9EI,8900,11/6/2019,9900,,8900,less than downpayment,,8900,0
PLMBW9EI,1000,11/28/2019,9900,PLMBW9EI,9900,equal to downpayment,less than downpayment,1000,0
PLNP7CU4,10000,11/4/2019,9900,,10000,more than downpayment,,9900,100
PLNP7CU4,4000,12/2/2019,9900,PLNP7CU4,14000,more than downpayment,more than downpayment,0,4000
PLNP7CU4,4000,1/7/2020,9900,PLNP7CU4,18000,more than downpayment,more than downpayment,0,4000
PLNP7CU4,4000,2/7/2020,9900,PLNP7CU4,22000,more than downpayment,more than downpayment,0,4000
PNA7qwP6,9900,2/15/2019,9900,,9900,equal to downpayment,,9900,0
PNA7qwP6,9000,3/14/2019,9900,PNA7qwP6,18900,more than downpayment,equal to downpayment,0,9000
PNA7qwP6,18000,4/16/2019,9900,PNA7qwP6,36900,more than downpayment,more than downpayment,0,18000
PNA7qwP6,27000,5/2/2019,9900,PNA7qwP6,63900,more than downpayment,more than downpayment,0,27000
PNlROcuI,9900,7/9/2019,9900,,9900,equal to downpayment,,9900,0
PNlROcuI,3900,9/2/2019,9900,PNlROcuI,13800,more than downpayment,equal to downpayment,0,3900
PNlROcuI,3900,10/2/2019,9900,PNlROcuI,17700,more than downpayment,more than downpayment,0,3900
PNlROcuI,3900,11/4/2019,9900,PNlROcuI,21600,more than downpayment,more than downpayment,0,3900
PNlROcuI,3900,12/2/2019,9900,PNlROcuI,25500,more than downpayment,more than downpayment,0,3900
PNlROcuI,3900,1/4/2020,9900,PNlROcuI,29400,more than downpayment,more than downpayment,0,3900
PNlROcuI,3900,2/4/2020,9900,PNlROcuI,33300,more than downpayment,more than downpayment,0,3900
pO4z925P,8900,8/27/2019,8900,,8900,equal to downpayment,,8900,0
pO4z925P,3900,10/25/2019,8900,pO4z925P,12800,more than downpayment,equal to downpayment,0,3900
pO4z925P,3900,11/25/2019,8900,pO4z925P,16700,more than downpayment,more than downpayment,0,3900
pO4z925P,3900,12/25/2019,8900,pO4z925P,20600,more than downpayment,more than downpayment,0,3900
pO4z925P,3900,1/25/2020,8900,pO4z925P,24500,more than downpayment,more than downpayment,0,3900
pO6TZ4jq,8900,4/23/2019,8900,,8900,equal to downpayment,,8900,0
pO6TZ4jq,3900,5/23/2019,8900,pO6TZ4jq,12800,more than downpayment,equal to downpayment,0,3900
pO6TZ4jq,3900,6/22/2019,8900,pO6TZ4jq,16700,more than downpayment,more than downpayment,0,3900
pO6TZ4jq,3900,7/19/2019,8900,pO6TZ4jq,20600,more than downpayment,more than downpayment,0,3900
pO6TZ4jq,3900,8/26/2019,8900,pO6TZ4jq,24500,more than downpayment,more than downpayment,0,3900
pO6TZ4jq,3900,9/25/2019,8900,pO6TZ4jq,28400,more than downpayment,more than downpayment,0,3900
pO6TZ4jq,3900,10/25/2019,8900,pO6TZ4jq,32300,more than downpayment,more than downpayment,0,3900
pO6TZ4jq,3900,11/26/2019,8900,pO6TZ4jq,36200,more than downpayment,more than downpayment,0,3900
pO6TZ4jq,3900,12/26/2019,8900,pO6TZ4jq,40100,more than downpayment,more than downpayment,0,3900
pO8E5NzX,9900,4/15/2019,9900,,9900,equal to downpayment,,9900,0
pO8E5NzX,4500,5/21/2019,9900,pO8E5NzX,14400,more than downpayment,equal to downpayment,0,4500
pO8E5NzX,4500,6/20/2019,9900,pO8E5NzX,18900,more than downpayment,more than downpayment,0,4500
pO8E5NzX,4500,7/22/2019,9900,pO8E5NzX,23400,more than downpayment,more than downpayment,0,4500
pO8E5NzX,4500,8/23/2019,9900,pO8E5NzX,27900,more than downpayment,more than downpayment,0,4500
pO8E5NzX,4500,9/24/2019,9900,pO8E5NzX,32400,more than downpayment,more than downpayment,0,4500
pO8E5NzX,4500,10/29/2019,9900,pO8E5NzX,36900,more than downpayment,more than downpayment,0,4500
pO8E5NzX,4500,11/25/2019,9900,pO8E5NzX,41400,more than downpayment,more than downpayment,0,4500
pO8E5NzX,4500,12/20/2019,9900,pO8E5NzX,45900,more than downpayment,more than downpayment,0,4500
pO8E5NzX,4500,1/27/2020,9900,pO8E5NzX,50400,more than downpayment,more than downpayment,0,4500
Po8OJmz5,9900,7/5/2019,9900,,9900,equal to downpayment,,9900,0
Po8OJmz5,3900,8/13/2019,9900,Po8OJmz5,13800,more than downpayment,equal to downpayment,0,3900
Po8OJmz5,3900,9/15/2019,9900,Po8OJmz5,17700,more than downpayment,more than downpayment,0,3900
Po8OJmz5,3900,10/15/2019,9900,Po8OJmz5,21600,more than downpayment,more than downpayment,0,3900
Po8OJmz5,3900,11/15/2019,9900,Po8OJmz5,25500,more than downpayment,more than downpayment,0,3900
Po8OJmz5,3900,12/20/2019,9900,Po8OJmz5,29400,more than downpayment,more than downpayment,0,3900
Po8OJmz5,3900,1/15/2020,9900,Po8OJmz5,33300,more than downpayment,more than downpayment,0,3900
pOhJOQbC,8900,4/18/2019,8900,,8900,equal to downpayment,,8900,0
pOhJOQbC,3900,5/27/2019,8900,pOhJOQbC,12800,more than downpayment,equal to downpayment,0,3900
pOhJOQbC,3900,6/1/2019,8900,pOhJOQbC,16700,more than downpayment,more than downpayment,0,3900
pOhJOQbC,3900,6/24/2019,8900,pOhJOQbC,20600,more than downpayment,more than downpayment,0,3900
pOhJOQbC,3900,8/9/2019,8900,pOhJOQbC,24500,more than downpayment,more than downpayment,0,3900
pOhJOQbC,3900,9/5/2019,8900,pOhJOQbC,28400,more than downpayment,more than downpayment,0,3900
pOhJOQbC,3900,11/4/2019,8900,pOhJOQbC,32300,more than downpayment,more than downpayment,0,3900
pOhJOQbC,3900,12/10/2019,8900,pOhJOQbC,36200,more than downpayment,more than downpayment,0,3900
pOhJOQbC,3900,1/5/2020,8900,pOhJOQbC,40100,more than downpayment,more than downpayment,0,3900
poT9d75n,10000,9/14/2017,10000,,10000,equal to downpayment,,10000,0
poT9d75n,2000,4/13/2018,10000,poT9d75n,12000,more than downpayment,equal to downpayment,0,2000
poT9d75n,2300,6/7/2018,10000,poT9d75n,14300,more than downpayment,more than downpayment,0,2300
poT9d75n,2400,6/20/2018,10000,poT9d75n,16700,more than downpayment,more than downpayment,0,2400
poT9d75n,1000,12/20/2018,10000,poT9d75n,17700,more than downpayment,more than downpayment,0,1000
PP5VHMBH,9900,10/27/2019,9900,,9900,equal to downpayment,,9900,0
PP5VHMBH,4000,11/14/2019,9900,PP5VHMBH,13900,more than downpayment,equal to downpayment,0,4000
PP5VHMBH,4000,1/2/2020,9900,PP5VHMBH,17900,more than downpayment,more than downpayment,0,4000
PP5VHMBH,3900,1/30/2020,9900,PP5VHMBH,21800,more than downpayment,more than downpayment,0,3900
PqEX5SkX,8901,7/23/2019,8900,,8901,more than downpayment,,8900,1
PqEX5SkX,3900,10/17/2019,8900,PqEX5SkX,12801,more than downpayment,more than downpayment,0,3900
PqEX5SkX,3900,11/19/2019,8900,PqEX5SkX,16701,more than downpayment,more than downpayment,0,3900
PqEX5SkX,3900,12/17/2019,8900,PqEX5SkX,20601,more than downpayment,more than downpayment,0,3900
PqEX5SkX,3900,1/17/2020,8900,PqEX5SkX,24501,more than downpayment,more than downpayment,0,3900
PQO7HKJ6,8900,7/19/2019,8900,,8900,equal to downpayment,,8900,0
PQO7HKJ6,4000,9/9/2019,8900,PQO7HKJ6,12900,more than downpayment,equal to downpayment,0,4000
PQO7HKJ6,4000,10/11/2019,8900,PQO7HKJ6,16900,more than downpayment,more than downpayment,0,4000
PQO7HKJ6,4000,11/2/2019,8900,PQO7HKJ6,20900,more than downpayment,more than downpayment,0,4000
PQO7HKJ6,4000,12/13/2019,8900,PQO7HKJ6,24900,more than downpayment,more than downpayment,0,4000
PQO7HKJ6,4000,1/7/2020,8900,PQO7HKJ6,28900,more than downpayment,more than downpayment,0,4000
PR2WpEgs,8900,1/12/2019,8900,,8900,equal to downpayment,,8900,0
PR2WpEgs,3900,3/4/2019,8900,PR2WpEgs,12800,more than downpayment,equal to downpayment,0,3900
PR2WpEgs,3900,4/4/2019,8900,PR2WpEgs,16700,more than downpayment,more than downpayment,0,3900
PR2WpEgs,3900,5/6/2019,8900,PR2WpEgs,20600,more than downpayment,more than downpayment,0,3900
PR2WpEgs,3900,6/4/2019,8900,PR2WpEgs,24500,more than downpayment,more than downpayment,0,3900
PR2WpEgs,3900,7/5/2019,8900,PR2WpEgs,28400,more than downpayment,more than downpayment,0,3900
PR2WpEgs,3900,8/5/2019,8900,PR2WpEgs,32300,more than downpayment,more than downpayment,0,3900
PR2WpEgs,3900,9/7/2019,8900,PR2WpEgs,36200,more than downpayment,more than downpayment,0,3900
PR2WpEgs,3900,10/4/2019,8900,PR2WpEgs,40100,more than downpayment,more than downpayment,0,3900
PR2WpEgs,3900,11/6/2019,8900,PR2WpEgs,44000,more than downpayment,more than downpayment,0,3900
PR2WpEgs,3900,12/2/2019,8900,PR2WpEgs,47900,more than downpayment,more than downpayment,0,3900
PR2WpEgs,3900,1/5/2020,8900,PR2WpEgs,51800,more than downpayment,more than downpayment,0,3900
PR2WpEgs,3900,2/3/2020,8900,PR2WpEgs,55700,more than downpayment,more than downpayment,0,3900
pRQw13ad,8900,5/27/2019,8900,,8900,equal to downpayment,,8900,0
pRQw13ad,3900,7/1/2019,8900,pRQw13ad,12800,more than downpayment,equal to downpayment,0,3900
pRQw13ad,3900,8/5/2019,8900,pRQw13ad,16700,more than downpayment,more than downpayment,0,3900
pRQw13ad,3900,8/31/2019,8900,pRQw13ad,20600,more than downpayment,more than downpayment,0,3900
pRQw13ad,3900,10/3/2019,8900,pRQw13ad,24500,more than downpayment,more than downpayment,0,3900
pRQw13ad,3900,11/1/2019,8900,pRQw13ad,28400,more than downpayment,more than downpayment,0,3900
pRQw13ad,3900,12/1/2019,8900,pRQw13ad,32300,more than downpayment,more than downpayment,0,3900
pRQw13ad,3900,1/2/2020,8900,pRQw13ad,36200,more than downpayment,more than downpayment,0,3900
pRQw13ad,3900,1/31/2020,8900,pRQw13ad,40100,more than downpayment,more than downpayment,0,3900
PS7O5E5P,8900,10/31/2019,8900,,8900,equal to downpayment,,8900,0
PS7O5E5P,3900,12/6/2019,8900,PS7O5E5P,12800,more than downpayment,equal to downpayment,0,3900
PS7O5E5P,3900,1/8/2020,8900,PS7O5E5P,16700,more than downpayment,more than downpayment,0,3900
PT9M1BMW,10000,12/18/2019,9900,,10000,more than downpayment,,9900,100
PtBefNXY,9000,4/5/2019,8900,,9000,more than downpayment,,8900,100
PtBefNXY,4000,5/15/2019,8900,PtBefNXY,13000,more than downpayment,more than downpayment,0,4000
PtBefNXY,3000,6/16/2019,8900,PtBefNXY,16000,more than downpayment,more than downpayment,0,3000
PtBefNXY,1000,6/17/2019,8900,PtBefNXY,17000,more than downpayment,more than downpayment,0,1000
PtBefNXY,3850,7/15/2019,8900,PtBefNXY,20850,more than downpayment,more than downpayment,0,3850
PtBefNXY,3900,8/15/2019,8900,PtBefNXY,24750,more than downpayment,more than downpayment,0,3900
PtBefNXY,3900,9/16/2019,8900,PtBefNXY,28650,more than downpayment,more than downpayment,0,3900
PtBefNXY,4000,10/29/2019,8900,PtBefNXY,32650,more than downpayment,more than downpayment,0,4000
PtBefNXY,4000,11/29/2019,8900,PtBefNXY,36650,more than downpayment,more than downpayment,0,4000
PtBefNXY,2000,1/9/2020,8900,PtBefNXY,38650,more than downpayment,more than downpayment,0,2000
PtBefNXY,1500,1/20/2020,8900,PtBefNXY,40150,more than downpayment,more than downpayment,0,1500
PtBefNXY,1000,2/2/2020,8900,PtBefNXY,41150,more than downpayment,more than downpayment,0,1000
PtBefNXY,500,2/3/2020,8900,PtBefNXY,41650,more than downpayment,more than downpayment,0,500
PtBefNXY,1000,2/6/2020,8900,PtBefNXY,42650,more than downpayment,more than downpayment,0,1000
PU1KSB8D,2000,6/27/2019,1999,,2000,more than downpayment,,1999,1
PU1KSB8D,5000,10/28/2019,1999,PU1KSB8D,7000,more than downpayment,more than downpayment,0,5000
PU1KSB8D,3500,2/9/2020,1999,PU1KSB8D,10500,more than downpayment,more than downpayment,0,3500
PVV95U7I,8900,1/6/2020,8900,,8900,equal to downpayment,,8900,0
PWGNC6VH,8900,11/13/2019,8900,,8900,equal to downpayment,,8900,0
PWGNC6VH,3900,1/23/2020,8900,PWGNC6VH,12800,more than downpayment,equal to downpayment,0,3900
pWNgISPQ,8900,4/8/2019,23400,,8900,less than downpayment,,8900,0
pWNgISPQ,8000,5/15/2019,23400,pWNgISPQ,16900,less than downpayment,less than downpayment,8000,0
pWNgISPQ,5000,5/20/2019,23400,pWNgISPQ,21900,less than downpayment,less than downpayment,5000,0
pWNgISPQ,12000,6/22/2019,23400,pWNgISPQ,33900,more than downpayment,less than downpayment,1500,10500
pWNgISPQ,50000,7/15/2019,23400,pWNgISPQ,83900,more than downpayment,more than downpayment,0,50000
pWNgISPQ,20000,10/21/2019,23400,pWNgISPQ,103900,more than downpayment,more than downpayment,0,20000
pWNgISPQ,7100,11/19/2019,23400,pWNgISPQ,111000,more than downpayment,more than downpayment,0,7100
PwoECROd,8900,3/4/2019,8900,,8900,equal to downpayment,,8900,0
PwoECROd,3900,4/8/2019,8900,PwoECROd,12800,more than downpayment,equal to downpayment,0,3900
PwoECROd,3900,5/14/2019,8900,PwoECROd,16700,more than downpayment,more than downpayment,0,3900
PwoECROd,3900,6/9/2019,8900,PwoECROd,20600,more than downpayment,more than downpayment,0,3900
PwoECROd,3900,7/15/2019,8900,PwoECROd,24500,more than downpayment,more than downpayment,0,3900
PwoECROd,3900,8/13/2019,8900,PwoECROd,28400,more than downpayment,more than downpayment,0,3900
PwoECROd,15000,12/10/2019,8900,PwoECROd,43400,more than downpayment,more than downpayment,0,15000
PwoECROd,600,1/15/2020,8900,PwoECROd,44000,more than downpayment,more than downpayment,0,600
PwoECROd,3900,1/27/2020,8900,PwoECROd,47900,more than downpayment,more than downpayment,0,3900
PwYXwwaM,8900,3/29/2019,8900,,8900,equal to downpayment,,8900,0
PwYXwwaM,11700,5/2/2019,8900,PwYXwwaM,20600,more than downpayment,equal to downpayment,0,11700
PwYXwwaM,3900,7/29/2019,8900,PwYXwwaM,24500,more than downpayment,more than downpayment,0,3900
PwYXwwaM,1000,9/4/2019,8900,PwYXwwaM,25500,more than downpayment,more than downpayment,0,1000
PwYXwwaM,2500,9/6/2019,8900,PwYXwwaM,28000,more than downpayment,more than downpayment,0,2500
PwYXwwaM,400,10/1/2019,8900,PwYXwwaM,28400,more than downpayment,more than downpayment,0,400
PwYXwwaM,2300,10/3/2019,8900,PwYXwwaM,30700,more than downpayment,more than downpayment,0,2300
PwYXwwaM,1700,10/10/2019,8900,PwYXwwaM,32400,more than downpayment,more than downpayment,0,1700
PwYXwwaM,4900,2/3/2020,8900,PwYXwwaM,37300,more than downpayment,more than downpayment,0,4900
PwYXwwaM,2000,2/7/2020,8900,PwYXwwaM,39300,more than downpayment,more than downpayment,0,2000
PX617S3D,9900,11/20/2019,9900,,9900,equal to downpayment,,9900,0
PX617S3D,3900,1/5/2020,9900,PX617S3D,13800,more than downpayment,equal to downpayment,0,3900
PX617S3D,3900,2/4/2020,9900,PX617S3D,17700,more than downpayment,more than downpayment,0,3900
PXXqZWku,9900,7/13/2019,9900,,9900,equal to downpayment,,9900,0
PXXqZWku,3900,9/15/2019,9900,PXXqZWku,13800,more than downpayment,equal to downpayment,0,3900
PXXqZWku,3900,10/14/2019,9900,PXXqZWku,17700,more than downpayment,more than downpayment,0,3900
PXXqZWku,3900,11/15/2019,9900,PXXqZWku,21600,more than downpayment,more than downpayment,0,3900
PXXqZWku,3900,12/16/2019,9900,PXXqZWku,25500,more than downpayment,more than downpayment,0,3900
PXXqZWku,3900,1/15/2020,9900,PXXqZWku,29400,more than downpayment,more than downpayment,0,3900
pYILSQe1,9900,7/2/2019,9900,,9900,equal to downpayment,,9900,0
pYILSQe1,3900,9/3/2019,9900,pYILSQe1,13800,more than downpayment,equal to downpayment,0,3900
pYILSQe1,3900,10/3/2019,9900,pYILSQe1,17700,more than downpayment,more than downpayment,0,3900
pYILSQe1,3900,11/4/2019,9900,pYILSQe1,21600,more than downpayment,more than downpayment,0,3900
pYILSQe1,3900,12/7/2019,9900,pYILSQe1,25500,more than downpayment,more than downpayment,0,3900
pYILSQe1,7000,2/3/2020,9900,pYILSQe1,32500,more than downpayment,more than downpayment,0,7000
pYPF2jcE,10000,2/22/2019,9900,,10000,more than downpayment,,9900,100
pYPF2jcE,4500,3/22/2019,9900,pYPF2jcE,14500,more than downpayment,more than downpayment,0,4500
pYPF2jcE,5000,5/2/2019,9900,pYPF2jcE,19500,more than downpayment,more than downpayment,0,5000
pYPF2jcE,4500,6/4/2019,9900,pYPF2jcE,24000,more than downpayment,more than downpayment,0,4500
pYPF2jcE,4500,6/29/2019,9900,pYPF2jcE,28500,more than downpayment,more than downpayment,0,4500
pYPF2jcE,4500,8/8/2019,9900,pYPF2jcE,33000,more than downpayment,more than downpayment,0,4500
pYPF2jcE,4500,9/6/2019,9900,pYPF2jcE,37500,more than downpayment,more than downpayment,0,4500
PZ9jPLFY,8900,4/16/2019,8900,,8900,equal to downpayment,,8900,0
PZ9jPLFY,3000,5/30/2019,8900,PZ9jPLFY,11900,more than downpayment,equal to downpayment,0,3000
PZ9jPLFY,900,5/31/2019,8900,PZ9jPLFY,12800,more than downpayment,more than downpayment,0,900
PZ9jPLFY,3500,7/4/2019,8900,PZ9jPLFY,16300,more than downpayment,more than downpayment,0,3500
PZ9jPLFY,400,7/11/2019,8900,PZ9jPLFY,16700,more than downpayment,more than downpayment,0,400
PZ9jPLFY,3900,8/1/2019,8900,PZ9jPLFY,20600,more than downpayment,more than downpayment,0,3900
PZ9jPLFY,900,9/11/2019,8900,PZ9jPLFY,21500,more than downpayment,more than downpayment,0,900
PZ9jPLFY,1400,9/17/2019,8900,PZ9jPLFY,22900,more than downpayment,more than downpayment,0,1400
PZ9jPLFY,1800,9/20/2019,8900,PZ9jPLFY,24700,more than downpayment,more than downpayment,0,1800
PZ9jPLFY,3700,10/14/2019,8900,PZ9jPLFY,28400,more than downpayment,more than downpayment,0,3700
PZ9jPLFY,2000,11/22/2019,8900,PZ9jPLFY,30400,more than downpayment,more than downpayment,0,2000
PZ9jPLFY,2000,12/6/2019,8900,PZ9jPLFY,32400,more than downpayment,more than downpayment,0,2000
PZ9jPLFY,3800,12/25/2019,8900,PZ9jPLFY,36200,more than downpayment,more than downpayment,0,3800
PZ9jPLFY,3500,12/30/2019,8900,PZ9jPLFY,39700,more than downpayment,more than downpayment,0,3500
PZ9jPLFY,1400,1/3/2020,8900,PZ9jPLFY,41100,more than downpayment,more than downpayment,0,1400
PZ9jPLFY,2900,2/3/2020,8900,PZ9jPLFY,44000,more than downpayment,more than downpayment,0,2900
q123tzmy,100,6/4/2019,8900,,100,less than downpayment,,100,0
q123tzmy,2,8/14/2019,8900,q123tzmy,102,less than downpayment,less than downpayment,2,0
Q1EVR7O8,9900,10/9/2019,9900,,9900,equal to downpayment,,9900,0
Q1EVR7O8,3900,11/25/2019,9900,Q1EVR7O8,13800,more than downpayment,equal to downpayment,0,3900
Q1EVR7O8,3900,12/31/2019,9900,Q1EVR7O8,17700,more than downpayment,more than downpayment,0,3900
Q1EVR7O8,3900,1/24/2020,9900,Q1EVR7O8,21600,more than downpayment,more than downpayment,0,3900
Q1FZNKSL,9900,11/6/2019,9900,,9900,equal to downpayment,,9900,0
Q1FZNKSL,3900,12/6/2019,9900,Q1FZNKSL,13800,more than downpayment,equal to downpayment,0,3900
Q1FZNKSL,3900,1/9/2020,9900,Q1FZNKSL,17700,more than downpayment,more than downpayment,0,3900
Q1KLY56E,100,11/14/2019,9900,,100,less than downpayment,,100,0
Q1KLY56E,100,11/15/2019,9900,Q1KLY56E,200,less than downpayment,less than downpayment,100,0
Q1KLY56E,100,11/16/2019,9900,Q1KLY56E,300,less than downpayment,less than downpayment,100,0
Q1KLY56E,500,11/21/2019,9900,Q1KLY56E,800,less than downpayment,less than downpayment,500,0
Q235WOH6,9900,6/13/2019,8900,,9900,more than downpayment,,8900,1000
Q235WOH6,3900,8/30/2019,8900,Q235WOH6,13800,more than downpayment,more than downpayment,0,3900
Q235WOH6,3900,9/17/2019,8900,Q235WOH6,17700,more than downpayment,more than downpayment,0,3900
Q235WOH6,3900,10/17/2019,8900,Q235WOH6,21600,more than downpayment,more than downpayment,0,3900
Q235WOH6,3900,12/4/2019,8900,Q235WOH6,25500,more than downpayment,more than downpayment,0,3900
Q235WOH6,3900,12/26/2019,8900,Q235WOH6,29400,more than downpayment,more than downpayment,0,3900
Q235WOH6,3900,1/27/2020,8900,Q235WOH6,33300,more than downpayment,more than downpayment,0,3900
Q25WCZKO,9900,9/30/2019,9900,,9900,equal to downpayment,,9900,0
Q25WCZKO,15000,10/28/2019,9900,Q25WCZKO,24900,more than downpayment,equal to downpayment,0,15000
Q25WCZKO,15000,11/27/2019,9900,Q25WCZKO,39900,more than downpayment,more than downpayment,0,15000
Q25WCZKO,10000,12/26/2019,9900,Q25WCZKO,49900,more than downpayment,more than downpayment,0,10000
Q25WCZKO,5000,1/26/2020,9900,Q25WCZKO,54900,more than downpayment,more than downpayment,0,5000
q2mynOcA,10000,6/19/2017,10000,,10000,equal to downpayment,,10000,0
q2mynOcA,3500,10/11/2017,10000,q2mynOcA,13500,more than downpayment,equal to downpayment,0,3500
q2mynOcA,3500,11/14/2017,10000,q2mynOcA,17000,more than downpayment,more than downpayment,0,3500
q2mynOcA,3560,1/14/2018,10000,q2mynOcA,20560,more than downpayment,more than downpayment,0,3560
q2mynOcA,2700,2/16/2018,10000,q2mynOcA,23260,more than downpayment,more than downpayment,0,2700
q2mynOcA,3000,2/23/2018,10000,q2mynOcA,26260,more than downpayment,more than downpayment,0,3000
q2mynOcA,3000,3/23/2018,10000,q2mynOcA,29260,more than downpayment,more than downpayment,0,3000
q2mynOcA,3500,5/26/2018,10000,q2mynOcA,32760,more than downpayment,more than downpayment,0,3500
q2mynOcA,7000,7/20/2018,10000,q2mynOcA,39760,more than downpayment,more than downpayment,0,7000
q2mynOcA,240,8/14/2018,10000,q2mynOcA,40000,more than downpayment,more than downpayment,0,240
Q3okeMHm,9900,6/7/2019,9900,,9900,equal to downpayment,,9900,0
Q3okeMHm,3900,7/19/2019,9900,Q3okeMHm,13800,more than downpayment,equal to downpayment,0,3900
Q3okeMHm,3900,8/23/2019,9900,Q3okeMHm,17700,more than downpayment,more than downpayment,0,3900
Q3okeMHm,3900,9/23/2019,9900,Q3okeMHm,21600,more than downpayment,more than downpayment,0,3900
Q3okeMHm,3900,10/23/2019,9900,Q3okeMHm,25500,more than downpayment,more than downpayment,0,3900
Q3okeMHm,3900,11/23/2019,9900,Q3okeMHm,29400,more than downpayment,more than downpayment,0,3900
Q3okeMHm,3900,12/18/2019,9900,Q3okeMHm,33300,more than downpayment,more than downpayment,0,3900
Q3okeMHm,3900,1/23/2020,9900,Q3okeMHm,37200,more than downpayment,more than downpayment,0,3900
Q3Ov3H7g,8900,4/12/2019,8900,,8900,equal to downpayment,,8900,0
Q3Ov3H7g,3900,5/15/2019,8900,Q3Ov3H7g,12800,more than downpayment,equal to downpayment,0,3900
Q3Ov3H7g,3900,6/15/2019,8900,Q3Ov3H7g,16700,more than downpayment,more than downpayment,0,3900
Q3Ov3H7g,3900,7/15/2019,8900,Q3Ov3H7g,20600,more than downpayment,more than downpayment,0,3900
Q3Ov3H7g,3900,8/16/2019,8900,Q3Ov3H7g,24500,more than downpayment,more than downpayment,0,3900
Q3Ov3H7g,3900,9/17/2019,8900,Q3Ov3H7g,28400,more than downpayment,more than downpayment,0,3900
Q3Ov3H7g,3900,10/26/2019,8900,Q3Ov3H7g,32300,more than downpayment,more than downpayment,0,3900
Q3Ov3H7g,3900,11/20/2019,8900,Q3Ov3H7g,36200,more than downpayment,more than downpayment,0,3900
Q3Ov3H7g,3900,1/6/2020,8900,Q3Ov3H7g,40100,more than downpayment,more than downpayment,0,3900
Q3Ov3H7g,3900,1/27/2020,8900,Q3Ov3H7g,44000,more than downpayment,more than downpayment,0,3900
Q3xvUNBM,2500,2/25/2019,8900,,2500,less than downpayment,,2500,0
Q3xvUNBM,8900,3/28/2019,8900,Q3xvUNBM,11400,more than downpayment,less than downpayment,6400,2500
Q3xvUNBM,3900,5/4/2019,8900,Q3xvUNBM,15300,more than downpayment,more than downpayment,0,3900
Q3xvUNBM,3900,6/5/2019,8900,Q3xvUNBM,19200,more than downpayment,more than downpayment,0,3900
Q3xvUNBM,3900,7/5/2019,8900,Q3xvUNBM,23100,more than downpayment,more than downpayment,0,3900
Q3xvUNBM,3900,8/9/2019,8900,Q3xvUNBM,27000,more than downpayment,more than downpayment,0,3900
Q3xvUNBM,3900,9/7/2019,8900,Q3xvUNBM,30900,more than downpayment,more than downpayment,0,3900
Q3xvUNBM,3900,10/7/2019,8900,Q3xvUNBM,34800,more than downpayment,more than downpayment,0,3900
Q3xvUNBM,3900,11/6/2019,8900,Q3xvUNBM,38700,more than downpayment,more than downpayment,0,3900
Q3xvUNBM,3900,12/13/2019,8900,Q3xvUNBM,42600,more than downpayment,more than downpayment,0,3900
Q3xvUNBM,3900,1/4/2020,8900,Q3xvUNBM,46500,more than downpayment,more than downpayment,0,3900
Q3xvUNBM,3900,2/5/2020,8900,Q3xvUNBM,50400,more than downpayment,more than downpayment,0,3900
Q4O6QOFQ,9900,1/13/2020,9900,,9900,equal to downpayment,,9900,0
Q5wesaEZ,8900,8/30/2019,8900,,8900,equal to downpayment,,8900,0
Q5wesaEZ,3900,11/15/2019,8900,Q5wesaEZ,12800,more than downpayment,equal to downpayment,0,3900
Q5wesaEZ,3900,1/15/2020,8900,Q5wesaEZ,16700,more than downpayment,more than downpayment,0,3900
Q5wesaEZ,3900,1/16/2020,8900,Q5wesaEZ,20600,more than downpayment,more than downpayment,0,3900
Q6V1D7OY,9900,6/14/2019,8900,,9900,more than downpayment,,8900,1000
Q6V1D7OY,3900,8/5/2019,8900,Q6V1D7OY,13800,more than downpayment,more than downpayment,0,3900
Q6V1D7OY,3900,9/5/2019,8900,Q6V1D7OY,17700,more than downpayment,more than downpayment,0,3900
Q6V1D7OY,3900,10/5/2019,8900,Q6V1D7OY,21600,more than downpayment,more than downpayment,0,3900
Q6V1D7OY,3900,11/5/2019,8900,Q6V1D7OY,25500,more than downpayment,more than downpayment,0,3900
Q6V1D7OY,3900,12/5/2019,8900,Q6V1D7OY,29400,more than downpayment,more than downpayment,0,3900
Q6V1D7OY,3900,12/26/2019,8900,Q6V1D7OY,33300,more than downpayment,more than downpayment,0,3900
Q6V1D7OY,3900,2/4/2020,8900,Q6V1D7OY,37200,more than downpayment,more than downpayment,0,3900
Q8ZXKRGP,10000,12/2/2019,9900,,10000,more than downpayment,,9900,100
Q8ZXKRGP,3900,1/28/2020,9900,Q8ZXKRGP,13900,more than downpayment,more than downpayment,0,3900
Q96Z5KN1,4000,12/22/2019,9900,,4000,less than downpayment,,4000,0
Q9C8QLDM,10000,10/10/2019,9900,,10000,more than downpayment,,9900,100
Q9C8QLDM,4600,12/4/2019,9900,Q9C8QLDM,14600,more than downpayment,more than downpayment,0,4600
Q9C8QLDM,4600,1/5/2020,9900,Q9C8QLDM,19200,more than downpayment,more than downpayment,0,4600
Q9C8QLDM,4600,2/5/2020,9900,Q9C8QLDM,23800,more than downpayment,more than downpayment,0,4600
Q9F7277B,470,11/21/2019,8900,,470,less than downpayment,,470,0
Q9F7277B,430,11/24/2019,8900,Q9F7277B,900,less than downpayment,less than downpayment,430,0
Q9F7277B,8000,1/16/2020,8900,Q9F7277B,8900,equal to downpayment,less than downpayment,8000,0
QASY7WKL,9900,1/7/2020,8900,,9900,more than downpayment,,8900,1000
QB94S5FN,9900,11/7/2019,9900,,9900,equal to downpayment,,9900,0
QB94S5FN,3900,12/14/2019,9900,QB94S5FN,13800,more than downpayment,equal to downpayment,0,3900
QB94S5FN,3900,1/27/2020,9900,QB94S5FN,17700,more than downpayment,more than downpayment,0,3900
QBAFFIIX,9990,6/7/2019,8900,,9990,more than downpayment,,8900,1090
QBAFFIIX,3900,8/5/2019,8900,QBAFFIIX,13890,more than downpayment,more than downpayment,0,3900
QBAFFIIX,3990,9/4/2019,8900,QBAFFIIX,17880,more than downpayment,more than downpayment,0,3990
QBAFFIIX,3990,10/5/2019,8900,QBAFFIIX,21870,more than downpayment,more than downpayment,0,3990
QBAFFIIX,3900,11/4/2019,8900,QBAFFIIX,25770,more than downpayment,more than downpayment,0,3900
QBAFFIIX,1000,12/3/2019,8900,QBAFFIIX,26770,more than downpayment,more than downpayment,0,1000
QBAFFIIX,2000,12/4/2019,8900,QBAFFIIX,28770,more than downpayment,more than downpayment,0,2000
QBAFFIIX,900,12/5/2019,8900,QBAFFIIX,29670,more than downpayment,more than downpayment,0,900
QBAFFIIX,3900,1/5/2020,8900,QBAFFIIX,33570,more than downpayment,more than downpayment,0,3900
QBAFFIIX,3900,2/5/2020,8900,QBAFFIIX,37470,more than downpayment,more than downpayment,0,3900
qBBm95ZQ,10000,9/15/2017,10000,,10000,equal to downpayment,,10000,0
QBOYs6J2,9900,6/10/2019,8900,,9900,more than downpayment,,8900,1000
QBOYs6J2,3900,8/3/2019,8900,QBOYs6J2,13800,more than downpayment,more than downpayment,0,3900
QBOYs6J2,3900,9/15/2019,8900,QBOYs6J2,17700,more than downpayment,more than downpayment,0,3900
QBOYs6J2,3900,10/4/2019,8900,QBOYs6J2,21600,more than downpayment,more than downpayment,0,3900
QBOYs6J2,3900,10/17/2019,8900,QBOYs6J2,25500,more than downpayment,more than downpayment,0,3900
QBOYs6J2,2500,11/29/2019,8900,QBOYs6J2,28000,more than downpayment,more than downpayment,0,2500
QBOYs6J2,1400,12/19/2019,8900,QBOYs6J2,29400,more than downpayment,more than downpayment,0,1400
QBOYs6J2,4000,1/20/2020,8900,QBOYs6J2,33400,more than downpayment,more than downpayment,0,4000
qcJThry6,10000,11/26/2018,10000,,10000,equal to downpayment,,10000,0
qcJThry6,4500,12/20/2018,10000,qcJThry6,14500,more than downpayment,equal to downpayment,0,4500
qcJThry6,4450,1/31/2019,10000,qcJThry6,18950,more than downpayment,more than downpayment,0,4450
qcJThry6,4550,2/24/2019,10000,qcJThry6,23500,more than downpayment,more than downpayment,0,4550
qcJThry6,3500,4/8/2019,10000,qcJThry6,27000,more than downpayment,more than downpayment,0,3500
qcJThry6,2600,5/10/2019,10000,qcJThry6,29600,more than downpayment,more than downpayment,0,2600
qcJThry6,3500,6/6/2019,10000,qcJThry6,33100,more than downpayment,more than downpayment,0,3500
qcJThry6,4500,6/22/2019,10000,qcJThry6,37600,more than downpayment,more than downpayment,0,4500
qcJThry6,5000,7/27/2019,10000,qcJThry6,42600,more than downpayment,more than downpayment,0,5000
qcJThry6,4500,10/3/2019,10000,qcJThry6,47100,more than downpayment,more than downpayment,0,4500
qcJThry6,3000,1/15/2020,10000,qcJThry6,50100,more than downpayment,more than downpayment,0,3000
qcJThry6,2000,1/24/2020,10000,qcJThry6,52100,more than downpayment,more than downpayment,0,2000
QDP3PEU8,8900,11/4/2019,8900,,8900,equal to downpayment,,8900,0
QDP3PEU8,3900,12/26/2019,8900,QDP3PEU8,12800,more than downpayment,equal to downpayment,0,3900
QDP3PEU8,3900,1/27/2020,8900,QDP3PEU8,16700,more than downpayment,more than downpayment,0,3900
QEQIZTH9,8900,9/2/2019,8900,,8900,equal to downpayment,,8900,0
QEQIZTH9,3900,10/25/2019,8900,QEQIZTH9,12800,more than downpayment,equal to downpayment,0,3900
QEQIZTH9,3900,11/25/2019,8900,QEQIZTH9,16700,more than downpayment,more than downpayment,0,3900
QEQIZTH9,3900,12/26/2019,8900,QEQIZTH9,20600,more than downpayment,more than downpayment,0,3900
QEQIZTH9,3900,1/20/2020,8900,QEQIZTH9,24500,more than downpayment,more than downpayment,0,3900
QFCOILZR,9900,11/30/2019,9900,,9900,equal to downpayment,,9900,0
qGJSWk24,12800,2/28/2019,8900,,12800,more than downpayment,,8900,3900
qGJSWk24,990,7/1/2019,8900,qGJSWk24,13790,more than downpayment,more than downpayment,0,990
qGJSWk24,10000,10/16/2019,8900,qGJSWk24,23790,more than downpayment,more than downpayment,0,10000
qGJSWk24,3900,10/31/2019,8900,qGJSWk24,27690,more than downpayment,more than downpayment,0,3900
qGJSWk24,8000,12/24/2019,8900,qGJSWk24,35690,more than downpayment,more than downpayment,0,8000
qGJSWk24,8510,1/30/2020,8900,qGJSWk24,44200,more than downpayment,more than downpayment,0,8510
QH9wIi98,9000,8/5/2019,9900,,9000,less than downpayment,,9000,0
QH9wIi98,900,8/9/2019,9900,QH9wIi98,9900,equal to downpayment,less than downpayment,900,0
QH9wIi98,4000,9/25/2019,9900,QH9wIi98,13900,more than downpayment,equal to downpayment,0,4000
QH9wIi98,2000,11/11/2019,9900,QH9wIi98,15900,more than downpayment,more than downpayment,0,2000
QH9wIi98,5000,12/16/2019,9900,QH9wIi98,20900,more than downpayment,more than downpayment,0,5000
QH9wIi98,2500,1/14/2020,9900,QH9wIi98,23400,more than downpayment,more than downpayment,0,2500
QH9wIi98,1500,1/15/2020,9900,QH9wIi98,24900,more than downpayment,more than downpayment,0,1500
QH9wIi98,5000,1/16/2020,9900,QH9wIi98,29900,more than downpayment,more than downpayment,0,5000
QHE1S8JE,9900,6/5/2019,8900,,9900,more than downpayment,,8900,1000
QHE1S8JE,3900,7/30/2019,8900,QHE1S8JE,13800,more than downpayment,more than downpayment,0,3900
QHE1S8JE,3900,8/30/2019,8900,QHE1S8JE,17700,more than downpayment,more than downpayment,0,3900
QHE1S8JE,3900,10/3/2019,8900,QHE1S8JE,21600,more than downpayment,more than downpayment,0,3900
QHE1S8JE,3900,10/31/2019,8900,QHE1S8JE,25500,more than downpayment,more than downpayment,0,3900
QHE1S8JE,1000,12/5/2019,8900,QHE1S8JE,26500,more than downpayment,more than downpayment,0,1000
QHE1S8JE,1000,12/16/2019,8900,QHE1S8JE,27500,more than downpayment,more than downpayment,0,1000
QHE1S8JE,1000,1/24/2020,8900,QHE1S8JE,28500,more than downpayment,more than downpayment,0,1000
QHE1S8JE,1500,2/1/2020,8900,QHE1S8JE,30000,more than downpayment,more than downpayment,0,1500
QIF5G8O7,28400,9/16/2019,8900,,28400,more than downpayment,,8900,19500
QILIO5H2,9900,8/22/2019,9900,,9900,equal to downpayment,,9900,0
QILIO5H2,9900,9/14/2019,9900,QILIO5H2,19800,more than downpayment,equal to downpayment,0,9900
QILIO5H2,3900,10/31/2019,9900,QILIO5H2,23700,more than downpayment,more than downpayment,0,3900
QILIO5H2,3900,12/6/2019,9900,QILIO5H2,27600,more than downpayment,more than downpayment,0,3900
QILIO5H2,3900,12/22/2019,9900,QILIO5H2,31500,more than downpayment,more than downpayment,0,3900
QITAKFU4,9900,11/16/2019,9900,,9900,equal to downpayment,,9900,0
QITAKFU4,3900,1/25/2020,9900,QITAKFU4,13800,more than downpayment,equal to downpayment,0,3900
qjHmpEGX,10000,9/20/2017,10000,,10000,equal to downpayment,,10000,0
qjHmpEGX,7000,1/11/2018,10000,qjHmpEGX,17000,more than downpayment,equal to downpayment,0,7000
qjHmpEGX,6700,1/19/2018,10000,qjHmpEGX,23700,more than downpayment,more than downpayment,0,6700
qjHmpEGX,6000,2/15/2018,10000,qjHmpEGX,29700,more than downpayment,more than downpayment,0,6000
qjHmpEGX,7000,4/6/2018,10000,qjHmpEGX,36700,more than downpayment,more than downpayment,0,7000
qjHmpEGX,7000,5/14/2018,10000,qjHmpEGX,43700,more than downpayment,more than downpayment,0,7000
qjHmpEGX,5000,6/13/2018,10000,qjHmpEGX,48700,more than downpayment,more than downpayment,0,5000
qjHmpEGX,3500,7/19/2018,10000,qjHmpEGX,52200,more than downpayment,more than downpayment,0,3500
QJX2D4GD,9900,12/9/2019,9900,,9900,equal to downpayment,,9900,0
Ql7KsUrp,9000,1/9/2019,8900,,9000,more than downpayment,,8900,100
Ql7KsUrp,4000,2/12/2019,8900,Ql7KsUrp,13000,more than downpayment,more than downpayment,0,4000
Ql7KsUrp,4000,3/15/2019,8900,Ql7KsUrp,17000,more than downpayment,more than downpayment,0,4000
Ql7KsUrp,3900,4/13/2019,8900,Ql7KsUrp,20900,more than downpayment,more than downpayment,0,3900
Ql7KsUrp,3900,5/14/2019,8900,Ql7KsUrp,24800,more than downpayment,more than downpayment,0,3900
Ql7KsUrp,1000,6/28/2019,8900,Ql7KsUrp,25800,more than downpayment,more than downpayment,0,1000
Ql7KsUrp,1000,7/15/2019,8900,Ql7KsUrp,26800,more than downpayment,more than downpayment,0,1000
Ql7KsUrp,1000,8/24/2019,8900,Ql7KsUrp,27800,more than downpayment,more than downpayment,0,1000
Ql7KsUrp,2000,9/17/2019,8900,Ql7KsUrp,29800,more than downpayment,more than downpayment,0,2000
Ql7KsUrp,2000,10/16/2019,8900,Ql7KsUrp,31800,more than downpayment,more than downpayment,0,2000
Ql7KsUrp,1400,10/22/2019,8900,Ql7KsUrp,33200,more than downpayment,more than downpayment,0,1400
Ql7KsUrp,1500,10/30/2019,8900,Ql7KsUrp,34700,more than downpayment,more than downpayment,0,1500
Ql7KsUrp,2000,11/6/2019,8900,Ql7KsUrp,36700,more than downpayment,more than downpayment,0,2000
Ql7KsUrp,1000,11/8/2019,8900,Ql7KsUrp,37700,more than downpayment,more than downpayment,0,1000
Ql7KsUrp,2000,11/12/2019,8900,Ql7KsUrp,39700,more than downpayment,more than downpayment,0,2000
Ql7KsUrp,2000,11/25/2019,8900,Ql7KsUrp,41700,more than downpayment,more than downpayment,0,2000
QlhkgZXH,8900,5/16/2019,8900,,8900,equal to downpayment,,8900,0
QlhkgZXH,3900,6/26/2019,8900,QlhkgZXH,12800,more than downpayment,equal to downpayment,0,3900
QlhkgZXH,4300,7/22/2019,8900,QlhkgZXH,17100,more than downpayment,more than downpayment,0,4300
QlhkgZXH,3900,8/28/2019,8900,QlhkgZXH,21000,more than downpayment,more than downpayment,0,3900
QlhkgZXH,3900,10/2/2019,8900,QlhkgZXH,24900,more than downpayment,more than downpayment,0,3900
QlhkgZXH,3500,11/7/2019,8900,QlhkgZXH,28400,more than downpayment,more than downpayment,0,3500
QlhkgZXH,4000,12/17/2019,8900,QlhkgZXH,32400,more than downpayment,more than downpayment,0,4000
QlhkgZXH,3900,1/9/2020,8900,QlhkgZXH,36300,more than downpayment,more than downpayment,0,3900
QlhkgZXH,3900,1/28/2020,8900,QlhkgZXH,40200,more than downpayment,more than downpayment,0,3900
QMD57VYZ,9900,6/11/2019,8900,,9900,more than downpayment,,8900,1000
QMD57VYZ,3900,7/26/2019,8900,QMD57VYZ,13800,more than downpayment,more than downpayment,0,3900
QMD57VYZ,3900,9/9/2019,8900,QMD57VYZ,17700,more than downpayment,more than downpayment,0,3900
QMD57VYZ,3900,10/14/2019,8900,QMD57VYZ,21600,more than downpayment,more than downpayment,0,3900
QMD57VYZ,3900,12/4/2019,8900,QMD57VYZ,25500,more than downpayment,more than downpayment,0,3900
QMD57VYZ,3900,1/4/2020,8900,QMD57VYZ,29400,more than downpayment,more than downpayment,0,3900
QMD57VYZ,3900,2/2/2020,8900,QMD57VYZ,33300,more than downpayment,more than downpayment,0,3900
QMPB63JO,9900,10/10/2019,9900,,9900,equal to downpayment,,9900,0
QMPB63JO,2000,11/6/2019,9900,QMPB63JO,11900,more than downpayment,equal to downpayment,0,2000
QMPB63JO,3000,12/3/2019,9900,QMPB63JO,14900,more than downpayment,more than downpayment,0,3000
QMPB63JO,3000,12/28/2019,9900,QMPB63JO,17900,more than downpayment,more than downpayment,0,3000
QMPB63JO,5000,1/4/2020,9900,QMPB63JO,22900,more than downpayment,more than downpayment,0,5000
QMPB63JO,10000,1/29/2020,9900,QMPB63JO,32900,more than downpayment,more than downpayment,0,10000
qmyQBWts,9000,4/15/2019,8900,,9000,more than downpayment,,8900,100
qmyQBWts,3900,5/23/2019,8900,qmyQBWts,12900,more than downpayment,more than downpayment,0,3900
qmyQBWts,3800,6/28/2019,8900,qmyQBWts,16700,more than downpayment,more than downpayment,0,3800
qmyQBWts,4000,7/26/2019,8900,qmyQBWts,20700,more than downpayment,more than downpayment,0,4000
qmyQBWts,10000,9/15/2019,8900,qmyQBWts,30700,more than downpayment,more than downpayment,0,10000
qmyQBWts,3000,10/30/2019,8900,qmyQBWts,33700,more than downpayment,more than downpayment,0,3000
qmyQBWts,3000,11/29/2019,8900,qmyQBWts,36700,more than downpayment,more than downpayment,0,3000
qmyQBWts,3500,1/14/2020,8900,qmyQBWts,40200,more than downpayment,more than downpayment,0,3500
qmyQBWts,3900,2/4/2020,8900,qmyQBWts,44100,more than downpayment,more than downpayment,0,3900
qnIKRtFd,10000,7/25/2017,10000,,10000,equal to downpayment,,10000,0
qnIKRtFd,3500,10/11/2017,10000,qnIKRtFd,13500,more than downpayment,equal to downpayment,0,3500
qnIKRtFd,500,3/12/2018,10000,qnIKRtFd,14000,more than downpayment,more than downpayment,0,500
qnIKRtFd,500,4/19/2018,10000,qnIKRtFd,14500,more than downpayment,more than downpayment,0,500
QNRYHBZ9,10000,12/16/2019,9900,,10000,more than downpayment,,9900,100
QNRYHBZ9,1015,1/24/2020,9900,QNRYHBZ9,11015,more than downpayment,more than downpayment,0,1015
QNRYHBZ9,500,1/26/2020,9900,QNRYHBZ9,11515,more than downpayment,more than downpayment,0,500
QO9P33B4,9900,8/12/2019,9900,,9900,equal to downpayment,,9900,0
QO9P33B4,3900,10/3/2019,9900,QO9P33B4,13800,more than downpayment,equal to downpayment,0,3900
QO9P33B4,3000,11/19/2019,9900,QO9P33B4,16800,more than downpayment,more than downpayment,0,3000
QO9P33B4,750,11/28/2019,9900,QO9P33B4,17550,more than downpayment,more than downpayment,0,750
QO9P33B4,4050,12/20/2019,9900,QO9P33B4,21600,more than downpayment,more than downpayment,0,4050
QO9P33B4,3950,1/17/2020,9900,QO9P33B4,25550,more than downpayment,more than downpayment,0,3950
qOcd50IT,10900,4/24/2019,8900,,10900,more than downpayment,,8900,2000
qOcd50IT,3900,8/7/2019,8900,qOcd50IT,14800,more than downpayment,more than downpayment,0,3900
qOcd50IT,3900,10/17/2019,8900,qOcd50IT,18700,more than downpayment,more than downpayment,0,3900
qOcd50IT,5800,11/28/2019,8900,qOcd50IT,24500,more than downpayment,more than downpayment,0,5800
qOcd50IT,7800,12/20/2019,8900,qOcd50IT,32300,more than downpayment,more than downpayment,0,7800
qodVwcEM,9900,11/14/2018,9900,,9900,equal to downpayment,,9900,0
qodVwcEM,5000,12/24/2018,9900,qodVwcEM,14900,more than downpayment,equal to downpayment,0,5000
qodVwcEM,5000,1/27/2019,9900,qodVwcEM,19900,more than downpayment,more than downpayment,0,5000
qodVwcEM,5000,2/25/2019,9900,qodVwcEM,24900,more than downpayment,more than downpayment,0,5000
qodVwcEM,5000,3/25/2019,9900,qodVwcEM,29900,more than downpayment,more than downpayment,0,5000
qodVwcEM,5000,4/25/2019,9900,qodVwcEM,34900,more than downpayment,more than downpayment,0,5000
qodVwcEM,5000,5/26/2019,9900,qodVwcEM,39900,more than downpayment,more than downpayment,0,5000
qodVwcEM,5000,6/26/2019,9900,qodVwcEM,44900,more than downpayment,more than downpayment,0,5000
qodVwcEM,1000,7/27/2019,9900,qodVwcEM,45900,more than downpayment,more than downpayment,0,1000
qodVwcEM,5000,9/2/2019,9900,qodVwcEM,50900,more than downpayment,more than downpayment,0,5000
qodVwcEM,4000,9/26/2019,9900,qodVwcEM,54900,more than downpayment,more than downpayment,0,4000
qodVwcEM,4500,10/26/2019,9900,qodVwcEM,59400,more than downpayment,more than downpayment,0,4500
qodVwcEM,4500,11/26/2019,9900,qodVwcEM,63900,more than downpayment,more than downpayment,0,4500
QOMLR6YD,9900,11/30/2019,9900,,9900,equal to downpayment,,9900,0
QpkEatoc,30000,12/20/2018,9900,,30000,more than downpayment,,9900,20100
QpkEatoc,9000,5/27/2019,9900,QpkEatoc,39000,more than downpayment,more than downpayment,0,9000
QpkEatoc,7000,7/30/2019,9900,QpkEatoc,46000,more than downpayment,more than downpayment,0,7000
QpkEatoc,7000,11/15/2019,9900,QpkEatoc,53000,more than downpayment,more than downpayment,0,7000
QpkEatoc,8000,1/2/2020,9900,QpkEatoc,61000,more than downpayment,more than downpayment,0,8000
QPLW28PA,9900,11/17/2019,9900,,9900,equal to downpayment,,9900,0
QPLW28PA,3900,1/23/2020,9900,QPLW28PA,13800,more than downpayment,equal to downpayment,0,3900
qqbgH0J1,8900,2/4/2019,8900,,8900,equal to downpayment,,8900,0
qqbgH0J1,3900,3/5/2019,8900,qqbgH0J1,12800,more than downpayment,equal to downpayment,0,3900
qqbgH0J1,3900,4/5/2019,8900,qqbgH0J1,16700,more than downpayment,more than downpayment,0,3900
qqbgH0J1,3900,5/6/2019,8900,qqbgH0J1,20600,more than downpayment,more than downpayment,0,3900
qqbgH0J1,3900,6/4/2019,8900,qqbgH0J1,24500,more than downpayment,more than downpayment,0,3900
qqbgH0J1,3900,7/3/2019,8900,qqbgH0J1,28400,more than downpayment,more than downpayment,0,3900
qqbgH0J1,3900,8/5/2019,8900,qqbgH0J1,32300,more than downpayment,more than downpayment,0,3900
qqbgH0J1,3900,9/4/2019,8900,qqbgH0J1,36200,more than downpayment,more than downpayment,0,3900
qqbgH0J1,3900,10/4/2019,8900,qqbgH0J1,40100,more than downpayment,more than downpayment,0,3900
qqbgH0J1,3900,11/5/2019,8900,qqbgH0J1,44000,more than downpayment,more than downpayment,0,3900
qqbgH0J1,3900,12/5/2019,8900,qqbgH0J1,47900,more than downpayment,more than downpayment,0,3900
qqbgH0J1,3900,1/5/2020,8900,qqbgH0J1,51800,more than downpayment,more than downpayment,0,3900
qqbgH0J1,3900,2/5/2020,8900,qqbgH0J1,55700,more than downpayment,more than downpayment,0,3900
QQepHWZk,10000,6/1/2017,10000,,10000,equal to downpayment,,10000,0
QQepHWZk,1500,6/22/2017,10000,QQepHWZk,11500,more than downpayment,equal to downpayment,0,1500
QQepHWZk,3000,8/12/2017,10000,QQepHWZk,14500,more than downpayment,more than downpayment,0,3000
QQepHWZk,4000,1/31/2018,10000,QQepHWZk,18500,more than downpayment,more than downpayment,0,4000
QQepHWZk,7500,5/25/2018,10000,QQepHWZk,26000,more than downpayment,more than downpayment,0,7500
QQepHWZk,5000,7/11/2018,10000,QQepHWZk,31000,more than downpayment,more than downpayment,0,5000
QQepHWZk,2500,8/3/2018,10000,QQepHWZk,33500,more than downpayment,more than downpayment,0,2500
QQepHWZk,5000,8/23/2018,10000,QQepHWZk,38500,more than downpayment,more than downpayment,0,5000
QQepHWZk,2000,10/26/2018,10000,QQepHWZk,40500,more than downpayment,more than downpayment,0,2000
QQepHWZk,1000,12/17/2018,10000,QQepHWZk,41500,more than downpayment,more than downpayment,0,1000
QREDB68D,1000,10/11/2019,9900,,1000,less than downpayment,,1000,0
QRRY8TJI,6000,6/14/2019,1999,,6000,more than downpayment,,1999,4001
QRRY8TJI,10000,8/20/2019,1999,QRRY8TJI,16000,more than downpayment,more than downpayment,0,10000
QRRY8TJI,6000,1/21/2020,1999,QRRY8TJI,22000,more than downpayment,more than downpayment,0,6000
qsCEnq4O,8900,3/29/2019,8900,,8900,equal to downpayment,,8900,0
qsCEnq4O,3900,5/2/2019,8900,qsCEnq4O,12800,more than downpayment,equal to downpayment,0,3900
qsCEnq4O,3900,6/3/2019,8900,qsCEnq4O,16700,more than downpayment,more than downpayment,0,3900
qsCEnq4O,3900,7/2/2019,8900,qsCEnq4O,20600,more than downpayment,more than downpayment,0,3900
qsCEnq4O,3900,8/2/2019,8900,qsCEnq4O,24500,more than downpayment,more than downpayment,0,3900
qsCEnq4O,3900,9/2/2019,8900,qsCEnq4O,28400,more than downpayment,more than downpayment,0,3900
qsCEnq4O,3900,10/2/2019,8900,qsCEnq4O,32300,more than downpayment,more than downpayment,0,3900
qsCEnq4O,3900,11/2/2019,8900,qsCEnq4O,36200,more than downpayment,more than downpayment,0,3900
qsCEnq4O,3900,12/2/2019,8900,qsCEnq4O,40100,more than downpayment,more than downpayment,0,3900
qsCEnq4O,3900,1/2/2020,8900,qsCEnq4O,44000,more than downpayment,more than downpayment,0,3900
qsCEnq4O,3900,2/3/2020,8900,qsCEnq4O,47900,more than downpayment,more than downpayment,0,3900
qskTn1ZK,8900,2/6/2019,8900,,8900,equal to downpayment,,8900,0
qskTn1ZK,3902,2/14/2019,8900,qskTn1ZK,12802,more than downpayment,equal to downpayment,0,3902
qskTn1ZK,3998,3/10/2019,8900,qskTn1ZK,16800,more than downpayment,more than downpayment,0,3998
qskTn1ZK,4000,5/6/2019,8900,qskTn1ZK,20800,more than downpayment,more than downpayment,0,4000
qskTn1ZK,4000,6/14/2019,8900,qskTn1ZK,24800,more than downpayment,more than downpayment,0,4000
qskTn1ZK,3900,6/23/2019,8900,qskTn1ZK,28700,more than downpayment,more than downpayment,0,3900
qskTn1ZK,4000,8/13/2019,8900,qskTn1ZK,32700,more than downpayment,more than downpayment,0,4000
qskTn1ZK,2500,9/30/2019,8900,qskTn1ZK,35200,more than downpayment,more than downpayment,0,2500
qskTn1ZK,1000,10/4/2019,8900,qskTn1ZK,36200,more than downpayment,more than downpayment,0,1000
qskTn1ZK,3900,10/9/2019,8900,qskTn1ZK,40100,more than downpayment,more than downpayment,0,3900
qskTn1ZK,3900,11/5/2019,8900,qskTn1ZK,44000,more than downpayment,more than downpayment,0,3900
qskTn1ZK,3900,12/21/2019,8900,qskTn1ZK,47900,more than downpayment,more than downpayment,0,3900
qskTn1ZK,3900,1/25/2020,8900,qskTn1ZK,51800,more than downpayment,more than downpayment,0,3900
qspNuCfr,9900,9/4/2019,9900,,9900,equal to downpayment,,9900,0
qspNuCfr,3900,1/2/2020,9900,qspNuCfr,13800,more than downpayment,equal to downpayment,0,3900
qspNuCfr,3900,1/22/2020,9900,qspNuCfr,17700,more than downpayment,more than downpayment,0,3900
qspNuCfr,3900,1/29/2020,9900,qspNuCfr,21600,more than downpayment,more than downpayment,0,3900
QsqHqc9v,10000,2/19/2019,8900,,10000,more than downpayment,,8900,1100
QsqHqc9v,3900,3/25/2019,8900,QsqHqc9v,13900,more than downpayment,more than downpayment,0,3900
QsqHqc9v,3900,4/25/2019,8900,QsqHqc9v,17800,more than downpayment,more than downpayment,0,3900
QsqHqc9v,3900,5/30/2019,8900,QsqHqc9v,21700,more than downpayment,more than downpayment,0,3900
QsqHqc9v,3900,7/4/2019,8900,QsqHqc9v,25600,more than downpayment,more than downpayment,0,3900
QsqHqc9v,3900,7/29/2019,8900,QsqHqc9v,29500,more than downpayment,more than downpayment,0,3900
QsqHqc9v,3900,8/26/2019,8900,QsqHqc9v,33400,more than downpayment,more than downpayment,0,3900
QsqHqc9v,3900,10/1/2019,8900,QsqHqc9v,37300,more than downpayment,more than downpayment,0,3900
QsqHqc9v,4000,11/27/2019,8900,QsqHqc9v,41300,more than downpayment,more than downpayment,0,4000
QsqHqc9v,3900,12/12/2019,8900,QsqHqc9v,45200,more than downpayment,more than downpayment,0,3900
QsqHqc9v,2700,1/14/2020,8900,QsqHqc9v,47900,more than downpayment,more than downpayment,0,2700
QSWU6MTS,26250,7/16/2019,26250,,26250,equal to downpayment,,26250,0
QSWU6MTS,26250,8/20/2019,26250,QSWU6MTS,52500,more than downpayment,equal to downpayment,0,26250
QSWU6MTS,26250,9/18/2019,26250,QSWU6MTS,78750,more than downpayment,more than downpayment,0,26250
QSWU6MTS,26250,11/5/2019,26250,QSWU6MTS,105000,more than downpayment,more than downpayment,0,26250
Qu0ZEHqv,9900,7/8/2019,8900,,9900,more than downpayment,,8900,1000
Qu0ZEHqv,4000,8/20/2019,8900,Qu0ZEHqv,13900,more than downpayment,more than downpayment,0,4000
Qu0ZEHqv,4000,9/20/2019,8900,Qu0ZEHqv,17900,more than downpayment,more than downpayment,0,4000
Qu0ZEHqv,4000,10/24/2019,8900,Qu0ZEHqv,21900,more than downpayment,more than downpayment,0,4000
Qu0ZEHqv,2400,11/25/2019,8900,Qu0ZEHqv,24300,more than downpayment,more than downpayment,0,2400
Qu0ZEHqv,500,11/28/2019,8900,Qu0ZEHqv,24800,more than downpayment,more than downpayment,0,500
Qu0ZEHqv,4000,12/31/2019,8900,Qu0ZEHqv,28800,more than downpayment,more than downpayment,0,4000
Qu0ZEHqv,4000,1/23/2020,8900,Qu0ZEHqv,32800,more than downpayment,more than downpayment,0,4000
QUB7LDOU,10000,6/19/2019,8900,,10000,more than downpayment,,8900,1100
QUB7LDOU,3900,8/22/2019,8900,QUB7LDOU,13900,more than downpayment,more than downpayment,0,3900
QUB7LDOU,3900,9/26/2019,8900,QUB7LDOU,17800,more than downpayment,more than downpayment,0,3900
QUB7LDOU,3900,10/25/2019,8900,QUB7LDOU,21700,more than downpayment,more than downpayment,0,3900
QUB7LDOU,3900,11/29/2019,8900,QUB7LDOU,25600,more than downpayment,more than downpayment,0,3900
QUB7LDOU,3900,12/21/2019,8900,QUB7LDOU,29500,more than downpayment,more than downpayment,0,3900
QUB7LDOU,3900,1/22/2020,8900,QUB7LDOU,33400,more than downpayment,more than downpayment,0,3900
QULHWEGB,9900,11/30/2019,9900,,9900,equal to downpayment,,9900,0
QULHWEGB,3900,2/3/2020,9900,QULHWEGB,13800,more than downpayment,equal to downpayment,0,3900
QUQEZN6O,7900,10/4/2019,7900,,7900,equal to downpayment,,7900,0
qvHp5G3H,10000,11/27/2018,10000,,10000,equal to downpayment,,10000,0
qvHp5G3H,4500,1/5/2019,10000,qvHp5G3H,14500,more than downpayment,equal to downpayment,0,4500
qvHp5G3H,4500,2/5/2019,10000,qvHp5G3H,19000,more than downpayment,more than downpayment,0,4500
qvHp5G3H,4500,3/6/2019,10000,qvHp5G3H,23500,more than downpayment,more than downpayment,0,4500
qvHp5G3H,4500,4/5/2019,10000,qvHp5G3H,28000,more than downpayment,more than downpayment,0,4500
qvHp5G3H,4500,5/6/2019,10000,qvHp5G3H,32500,more than downpayment,more than downpayment,0,4500
qvHp5G3H,4500,6/7/2019,10000,qvHp5G3H,37000,more than downpayment,more than downpayment,0,4500
qvHp5G3H,4500,7/10/2019,10000,qvHp5G3H,41500,more than downpayment,more than downpayment,0,4500
qvHp5G3H,4500,8/9/2019,10000,qvHp5G3H,46000,more than downpayment,more than downpayment,0,4500
qvHp5G3H,6000,10/8/2019,10000,qvHp5G3H,52000,more than downpayment,more than downpayment,0,6000
qvHp5G3H,3000,11/4/2019,10000,qvHp5G3H,55000,more than downpayment,more than downpayment,0,3000
qvHp5G3H,4500,12/6/2019,10000,qvHp5G3H,59500,more than downpayment,more than downpayment,0,4500
qvHp5G3H,4500,2/5/2020,10000,qvHp5G3H,64000,more than downpayment,more than downpayment,0,4500
qvmpv9qY,1000,11/7/2018,9900,,1000,less than downpayment,,1000,0
QWUQEX2K,8900,10/26/2019,8900,,8900,equal to downpayment,,8900,0
QWUQEX2K,50000,11/6/2019,8900,QWUQEX2K,58900,more than downpayment,equal to downpayment,0,50000
QWUQEX2K,46100,11/27/2019,8900,QWUQEX2K,105000,more than downpayment,more than downpayment,0,46100
qwVxQbCQ,9900,7/4/2019,9900,,9900,equal to downpayment,,9900,0
QXN2GLBV,10000,6/30/2017,10000,,10000,equal to downpayment,,10000,0
QXN2GLBV,10000,12/13/2017,10000,QXN2GLBV,20000,more than downpayment,equal to downpayment,0,10000
QXN2GLBV,10000,3/7/2018,10000,QXN2GLBV,30000,more than downpayment,more than downpayment,0,10000
QXN2GLBV,10000,7/2/2018,10000,QXN2GLBV,40000,more than downpayment,more than downpayment,0,10000
QXN2GLBV,5000,10/23/2018,10000,QXN2GLBV,45000,more than downpayment,more than downpayment,0,5000
QY4AZQ6B,9900,11/9/2019,9900,,9900,equal to downpayment,,9900,0
QY4AZQ6B,3900,12/25/2019,9900,QY4AZQ6B,13800,more than downpayment,equal to downpayment,0,3900
QY4AZQ6B,3900,1/25/2020,9900,QY4AZQ6B,17700,more than downpayment,more than downpayment,0,3900
QY8H7RST,9900,8/6/2019,8900,,9900,more than downpayment,,8900,1000
QY8H7RST,3900,10/12/2019,8900,QY8H7RST,13800,more than downpayment,more than downpayment,0,3900
QY8H7RST,5000,11/16/2019,8900,QY8H7RST,18800,more than downpayment,more than downpayment,0,5000
QY8H7RST,5000,1/3/2020,8900,QY8H7RST,23800,more than downpayment,more than downpayment,0,5000
QY8H7RST,5000,1/21/2020,8900,QY8H7RST,28800,more than downpayment,more than downpayment,0,5000
QYMX5INQ,7900,1/27/2020,7900,,7900,equal to downpayment,,7900,0
QZ9APXJF,10000,12/23/2019,9900,,10000,more than downpayment,,9900,100
QZMB172A,9900,11/13/2019,9900,,9900,equal to downpayment,,9900,0
QZMB172A,3900,1/21/2020,9900,QZMB172A,13800,more than downpayment,equal to downpayment,0,3900
r1B7ryBy,10000,7/10/2018,10000,,10000,equal to downpayment,,10000,0
r1B7ryBy,4500,9/3/2018,10000,r1B7ryBy,14500,more than downpayment,equal to downpayment,0,4500
r1B7ryBy,5000,10/3/2018,10000,r1B7ryBy,19500,more than downpayment,more than downpayment,0,5000
r1B7ryBy,5000,11/3/2018,10000,r1B7ryBy,24500,more than downpayment,more than downpayment,0,5000
r1B7ryBy,5000,12/4/2018,10000,r1B7ryBy,29500,more than downpayment,more than downpayment,0,5000
r1B7ryBy,5000,1/4/2019,10000,r1B7ryBy,34500,more than downpayment,more than downpayment,0,5000
r1B7ryBy,5000,2/4/2019,10000,r1B7ryBy,39500,more than downpayment,more than downpayment,0,5000
r1B7ryBy,5000,3/4/2019,10000,r1B7ryBy,44500,more than downpayment,more than downpayment,0,5000
r1B7ryBy,5000,4/4/2019,10000,r1B7ryBy,49500,more than downpayment,more than downpayment,0,5000
r1B7ryBy,5000,5/4/2019,10000,r1B7ryBy,54500,more than downpayment,more than downpayment,0,5000
r1B7ryBy,5000,6/4/2019,10000,r1B7ryBy,59500,more than downpayment,more than downpayment,0,5000
r1B7ryBy,4500,7/4/2019,10000,r1B7ryBy,64000,more than downpayment,more than downpayment,0,4500
R1IyAs6H,25000,12/5/2018,8900,,25000,more than downpayment,,8900,16100
R1IyAs6H,31200,1/9/2019,8900,R1IyAs6H,56200,more than downpayment,more than downpayment,0,31200
r1W5AZjz,9900,6/23/2019,8900,,9900,more than downpayment,,8900,1000
r1W5AZjz,3900,8/9/2019,8900,r1W5AZjz,13800,more than downpayment,more than downpayment,0,3900
r1W5AZjz,3900,9/2/2019,8900,r1W5AZjz,17700,more than downpayment,more than downpayment,0,3900
r1W5AZjz,3900,9/10/2019,8900,r1W5AZjz,21600,more than downpayment,more than downpayment,0,3900
r1W5AZjz,3900,10/2/2019,8900,r1W5AZjz,25500,more than downpayment,more than downpayment,0,3900
r1W5AZjz,3900,11/10/2019,8900,r1W5AZjz,29400,more than downpayment,more than downpayment,0,3900
r1W5AZjz,3900,1/1/2020,8900,r1W5AZjz,33300,more than downpayment,more than downpayment,0,3900
r1W5AZjz,3900,2/8/2020,8900,r1W5AZjz,37200,more than downpayment,more than downpayment,0,3900
R2C3FZ52,9900,8/20/2019,9900,,9900,equal to downpayment,,9900,0
R2C3FZ52,3950,10/25/2019,9900,R2C3FZ52,13850,more than downpayment,equal to downpayment,0,3950
R2C3FZ52,3900,11/27/2019,9900,R2C3FZ52,17750,more than downpayment,more than downpayment,0,3900
R2C3FZ52,3900,1/1/2020,9900,R2C3FZ52,21650,more than downpayment,more than downpayment,0,3900
R2C3FZ52,3850,1/28/2020,9900,R2C3FZ52,25500,more than downpayment,more than downpayment,0,3850
R2CWEICA,9900,10/15/2019,9900,,9900,equal to downpayment,,9900,0
R2CWEICA,3900,11/25/2019,9900,R2CWEICA,13800,more than downpayment,equal to downpayment,0,3900
R2CWEICA,3900,12/18/2019,9900,R2CWEICA,17700,more than downpayment,more than downpayment,0,3900
R2CWEICA,3900,1/17/2020,9900,R2CWEICA,21600,more than downpayment,more than downpayment,0,3900
R2EQIISS,9900,10/15/2019,9900,,9900,equal to downpayment,,9900,0
R2EQIISS,3900,11/29/2019,9900,R2EQIISS,13800,more than downpayment,equal to downpayment,0,3900
R2EQIISS,3900,12/22/2019,9900,R2EQIISS,17700,more than downpayment,more than downpayment,0,3900
R2EQIISS,3900,2/7/2020,9900,R2EQIISS,21600,more than downpayment,more than downpayment,0,3900
R2RSAVE5,5000,12/17/2019,9900,,5000,less than downpayment,,5000,0
R2RSAVE5,5000,12/18/2019,9900,R2RSAVE5,10000,more than downpayment,less than downpayment,4900,100
R2RSAVE5,3900,2/7/2020,9900,R2RSAVE5,13900,more than downpayment,more than downpayment,0,3900
R3GSRCAT,8900,9/12/2019,8900,,8900,equal to downpayment,,8900,0
R3GSRCAT,3900,10/29/2019,8900,R3GSRCAT,12800,more than downpayment,equal to downpayment,0,3900
R3GSRCAT,3900,11/29/2019,8900,R3GSRCAT,16700,more than downpayment,more than downpayment,0,3900
R3GSRCAT,3900,12/29/2019,8900,R3GSRCAT,20600,more than downpayment,more than downpayment,0,3900
R3GSRCAT,3900,1/29/2020,8900,R3GSRCAT,24500,more than downpayment,more than downpayment,0,3900
R3O2185C,4450,1/31/2020,9900,,4450,less than downpayment,,4450,0
R4I6NI1N,8900,12/27/2019,8900,,8900,equal to downpayment,,8900,0
r4prr78k,10000,8/29/2017,10000,,10000,equal to downpayment,,10000,0
r4prr78k,35000,9/2/2017,10000,r4prr78k,45000,more than downpayment,equal to downpayment,0,35000
R72tGVtn,10000,9/27/2017,10000,,10000,equal to downpayment,,10000,0
R72tGVtn,4000,1/24/2018,10000,R72tGVtn,14000,more than downpayment,equal to downpayment,0,4000
R72tGVtn,2000,3/24/2018,10000,R72tGVtn,16000,more than downpayment,more than downpayment,0,2000
R72tGVtn,500,7/4/2018,10000,R72tGVtn,16500,more than downpayment,more than downpayment,0,500
R72tGVtn,1000,10/6/2018,10000,R72tGVtn,17500,more than downpayment,more than downpayment,0,1000
R72tGVtn,1000,12/10/2018,10000,R72tGVtn,18500,more than downpayment,more than downpayment,0,1000
R72tGVtn,1000,1/28/2019,10000,R72tGVtn,19500,more than downpayment,more than downpayment,0,1000
R72tGVtn,500,3/26/2019,10000,R72tGVtn,20000,more than downpayment,more than downpayment,0,500
R72tGVtn,1000,4/22/2019,10000,R72tGVtn,21000,more than downpayment,more than downpayment,0,1000
R72tGVtn,1000,7/27/2019,10000,R72tGVtn,22000,more than downpayment,more than downpayment,0,1000
R72tGVtn,2000,11/7/2019,10000,R72tGVtn,24000,more than downpayment,more than downpayment,0,2000
R72tGVtn,1000,12/17/2019,10000,R72tGVtn,25000,more than downpayment,more than downpayment,0,1000
R72tGVtn,25000,2/5/2020,10000,R72tGVtn,50000,more than downpayment,more than downpayment,0,25000
r8beD0zv,9000,3/1/2019,8900,,9000,more than downpayment,,8900,100
r8beD0zv,3900,4/8/2019,8900,r8beD0zv,12900,more than downpayment,more than downpayment,0,3900
r8beD0zv,3900,5/6/2019,8900,r8beD0zv,16800,more than downpayment,more than downpayment,0,3900
R8JU91YY,8900,5/15/2019,8900,,8900,equal to downpayment,,8900,0
R8JU91YY,5000,5/29/2019,8900,R8JU91YY,13900,more than downpayment,equal to downpayment,0,5000
R8JU91YY,5000,6/28/2019,8900,R8JU91YY,18900,more than downpayment,more than downpayment,0,5000
R8JU91YY,5000,8/1/2019,8900,R8JU91YY,23900,more than downpayment,more than downpayment,0,5000
R8JU91YY,3900,11/3/2019,8900,R8JU91YY,27800,more than downpayment,more than downpayment,0,3900
R8JU91YY,4500,12/2/2019,8900,R8JU91YY,32300,more than downpayment,more than downpayment,0,4500
R9LTM2ST,9900,12/23/2019,9900,,9900,equal to downpayment,,9900,0
RA5NFD3J,9900,6/22/2019,9900,,9900,equal to downpayment,,9900,0
RA5NFD3J,3900,8/15/2019,9900,RA5NFD3J,13800,more than downpayment,equal to downpayment,0,3900
RA5NFD3J,3900,9/16/2019,9900,RA5NFD3J,17700,more than downpayment,more than downpayment,0,3900
RA5NFD3J,3900,10/18/2019,9900,RA5NFD3J,21600,more than downpayment,more than downpayment,0,3900
RA5NFD3J,3900,11/20/2019,9900,RA5NFD3J,25500,more than downpayment,more than downpayment,0,3900
RA5NFD3J,3900,12/28/2019,9900,RA5NFD3J,29400,more than downpayment,more than downpayment,0,3900
RA5NFD3J,3900,1/27/2020,9900,RA5NFD3J,33300,more than downpayment,more than downpayment,0,3900
RAR8KTK5,9900,11/18/2019,9900,,9900,equal to downpayment,,9900,0
RAR8KTK5,3900,1/23/2020,9900,RAR8KTK5,13800,more than downpayment,equal to downpayment,0,3900
RbVS9NWJ,8900,5/24/2019,8900,,8900,equal to downpayment,,8900,0
RbVS9NWJ,3900,7/25/2019,8900,RbVS9NWJ,12800,more than downpayment,equal to downpayment,0,3900
RbVS9NWJ,3900,8/26/2019,8900,RbVS9NWJ,16700,more than downpayment,more than downpayment,0,3900
RbVS9NWJ,3900,9/24/2019,8900,RbVS9NWJ,20600,more than downpayment,more than downpayment,0,3900
RbVS9NWJ,3900,10/28/2019,8900,RbVS9NWJ,24500,more than downpayment,more than downpayment,0,3900
RbVS9NWJ,3900,11/26/2019,8900,RbVS9NWJ,28400,more than downpayment,more than downpayment,0,3900
RbVS9NWJ,3900,1/2/2020,8900,RbVS9NWJ,32300,more than downpayment,more than downpayment,0,3900
RbVS9NWJ,700,2/1/2020,8900,RbVS9NWJ,33000,more than downpayment,more than downpayment,0,700
RbVS9NWJ,1000,2/8/2020,8900,RbVS9NWJ,34000,more than downpayment,more than downpayment,0,1000
RBXYWGNA,9900,1/30/2020,9900,,9900,equal to downpayment,,9900,0
RBYBZH77,9900,12/18/2019,9900,,9900,equal to downpayment,,9900,0
RcLcJBGm,11900,8/23/2019,9900,,11900,more than downpayment,,9900,2000
RcLcJBGm,3900,11/4/2019,9900,RcLcJBGm,15800,more than downpayment,more than downpayment,0,3900
RcLcJBGm,3900,12/5/2019,9900,RcLcJBGm,19700,more than downpayment,more than downpayment,0,3900
RcLcJBGm,3900,1/3/2020,9900,RcLcJBGm,23600,more than downpayment,more than downpayment,0,3900
RcLcJBGm,3900,2/5/2020,9900,RcLcJBGm,27500,more than downpayment,more than downpayment,0,3900
RCSRSQCO,9900,6/14/2019,8900,,9900,more than downpayment,,8900,1000
RCSRSQCO,3900,8/4/2019,8900,RCSRSQCO,13800,more than downpayment,more than downpayment,0,3900
RCSRSQCO,3900,9/4/2019,8900,RCSRSQCO,17700,more than downpayment,more than downpayment,0,3900
RCSRSQCO,3900,10/3/2019,8900,RCSRSQCO,21600,more than downpayment,more than downpayment,0,3900
RCSRSQCO,3900,11/1/2019,8900,RCSRSQCO,25500,more than downpayment,more than downpayment,0,3900
RCSRSQCO,3900,12/4/2019,8900,RCSRSQCO,29400,more than downpayment,more than downpayment,0,3900
RCSRSQCO,3900,1/3/2020,8900,RCSRSQCO,33300,more than downpayment,more than downpayment,0,3900
RCSRSQCO,3900,2/4/2020,8900,RCSRSQCO,37200,more than downpayment,more than downpayment,0,3900
rCv3ljf6,8900,11/26/2018,8900,,8900,equal to downpayment,,8900,0
rCv3ljf6,3900,1/8/2019,8900,rCv3ljf6,12800,more than downpayment,equal to downpayment,0,3900
rCv3ljf6,3900,2/15/2019,8900,rCv3ljf6,16700,more than downpayment,more than downpayment,0,3900
rCv3ljf6,3900,3/7/2019,8900,rCv3ljf6,20600,more than downpayment,more than downpayment,0,3900
rCv3ljf6,3900,4/16/2019,8900,rCv3ljf6,24500,more than downpayment,more than downpayment,0,3900
rCv3ljf6,4000,6/7/2019,8900,rCv3ljf6,28500,more than downpayment,more than downpayment,0,4000
rCv3ljf6,3900,8/26/2019,8900,rCv3ljf6,32400,more than downpayment,more than downpayment,0,3900
rCv3ljf6,3400,10/5/2019,8900,rCv3ljf6,35800,more than downpayment,more than downpayment,0,3400
rCv3ljf6,4700,11/20/2019,8900,rCv3ljf6,40500,more than downpayment,more than downpayment,0,4700
rCv3ljf6,4700,12/6/2019,8900,rCv3ljf6,45200,more than downpayment,more than downpayment,0,4700
rCv3ljf6,4700,12/17/2019,8900,rCv3ljf6,49900,more than downpayment,more than downpayment,0,4700
rCv3ljf6,6400,1/26/2020,8900,rCv3ljf6,56300,more than downpayment,more than downpayment,0,6400
rDGrQG61,8900,2/4/2019,8900,,8900,equal to downpayment,,8900,0
rDGrQG61,3900,3/18/2019,8900,rDGrQG61,12800,more than downpayment,equal to downpayment,0,3900
rDGrQG61,3900,5/30/2019,8900,rDGrQG61,16700,more than downpayment,more than downpayment,0,3900
RDL4MUBO,9900,9/18/2019,9900,,9900,equal to downpayment,,9900,0
RDL4MUBO,3900,1/2/2020,9900,RDL4MUBO,13800,more than downpayment,equal to downpayment,0,3900
RDL4MUBO,3900,2/4/2020,9900,RDL4MUBO,17700,more than downpayment,more than downpayment,0,3900
rdmXJB7F,10000,7/18/2018,10000,,10000,equal to downpayment,,10000,0
rdmXJB7F,4500,9/15/2018,10000,rdmXJB7F,14500,more than downpayment,equal to downpayment,0,4500
rdmXJB7F,4500,10/15/2018,10000,rdmXJB7F,19000,more than downpayment,more than downpayment,0,4500
rdmXJB7F,4500,11/14/2018,10000,rdmXJB7F,23500,more than downpayment,more than downpayment,0,4500
rdmXJB7F,4500,12/15/2018,10000,rdmXJB7F,28000,more than downpayment,more than downpayment,0,4500
rdmXJB7F,4500,1/18/2019,10000,rdmXJB7F,32500,more than downpayment,more than downpayment,0,4500
rdmXJB7F,4500,2/19/2019,10000,rdmXJB7F,37000,more than downpayment,more than downpayment,0,4500
rdmXJB7F,4500,3/19/2019,10000,rdmXJB7F,41500,more than downpayment,more than downpayment,0,4500
rdmXJB7F,4500,4/25/2019,10000,rdmXJB7F,46000,more than downpayment,more than downpayment,0,4500
rdmXJB7F,4500,5/29/2019,10000,rdmXJB7F,50500,more than downpayment,more than downpayment,0,4500
rdmXJB7F,4500,6/25/2019,10000,rdmXJB7F,55000,more than downpayment,more than downpayment,0,4500
rdmXJB7F,4500,7/30/2019,10000,rdmXJB7F,59500,more than downpayment,more than downpayment,0,4500
rdmXJB7F,4500,8/27/2019,10000,rdmXJB7F,64000,more than downpayment,more than downpayment,0,4500
RE5Y4JBJ,8900,10/17/2019,8900,,8900,equal to downpayment,,8900,0
RE5Y4JBJ,3900,12/23/2019,8900,RE5Y4JBJ,12800,more than downpayment,equal to downpayment,0,3900
RE5Y4JBJ,3900,1/15/2020,8900,RE5Y4JBJ,16700,more than downpayment,more than downpayment,0,3900
RE5Y4JBJ,3900,2/4/2020,8900,RE5Y4JBJ,20600,more than downpayment,more than downpayment,0,3900
re7iRNM6,8900,3/7/2019,8900,,8900,equal to downpayment,,8900,0
re7iRNM6,3900,4/25/2019,8900,re7iRNM6,12800,more than downpayment,equal to downpayment,0,3900
re7iRNM6,3900,5/25/2019,8900,re7iRNM6,16700,more than downpayment,more than downpayment,0,3900
re7iRNM6,3900,6/26/2019,8900,re7iRNM6,20600,more than downpayment,more than downpayment,0,3900
re7iRNM6,3900,7/25/2019,8900,re7iRNM6,24500,more than downpayment,more than downpayment,0,3900
re7iRNM6,3900,9/6/2019,8900,re7iRNM6,28400,more than downpayment,more than downpayment,0,3900
re7iRNM6,3900,10/1/2019,8900,re7iRNM6,32300,more than downpayment,more than downpayment,0,3900
re7iRNM6,3900,11/7/2019,8900,re7iRNM6,36200,more than downpayment,more than downpayment,0,3900
re7iRNM6,3900,12/2/2019,8900,re7iRNM6,40100,more than downpayment,more than downpayment,0,3900
re7iRNM6,3900,1/8/2020,8900,re7iRNM6,44000,more than downpayment,more than downpayment,0,3900
re7iRNM6,3900,1/27/2020,8900,re7iRNM6,47900,more than downpayment,more than downpayment,0,3900
rEao3Wt0,10000,7/11/2019,9900,,10000,more than downpayment,,9900,100
rEao3Wt0,70000,8/28/2019,9900,rEao3Wt0,80000,more than downpayment,more than downpayment,0,70000
rEao3Wt0,3900,10/7/2019,9900,rEao3Wt0,83900,more than downpayment,more than downpayment,0,3900
rEao3Wt0,4000,2/4/2020,9900,rEao3Wt0,87900,more than downpayment,more than downpayment,0,4000
REYY2W47,2000,6/28/2019,1999,,2000,more than downpayment,,1999,1
REYY2W47,2000,8/16/2019,1999,REYY2W47,4000,more than downpayment,more than downpayment,0,2000
REYY2W47,2000,10/12/2019,1999,REYY2W47,6000,more than downpayment,more than downpayment,0,2000
REYY2W47,2000,11/4/2019,1999,REYY2W47,8000,more than downpayment,more than downpayment,0,2000
REYY2W47,2000,12/9/2019,1999,REYY2W47,10000,more than downpayment,more than downpayment,0,2000
REYY2W47,2000,1/13/2020,1999,REYY2W47,12000,more than downpayment,more than downpayment,0,2000
REYY2W47,2000,2/8/2020,1999,REYY2W47,14000,more than downpayment,more than downpayment,0,2000
rg98ftjH,10167,2/16/2019,9900,,10167,more than downpayment,,9900,267
rg98ftjH,4500,3/22/2019,9900,rg98ftjH,14667,more than downpayment,more than downpayment,0,4500
rg98ftjH,4500,5/4/2019,9900,rg98ftjH,19167,more than downpayment,more than downpayment,0,4500
rg98ftjH,4500,5/27/2019,9900,rg98ftjH,23667,more than downpayment,more than downpayment,0,4500
rg98ftjH,5000,11/19/2019,9900,rg98ftjH,28667,more than downpayment,more than downpayment,0,5000
rg98ftjH,6000,1/3/2020,9900,rg98ftjH,34667,more than downpayment,more than downpayment,0,6000
RGYOAZN9,4900,9/25/2019,9900,,4900,less than downpayment,,4900,0
RGYOAZN9,3000,9/26/2019,9900,RGYOAZN9,7900,less than downpayment,less than downpayment,3000,0
RGYOAZN9,2000,9/27/2019,9900,RGYOAZN9,9900,equal to downpayment,less than downpayment,2000,0
RGYOAZN9,3900,11/29/2019,9900,RGYOAZN9,13800,more than downpayment,equal to downpayment,0,3900
RGYOAZN9,3900,1/4/2020,9900,RGYOAZN9,17700,more than downpayment,more than downpayment,0,3900
RGYOAZN9,900,2/4/2020,9900,RGYOAZN9,18600,more than downpayment,more than downpayment,0,900
Rh2woKE7,3635,2/17/2019,8900,,3635,less than downpayment,,3635,0
Rh2woKE7,8900,5/29/2019,8900,Rh2woKE7,12535,more than downpayment,less than downpayment,5265,3635
Rh2woKE7,1000,6/11/2019,8900,Rh2woKE7,13535,more than downpayment,more than downpayment,0,1000
Rh2woKE7,3900,7/30/2019,8900,Rh2woKE7,17435,more than downpayment,more than downpayment,0,3900
Rh2woKE7,3900,9/5/2019,8900,Rh2woKE7,21335,more than downpayment,more than downpayment,0,3900
Rh2woKE7,3900,10/5/2019,8900,Rh2woKE7,25235,more than downpayment,more than downpayment,0,3900
Rh2woKE7,3900,11/5/2019,8900,Rh2woKE7,29135,more than downpayment,more than downpayment,0,3900
Rh2woKE7,3900,12/5/2019,8900,Rh2woKE7,33035,more than downpayment,more than downpayment,0,3900
Rh2woKE7,3900,12/31/2019,8900,Rh2woKE7,36935,more than downpayment,more than downpayment,0,3900
Rh2woKE7,3900,2/5/2020,8900,Rh2woKE7,40835,more than downpayment,more than downpayment,0,3900
rh8nwuTx,8900,5/10/2019,8900,,8900,equal to downpayment,,8900,0
rh8nwuTx,3900,6/24/2019,8900,rh8nwuTx,12800,more than downpayment,equal to downpayment,0,3900
rh8nwuTx,3900,7/22/2019,8900,rh8nwuTx,16700,more than downpayment,more than downpayment,0,3900
rh8nwuTx,3900,8/22/2019,8900,rh8nwuTx,20600,more than downpayment,more than downpayment,0,3900
rh8nwuTx,3900,9/25/2019,8900,rh8nwuTx,24500,more than downpayment,more than downpayment,0,3900
rh8nwuTx,3900,10/25/2019,8900,rh8nwuTx,28400,more than downpayment,more than downpayment,0,3900
rh8nwuTx,3900,11/22/2019,8900,rh8nwuTx,32300,more than downpayment,more than downpayment,0,3900
rh8nwuTx,3900,12/27/2019,8900,rh8nwuTx,36200,more than downpayment,more than downpayment,0,3900
rh8nwuTx,3900,1/25/2020,8900,rh8nwuTx,40100,more than downpayment,more than downpayment,0,3900
RHFD2H41,9900,10/22/2019,9900,,9900,equal to downpayment,,9900,0
RHFD2H41,3900,12/3/2019,9900,RHFD2H41,13800,more than downpayment,equal to downpayment,0,3900
RHFD2H41,3900,1/4/2020,9900,RHFD2H41,17700,more than downpayment,more than downpayment,0,3900
RHFD2H41,3900,2/5/2020,9900,RHFD2H41,21600,more than downpayment,more than downpayment,0,3900
rimTtdAa,8900,1/21/2019,8900,,8900,equal to downpayment,,8900,0
rimTtdAa,3900,3/1/2019,8900,rimTtdAa,12800,more than downpayment,equal to downpayment,0,3900
rimTtdAa,3900,3/25/2019,8900,rimTtdAa,16700,more than downpayment,more than downpayment,0,3900
rimTtdAa,3900,4/25/2019,8900,rimTtdAa,20600,more than downpayment,more than downpayment,0,3900
rimTtdAa,3900,5/25/2019,8900,rimTtdAa,24500,more than downpayment,more than downpayment,0,3900
rimTtdAa,3900,6/25/2019,8900,rimTtdAa,28400,more than downpayment,more than downpayment,0,3900
rimTtdAa,3900,7/25/2019,8900,rimTtdAa,32300,more than downpayment,more than downpayment,0,3900
rimTtdAa,3900,8/25/2019,8900,rimTtdAa,36200,more than downpayment,more than downpayment,0,3900
rimTtdAa,3900,10/4/2019,8900,rimTtdAa,40100,more than downpayment,more than downpayment,0,3900
rimTtdAa,3900,10/25/2019,8900,rimTtdAa,44000,more than downpayment,more than downpayment,0,3900
rimTtdAa,3900,11/25/2019,8900,rimTtdAa,47900,more than downpayment,more than downpayment,0,3900
rimTtdAa,3900,12/26/2019,8900,rimTtdAa,51800,more than downpayment,more than downpayment,0,3900
rimTtdAa,3900,1/24/2020,8900,rimTtdAa,55700,more than downpayment,more than downpayment,0,3900
RIoE7QxR,10000,1/13/2018,10000,,10000,equal to downpayment,,10000,0
RIoE7QxR,4500,2/15/2018,10000,RIoE7QxR,14500,more than downpayment,equal to downpayment,0,4500
RIoE7QxR,4500,3/19/2018,10000,RIoE7QxR,19000,more than downpayment,more than downpayment,0,4500
RIoE7QxR,4500,4/17/2018,10000,RIoE7QxR,23500,more than downpayment,more than downpayment,0,4500
RIoE7QxR,4500,5/17/2018,10000,RIoE7QxR,28000,more than downpayment,more than downpayment,0,4500
RIoE7QxR,2500,8/14/2018,10000,RIoE7QxR,30500,more than downpayment,more than downpayment,0,2500
RIoE7QxR,2000,8/15/2018,10000,RIoE7QxR,32500,more than downpayment,more than downpayment,0,2000
RIoE7QxR,4500,9/11/2018,10000,RIoE7QxR,37000,more than downpayment,more than downpayment,0,4500
RIoE7QxR,2500,10/1/2018,10000,RIoE7QxR,39500,more than downpayment,more than downpayment,0,2500
RIoE7QxR,2000,10/3/2018,10000,RIoE7QxR,41500,more than downpayment,more than downpayment,0,2000
RIoE7QxR,4500,10/9/2018,10000,RIoE7QxR,46000,more than downpayment,more than downpayment,0,4500
RIoE7QxR,4500,11/9/2018,10000,RIoE7QxR,50500,more than downpayment,more than downpayment,0,4500
RIoE7QxR,2500,1/11/2019,10000,RIoE7QxR,53000,more than downpayment,more than downpayment,0,2500
RIoE7QxR,2000,1/16/2019,10000,RIoE7QxR,55000,more than downpayment,more than downpayment,0,2000
RIoE7QxR,4500,2/14/2019,10000,RIoE7QxR,59500,more than downpayment,more than downpayment,0,4500
RIoE7QxR,4500,3/7/2019,10000,RIoE7QxR,64000,more than downpayment,more than downpayment,0,4500
RIXNVOOW,8900,6/2/2019,8900,,8900,equal to downpayment,,8900,0
RIXNVOOW,200,7/1/2019,8900,RIXNVOOW,9100,more than downpayment,equal to downpayment,0,200
RIXNVOOW,100,7/2/2019,8900,RIXNVOOW,9200,more than downpayment,more than downpayment,0,100
RIXNVOOW,1000,7/20/2019,8900,RIXNVOOW,10200,more than downpayment,more than downpayment,0,1000
RIXNVOOW,2600,7/24/2019,8900,RIXNVOOW,12800,more than downpayment,more than downpayment,0,2600
RIXNVOOW,1080,8/8/2019,8900,RIXNVOOW,13880,more than downpayment,more than downpayment,0,1080
RIXNVOOW,1000,8/10/2019,8900,RIXNVOOW,14880,more than downpayment,more than downpayment,0,1000
RIXNVOOW,1820,8/23/2019,8900,RIXNVOOW,16700,more than downpayment,more than downpayment,0,1820
RIXNVOOW,1000,9/28/2019,8900,RIXNVOOW,17700,more than downpayment,more than downpayment,0,1000
RIXNVOOW,5800,10/29/2019,8900,RIXNVOOW,23500,more than downpayment,more than downpayment,0,5800
RJB5B311,9900,7/31/2019,9900,,9900,equal to downpayment,,9900,0
RJB5B311,1500,10/3/2019,9900,RJB5B311,11400,more than downpayment,equal to downpayment,0,1500
RJB5B311,500,10/16/2019,9900,RJB5B311,11900,more than downpayment,more than downpayment,0,500
RJB5B311,2000,10/18/2019,9900,RJB5B311,13900,more than downpayment,more than downpayment,0,2000
RJB5B311,5500,11/20/2019,9900,RJB5B311,19400,more than downpayment,more than downpayment,0,5500
RJB5B311,1200,12/3/2019,9900,RJB5B311,20600,more than downpayment,more than downpayment,0,1200
RJB5B311,900,12/5/2019,9900,RJB5B311,21500,more than downpayment,more than downpayment,0,900
RJB5B311,100,12/16/2019,9900,RJB5B311,21600,more than downpayment,more than downpayment,0,100
RJB5B311,3900,12/23/2019,9900,RJB5B311,25500,more than downpayment,more than downpayment,0,3900
RJB5B311,3900,1/24/2020,9900,RJB5B311,29400,more than downpayment,more than downpayment,0,3900
RjhzaQfl,8900,2/28/2019,8900,,8900,equal to downpayment,,8900,0
RjhzaQfl,7800,3/5/2019,8900,RjhzaQfl,16700,more than downpayment,equal to downpayment,0,7800
RjhzaQfl,3900,5/6/2019,8900,RjhzaQfl,20600,more than downpayment,more than downpayment,0,3900
RjhzaQfl,3900,6/4/2019,8900,RjhzaQfl,24500,more than downpayment,more than downpayment,0,3900
RjhzaQfl,3900,7/5/2019,8900,RjhzaQfl,28400,more than downpayment,more than downpayment,0,3900
RjhzaQfl,3900,8/5/2019,8900,RjhzaQfl,32300,more than downpayment,more than downpayment,0,3900
RjhzaQfl,3900,9/9/2019,8900,RjhzaQfl,36200,more than downpayment,more than downpayment,0,3900
RjhzaQfl,3900,10/7/2019,8900,RjhzaQfl,40100,more than downpayment,more than downpayment,0,3900
RjhzaQfl,3900,11/5/2019,8900,RjhzaQfl,44000,more than downpayment,more than downpayment,0,3900
RjhzaQfl,3900,12/6/2019,8900,RjhzaQfl,47900,more than downpayment,more than downpayment,0,3900
RjhzaQfl,8800,1/2/2020,8900,RjhzaQfl,56700,more than downpayment,more than downpayment,0,8800
RjhzaQfl,3900,2/3/2020,8900,RjhzaQfl,60600,more than downpayment,more than downpayment,0,3900
RJK2mvWT,8900,4/17/2019,8900,,8900,equal to downpayment,,8900,0
RJK2mvWT,3900,5/25/2019,8900,RJK2mvWT,12800,more than downpayment,equal to downpayment,0,3900
RJK2mvWT,3900,6/25/2019,8900,RJK2mvWT,16700,more than downpayment,more than downpayment,0,3900
RJK2mvWT,3900,7/25/2019,8900,RJK2mvWT,20600,more than downpayment,more than downpayment,0,3900
RJK2mvWT,3900,8/27/2019,8900,RJK2mvWT,24500,more than downpayment,more than downpayment,0,3900
RJK2mvWT,3900,10/1/2019,8900,RJK2mvWT,28400,more than downpayment,more than downpayment,0,3900
RJK2mvWT,3900,10/26/2019,8900,RJK2mvWT,32300,more than downpayment,more than downpayment,0,3900
RJK2mvWT,3900,11/26/2019,8900,RJK2mvWT,36200,more than downpayment,more than downpayment,0,3900
RJK2mvWT,3900,12/31/2019,8900,RJK2mvWT,40100,more than downpayment,more than downpayment,0,3900
RJK2mvWT,3900,1/24/2020,8900,RJK2mvWT,44000,more than downpayment,more than downpayment,0,3900
RjyHg7tk,9900,11/2/2018,9900,,9900,equal to downpayment,,9900,0
RjyHg7tk,4500,11/23/2018,9900,RjyHg7tk,14400,more than downpayment,equal to downpayment,0,4500
RjyHg7tk,4500,12/22/2018,9900,RjyHg7tk,18900,more than downpayment,more than downpayment,0,4500
RjyHg7tk,4500,1/22/2019,9900,RjyHg7tk,23400,more than downpayment,more than downpayment,0,4500
RjyHg7tk,4500,2/24/2019,9900,RjyHg7tk,27900,more than downpayment,more than downpayment,0,4500
RjyHg7tk,4500,3/22/2019,9900,RjyHg7tk,32400,more than downpayment,more than downpayment,0,4500
RjyHg7tk,4500,4/20/2019,9900,RjyHg7tk,36900,more than downpayment,more than downpayment,0,4500
RjyHg7tk,4500,5/24/2019,9900,RjyHg7tk,41400,more than downpayment,more than downpayment,0,4500
RjyHg7tk,4500,6/24/2019,9900,RjyHg7tk,45900,more than downpayment,more than downpayment,0,4500
RjyHg7tk,4500,7/24/2019,9900,RjyHg7tk,50400,more than downpayment,more than downpayment,0,4500
RjyHg7tk,4500,8/24/2019,9900,RjyHg7tk,54900,more than downpayment,more than downpayment,0,4500
RjyHg7tk,4500,9/21/2019,9900,RjyHg7tk,59400,more than downpayment,more than downpayment,0,4500
RjyHg7tk,4500,10/25/2019,9900,RjyHg7tk,63900,more than downpayment,more than downpayment,0,4500
RjyHg7tk,3900,12/24/2019,9900,RjyHg7tk,67800,more than downpayment,more than downpayment,0,3900
rLB2wVWI,8900,1/29/2019,8900,,8900,equal to downpayment,,8900,0
rLB2wVWI,3900,2/21/2019,8900,rLB2wVWI,12800,more than downpayment,equal to downpayment,0,3900
rLB2wVWI,3900,3/9/2019,8900,rLB2wVWI,16700,more than downpayment,more than downpayment,0,3900
rLB2wVWI,3900,3/20/2019,8900,rLB2wVWI,20600,more than downpayment,more than downpayment,0,3900
rLB2wVWI,3900,6/20/2019,8900,rLB2wVWI,24500,more than downpayment,more than downpayment,0,3900
rLB2wVWI,3900,7/19/2019,8900,rLB2wVWI,28400,more than downpayment,more than downpayment,0,3900
rLB2wVWI,3900,8/25/2019,8900,rLB2wVWI,32300,more than downpayment,more than downpayment,0,3900
rLB2wVWI,3900,9/27/2019,8900,rLB2wVWI,36200,more than downpayment,more than downpayment,0,3900
rLB2wVWI,3900,10/26/2019,8900,rLB2wVWI,40100,more than downpayment,more than downpayment,0,3900
rLB2wVWI,3900,11/26/2019,8900,rLB2wVWI,44000,more than downpayment,more than downpayment,0,3900
rLB2wVWI,3900,12/22/2019,8900,rLB2wVWI,47900,more than downpayment,more than downpayment,0,3900
rLB2wVWI,3900,1/28/2020,8900,rLB2wVWI,51800,more than downpayment,more than downpayment,0,3900
RLT5VGAK,9900,9/19/2019,9900,,9900,equal to downpayment,,9900,0
RLT5VGAK,3900,11/4/2019,9900,RLT5VGAK,13800,more than downpayment,equal to downpayment,0,3900
RLT5VGAK,3900,12/4/2019,9900,RLT5VGAK,17700,more than downpayment,more than downpayment,0,3900
RLT5VGAK,3900,1/6/2020,9900,RLT5VGAK,21600,more than downpayment,more than downpayment,0,3900
RLT5VGAK,3900,2/5/2020,9900,RLT5VGAK,25500,more than downpayment,more than downpayment,0,3900
Rnnh0zkU,9900,11/1/2018,9900,,9900,equal to downpayment,,9900,0
Rnnh0zkU,4500,11/25/2018,9900,Rnnh0zkU,14400,more than downpayment,equal to downpayment,0,4500
Rnnh0zkU,4500,12/23/2018,9900,Rnnh0zkU,18900,more than downpayment,more than downpayment,0,4500
Rnnh0zkU,4500,1/31/2019,9900,Rnnh0zkU,23400,more than downpayment,more than downpayment,0,4500
Rnnh0zkU,4500,4/2/2019,9900,Rnnh0zkU,27900,more than downpayment,more than downpayment,0,4500
Rnnh0zkU,4500,5/2/2019,9900,Rnnh0zkU,32400,more than downpayment,more than downpayment,0,4500
Rnnh0zkU,4500,6/3/2019,9900,Rnnh0zkU,36900,more than downpayment,more than downpayment,0,4500
Rnnh0zkU,4500,6/30/2019,9900,Rnnh0zkU,41400,more than downpayment,more than downpayment,0,4500
Rnnh0zkU,15000,8/19/2019,9900,Rnnh0zkU,56400,more than downpayment,more than downpayment,0,15000
Rnnh0zkU,7500,11/12/2019,9900,Rnnh0zkU,63900,more than downpayment,more than downpayment,0,7500
Rnnh0zkU,400,1/25/2020,9900,Rnnh0zkU,64300,more than downpayment,more than downpayment,0,400
RNT15HKR,8600,1/4/2020,9900,,8600,less than downpayment,,8600,0
RNT15HKR,1300,1/10/2020,9900,RNT15HKR,9900,equal to downpayment,less than downpayment,1300,0
ROB34T2K,9900,11/26/2019,9900,,9900,equal to downpayment,,9900,0
rOhP91pc,10000,1/2/2019,10000,,10000,equal to downpayment,,10000,0
rOhP91pc,4500,1/26/2019,10000,rOhP91pc,14500,more than downpayment,equal to downpayment,0,4500
rOhP91pc,4500,2/26/2019,10000,rOhP91pc,19000,more than downpayment,more than downpayment,0,4500
rOhP91pc,4500,3/27/2019,10000,rOhP91pc,23500,more than downpayment,more than downpayment,0,4500
rOhP91pc,4500,4/26/2019,10000,rOhP91pc,28000,more than downpayment,more than downpayment,0,4500
rOhP91pc,4500,8/31/2019,10000,rOhP91pc,32500,more than downpayment,more than downpayment,0,4500
RPSEJSVO,9900,10/8/2019,9900,,9900,equal to downpayment,,9900,0
RPSEJSVO,3900,12/3/2019,9900,RPSEJSVO,13800,more than downpayment,equal to downpayment,0,3900
RPSEJSVO,3900,12/31/2019,9900,RPSEJSVO,17700,more than downpayment,more than downpayment,0,3900
RPSEJSVO,3900,2/4/2020,9900,RPSEJSVO,21600,more than downpayment,more than downpayment,0,3900
rq2hPxuS,9900,6/10/2019,9900,,9900,equal to downpayment,,9900,0
rq2hPxuS,3900,7/16/2019,9900,rq2hPxuS,13800,more than downpayment,equal to downpayment,0,3900
rq2hPxuS,3900,8/31/2019,9900,rq2hPxuS,17700,more than downpayment,more than downpayment,0,3900
rq2hPxuS,3900,10/7/2019,9900,rq2hPxuS,21600,more than downpayment,more than downpayment,0,3900
rq2hPxuS,1000,10/26/2019,9900,rq2hPxuS,22600,more than downpayment,more than downpayment,0,1000
rq2hPxuS,1900,10/30/2019,9900,rq2hPxuS,24500,more than downpayment,more than downpayment,0,1900
rq2hPxuS,1000,11/6/2019,9900,rq2hPxuS,25500,more than downpayment,more than downpayment,0,1000
rq2hPxuS,3900,12/5/2019,9900,rq2hPxuS,29400,more than downpayment,more than downpayment,0,3900
rq2hPxuS,3900,1/6/2020,9900,rq2hPxuS,33300,more than downpayment,more than downpayment,0,3900
rq2hPxuS,2000,2/7/2020,9900,rq2hPxuS,35300,more than downpayment,more than downpayment,0,2000
RQFbhFsm,9900,8/13/2019,9900,,9900,equal to downpayment,,9900,0
RQFbhFsm,3900,10/15/2019,9900,RQFbhFsm,13800,more than downpayment,equal to downpayment,0,3900
RQFbhFsm,3650,12/2/2019,9900,RQFbhFsm,17450,more than downpayment,more than downpayment,0,3650
RQFbhFsm,2940,12/17/2019,9900,RQFbhFsm,20390,more than downpayment,more than downpayment,0,2940
RQFbhFsm,1210,12/31/2019,9900,RQFbhFsm,21600,more than downpayment,more than downpayment,0,1210
RQFbhFsm,3900,1/27/2020,9900,RQFbhFsm,25500,more than downpayment,more than downpayment,0,3900
rQGTmms6,8900,5/22/2019,8900,,8900,equal to downpayment,,8900,0
rQGTmms6,3900,7/4/2019,8900,rQGTmms6,12800,more than downpayment,equal to downpayment,0,3900
rQGTmms6,3900,8/7/2019,8900,rQGTmms6,16700,more than downpayment,more than downpayment,0,3900
Rr2OrSIS,10000,8/29/2017,10000,,10000,equal to downpayment,,10000,0
Rr2OrSIS,15000,9/19/2017,10000,Rr2OrSIS,25000,more than downpayment,equal to downpayment,0,15000
Rr2OrSIS,5000,10/11/2017,10000,Rr2OrSIS,30000,more than downpayment,more than downpayment,0,5000
Rr2OrSIS,5000,10/31/2017,10000,Rr2OrSIS,35000,more than downpayment,more than downpayment,0,5000
Rr2OrSIS,5000,11/22/2017,10000,Rr2OrSIS,40000,more than downpayment,more than downpayment,0,5000
Rr2OrSIS,5000,10/12/2018,10000,Rr2OrSIS,45000,more than downpayment,more than downpayment,0,5000
RR7MHCVC,8900,7/22/2019,8900,,8900,equal to downpayment,,8900,0
RR7MHCVC,5000,8/15/2019,8900,RR7MHCVC,13900,more than downpayment,equal to downpayment,0,5000
RR7MHCVC,5000,9/11/2019,8900,RR7MHCVC,18900,more than downpayment,more than downpayment,0,5000
RR7MHCVC,5000,10/14/2019,8900,RR7MHCVC,23900,more than downpayment,more than downpayment,0,5000
RR7MHCVC,5000,11/9/2019,8900,RR7MHCVC,28900,more than downpayment,more than downpayment,0,5000
RR7MHCVC,5000,12/19/2019,8900,RR7MHCVC,33900,more than downpayment,more than downpayment,0,5000
RR7MHCVC,5000,1/24/2020,8900,RR7MHCVC,38900,more than downpayment,more than downpayment,0,5000
rrCsQR0z,8900,12/6/2018,8900,,8900,equal to downpayment,,8900,0
RT1xW0aJ,8900,4/3/2019,8900,,8900,equal to downpayment,,8900,0
RT1xW0aJ,3900,5/2/2019,8900,RT1xW0aJ,12800,more than downpayment,equal to downpayment,0,3900
RT1xW0aJ,3900,5/31/2019,8900,RT1xW0aJ,16700,more than downpayment,more than downpayment,0,3900
RT1xW0aJ,3900,7/1/2019,8900,RT1xW0aJ,20600,more than downpayment,more than downpayment,0,3900
RT1xW0aJ,3900,8/4/2019,8900,RT1xW0aJ,24500,more than downpayment,more than downpayment,0,3900
RT1xW0aJ,3900,8/31/2019,8900,RT1xW0aJ,28400,more than downpayment,more than downpayment,0,3900
RT1xW0aJ,3900,10/3/2019,8900,RT1xW0aJ,32300,more than downpayment,more than downpayment,0,3900
RT1xW0aJ,3900,11/1/2019,8900,RT1xW0aJ,36200,more than downpayment,more than downpayment,0,3900
RT1xW0aJ,3900,12/2/2019,8900,RT1xW0aJ,40100,more than downpayment,more than downpayment,0,3900
RT1xW0aJ,3900,12/31/2019,8900,RT1xW0aJ,44000,more than downpayment,more than downpayment,0,3900
RT1xW0aJ,3900,1/31/2020,8900,RT1xW0aJ,47900,more than downpayment,more than downpayment,0,3900
rTckok8e,9900,11/21/2018,9900,,9900,equal to downpayment,,9900,0
RTXEBVB4,9900,11/23/2019,9900,,9900,equal to downpayment,,9900,0
RTXEBVB4,3900,1/10/2020,9900,RTXEBVB4,13800,more than downpayment,equal to downpayment,0,3900
RUD5M1GU,9900,11/28/2019,9900,,9900,equal to downpayment,,9900,0
RUD5M1GU,3900,2/5/2020,9900,RUD5M1GU,13800,more than downpayment,equal to downpayment,0,3900
rUfqK6cu,8900,5/2/2019,8900,,8900,equal to downpayment,,8900,0
rUfqK6cu,3900,6/24/2019,8900,rUfqK6cu,12800,more than downpayment,equal to downpayment,0,3900
rUfqK6cu,3900,7/26/2019,8900,rUfqK6cu,16700,more than downpayment,more than downpayment,0,3900
rUfqK6cu,3900,8/27/2019,8900,rUfqK6cu,20600,more than downpayment,more than downpayment,0,3900
rUfqK6cu,3900,9/24/2019,8900,rUfqK6cu,24500,more than downpayment,more than downpayment,0,3900
rUfqK6cu,3900,10/31/2019,8900,rUfqK6cu,28400,more than downpayment,more than downpayment,0,3900
rUfqK6cu,3900,11/29/2019,8900,rUfqK6cu,32300,more than downpayment,more than downpayment,0,3900
rUfqK6cu,3900,1/13/2020,8900,rUfqK6cu,36200,more than downpayment,more than downpayment,0,3900
rUfqK6cu,3900,2/6/2020,8900,rUfqK6cu,40100,more than downpayment,more than downpayment,0,3900
rui1ZhuX,8900,7/11/2019,8900,,8900,equal to downpayment,,8900,0
rui1ZhuX,3900,9/3/2019,8900,rui1ZhuX,12800,more than downpayment,equal to downpayment,0,3900
rui1ZhuX,3900,10/2/2019,8900,rui1ZhuX,16700,more than downpayment,more than downpayment,0,3900
rui1ZhuX,3900,11/4/2019,8900,rui1ZhuX,20600,more than downpayment,more than downpayment,0,3900
rui1ZhuX,3900,12/5/2019,8900,rui1ZhuX,24500,more than downpayment,more than downpayment,0,3900
rui1ZhuX,3900,1/4/2020,8900,rui1ZhuX,28400,more than downpayment,more than downpayment,0,3900
rui1ZhuX,3900,2/3/2020,8900,rui1ZhuX,32300,more than downpayment,more than downpayment,0,3900
RUPGNUII,8900,5/21/2019,8900,,8900,equal to downpayment,,8900,0
RUPGNUII,4000,7/14/2019,8900,RUPGNUII,12900,more than downpayment,equal to downpayment,0,4000
RUPGNUII,7500,9/6/2019,8900,RUPGNUII,20400,more than downpayment,more than downpayment,0,7500
RUPGNUII,4100,10/23/2019,8900,RUPGNUII,24500,more than downpayment,more than downpayment,0,4100
RUPGNUII,3900,11/15/2019,8900,RUPGNUII,28400,more than downpayment,more than downpayment,0,3900
RUPGNUII,3900,12/22/2019,8900,RUPGNUII,32300,more than downpayment,more than downpayment,0,3900
RUPGNUII,3900,12/26/2019,8900,RUPGNUII,36200,more than downpayment,more than downpayment,0,3900
RUPGNUII,3900,1/20/2020,8900,RUPGNUII,40100,more than downpayment,more than downpayment,0,3900
rutKXcl9,8900,3/6/2019,8900,,8900,equal to downpayment,,8900,0
rVm1Tnev,6690,4/25/2017,6690,,6690,equal to downpayment,,6690,0
rVm1Tnev,2000,5/12/2017,6690,rVm1Tnev,8690,more than downpayment,equal to downpayment,0,2000
rVm1Tnev,676,6/1/2017,6690,rVm1Tnev,9366,more than downpayment,more than downpayment,0,676
rVm1Tnev,1676,6/27/2017,6690,rVm1Tnev,11042,more than downpayment,more than downpayment,0,1676
rVm1Tnev,1000,7/7/2017,6690,rVm1Tnev,12042,more than downpayment,more than downpayment,0,1000
rVm1Tnev,2500,7/25/2017,6690,rVm1Tnev,14542,more than downpayment,more than downpayment,0,2500
rVm1Tnev,2000,9/6/2017,6690,rVm1Tnev,16542,more than downpayment,more than downpayment,0,2000
rVm1Tnev,1000,2/15/2018,6690,rVm1Tnev,17542,more than downpayment,more than downpayment,0,1000
rVm1Tnev,1000,2/20/2018,6690,rVm1Tnev,18542,more than downpayment,more than downpayment,0,1000
rVm1Tnev,1000,3/2/2018,6690,rVm1Tnev,19542,more than downpayment,more than downpayment,0,1000
rVm1Tnev,500,11/19/2018,6690,rVm1Tnev,20042,more than downpayment,more than downpayment,0,500
rVm1Tnev,1000,4/23/2019,6690,rVm1Tnev,21042,more than downpayment,more than downpayment,0,1000
rVm1Tnev,500,5/2/2019,6690,rVm1Tnev,21542,more than downpayment,more than downpayment,0,500
rVm1Tnev,500,5/10/2019,6690,rVm1Tnev,22042,more than downpayment,more than downpayment,0,500
rVm1Tnev,500,5/20/2019,6690,rVm1Tnev,22542,more than downpayment,more than downpayment,0,500
rVm1Tnev,500,5/31/2019,6690,rVm1Tnev,23042,more than downpayment,more than downpayment,0,500
rVm1Tnev,500,6/19/2019,6690,rVm1Tnev,23542,more than downpayment,more than downpayment,0,500
rVm1Tnev,600,7/30/2019,6690,rVm1Tnev,24142,more than downpayment,more than downpayment,0,600
rWaQGx0V,10000,12/20/2017,10000,,10000,equal to downpayment,,10000,0
rWaQGx0V,4500,2/15/2018,10000,rWaQGx0V,14500,more than downpayment,equal to downpayment,0,4500
rWaQGx0V,4500,3/15/2018,10000,rWaQGx0V,19000,more than downpayment,more than downpayment,0,4500
rWaQGx0V,4500,4/16/2018,10000,rWaQGx0V,23500,more than downpayment,more than downpayment,0,4500
rWaQGx0V,4500,5/16/2018,10000,rWaQGx0V,28000,more than downpayment,more than downpayment,0,4500
rWaQGx0V,4500,6/19/2018,10000,rWaQGx0V,32500,more than downpayment,more than downpayment,0,4500
rWaQGx0V,4500,8/1/2018,10000,rWaQGx0V,37000,more than downpayment,more than downpayment,0,4500
rWaQGx0V,2500,9/4/2018,10000,rWaQGx0V,39500,more than downpayment,more than downpayment,0,2500
rWaQGx0V,3500,11/13/2018,10000,rWaQGx0V,43000,more than downpayment,more than downpayment,0,3500
rWaQGx0V,3000,1/15/2019,10000,rWaQGx0V,46000,more than downpayment,more than downpayment,0,3000
rWaQGx0V,2000,1/22/2019,10000,rWaQGx0V,48000,more than downpayment,more than downpayment,0,2000
rWaQGx0V,3000,2/14/2019,10000,rWaQGx0V,51000,more than downpayment,more than downpayment,0,3000
rWaQGx0V,1500,3/13/2019,10000,rWaQGx0V,52500,more than downpayment,more than downpayment,0,1500
rWaQGx0V,1500,3/21/2019,10000,rWaQGx0V,54000,more than downpayment,more than downpayment,0,1500
rWaQGx0V,10000,4/29/2019,10000,rWaQGx0V,64000,more than downpayment,more than downpayment,0,10000
RWyuvOdO,8900,3/8/2019,8900,,8900,equal to downpayment,,8900,0
RWyuvOdO,3900,4/13/2019,8900,RWyuvOdO,12800,more than downpayment,equal to downpayment,0,3900
RWyuvOdO,3900,5/13/2019,8900,RWyuvOdO,16700,more than downpayment,more than downpayment,0,3900
RWyuvOdO,3900,6/14/2019,8900,RWyuvOdO,20600,more than downpayment,more than downpayment,0,3900
RWyuvOdO,3900,7/15/2019,8900,RWyuvOdO,24500,more than downpayment,more than downpayment,0,3900
RWyuvOdO,3900,8/14/2019,8900,RWyuvOdO,28400,more than downpayment,more than downpayment,0,3900
RWyuvOdO,3900,9/13/2019,8900,RWyuvOdO,32300,more than downpayment,more than downpayment,0,3900
RWyuvOdO,3900,10/14/2019,8900,RWyuvOdO,36200,more than downpayment,more than downpayment,0,3900
RWyuvOdO,3900,11/11/2019,8900,RWyuvOdO,40100,more than downpayment,more than downpayment,0,3900
RWyuvOdO,3900,12/13/2019,8900,RWyuvOdO,44000,more than downpayment,more than downpayment,0,3900
RWyuvOdO,3900,1/14/2020,8900,RWyuvOdO,47900,more than downpayment,more than downpayment,0,3900
rx9OFE2O,10000,6/2/2017,10000,,10000,equal to downpayment,,10000,0
rx9OFE2O,3000,7/13/2017,10000,rx9OFE2O,13000,more than downpayment,equal to downpayment,0,3000
rx9OFE2O,3000,12/27/2017,10000,rx9OFE2O,16000,more than downpayment,more than downpayment,0,3000
rx9OFE2O,3000,2/26/2018,10000,rx9OFE2O,19000,more than downpayment,more than downpayment,0,3000
rx9OFE2O,3000,8/20/2018,10000,rx9OFE2O,22000,more than downpayment,more than downpayment,0,3000
rx9OFE2O,4000,2/6/2019,10000,rx9OFE2O,26000,more than downpayment,more than downpayment,0,4000
rx9OFE2O,1000,5/10/2019,10000,rx9OFE2O,27000,more than downpayment,more than downpayment,0,1000
RXAF675S,55700,10/28/2019,8900,,55700,more than downpayment,,8900,46800
RXDGCICJ,9900,1/27/2020,9900,,9900,equal to downpayment,,9900,0
RxhBoKqg,9900,7/6/2019,9900,,9900,equal to downpayment,,9900,0
RxhBoKqg,4500,8/24/2019,9900,RxhBoKqg,14400,more than downpayment,equal to downpayment,0,4500
RxhBoKqg,4500,9/24/2019,9900,RxhBoKqg,18900,more than downpayment,more than downpayment,0,4500
RxhBoKqg,4500,10/23/2019,9900,RxhBoKqg,23400,more than downpayment,more than downpayment,0,4500
RxhBoKqg,4500,1/19/2020,9900,RxhBoKqg,27900,more than downpayment,more than downpayment,0,4500
RxhBoKqg,4500,1/23/2020,9900,RxhBoKqg,32400,more than downpayment,more than downpayment,0,4500
RXICIPCX,9900,10/5/2019,9900,,9900,equal to downpayment,,9900,0
RXICIPCX,3900,11/18/2019,9900,RXICIPCX,13800,more than downpayment,equal to downpayment,0,3900
RXICIPCX,4000,1/12/2020,9900,RXICIPCX,17800,more than downpayment,more than downpayment,0,4000
RXMEkKfR,12000,10/30/2018,8900,,12000,more than downpayment,,8900,3100
RXMEkKfR,8000,11/22/2018,8900,RXMEkKfR,20000,more than downpayment,more than downpayment,0,8000
RXMEkKfR,16000,1/29/2019,8900,RXMEkKfR,36000,more than downpayment,more than downpayment,0,16000
RXMEkKfR,16000,3/8/2019,8900,RXMEkKfR,52000,more than downpayment,more than downpayment,0,16000
RXMEkKfR,13000,4/25/2019,8900,RXMEkKfR,65000,more than downpayment,more than downpayment,0,13000
RXMEkKfR,10000,6/4/2019,8900,RXMEkKfR,75000,more than downpayment,more than downpayment,0,10000
RXMEkKfR,18000,7/4/2019,8900,RXMEkKfR,93000,more than downpayment,more than downpayment,0,18000
RXMEkKfR,14000,8/9/2019,8900,RXMEkKfR,107000,more than downpayment,more than downpayment,0,14000
RXMEkKfR,14900,10/1/2019,8900,RXMEkKfR,121900,more than downpayment,more than downpayment,0,14900
RXMEkKfR,4000,11/6/2019,8900,RXMEkKfR,125900,more than downpayment,more than downpayment,0,4000
RXVN3IYO,10000,11/23/2019,9900,,10000,more than downpayment,,9900,100
RyAf2ymB,8900,1/28/2019,8900,,8900,equal to downpayment,,8900,0
RyAf2ymB,4000,3/5/2019,8900,RyAf2ymB,12900,more than downpayment,equal to downpayment,0,4000
RyAf2ymB,4000,4/5/2019,8900,RyAf2ymB,16900,more than downpayment,more than downpayment,0,4000
RyAf2ymB,3900,5/8/2019,8900,RyAf2ymB,20800,more than downpayment,more than downpayment,0,3900
RyAf2ymB,3900,6/6/2019,8900,RyAf2ymB,24700,more than downpayment,more than downpayment,0,3900
RyAf2ymB,3900,7/8/2019,8900,RyAf2ymB,28600,more than downpayment,more than downpayment,0,3900
RyAf2ymB,3900,8/6/2019,8900,RyAf2ymB,32500,more than downpayment,more than downpayment,0,3900
RyAf2ymB,3900,9/6/2019,8900,RyAf2ymB,36400,more than downpayment,more than downpayment,0,3900
RyAf2ymB,3900,10/7/2019,8900,RyAf2ymB,40300,more than downpayment,more than downpayment,0,3900
RyAf2ymB,3900,11/11/2019,8900,RyAf2ymB,44200,more than downpayment,more than downpayment,0,3900
RyAf2ymB,3700,12/31/2019,8900,RyAf2ymB,47900,more than downpayment,more than downpayment,0,3700
RyAf2ymB,3900,1/7/2020,8900,RyAf2ymB,51800,more than downpayment,more than downpayment,0,3900
RyAf2ymB,3900,2/6/2020,8900,RyAf2ymB,55700,more than downpayment,more than downpayment,0,3900
RYSPewie,8900,11/28/2018,8900,,8900,equal to downpayment,,8900,0
RYSPewie,3900,1/23/2019,8900,RYSPewie,12800,more than downpayment,equal to downpayment,0,3900
RYSPewie,3900,3/8/2019,8900,RYSPewie,16700,more than downpayment,more than downpayment,0,3900
RYSPewie,3900,7/26/2019,8900,RYSPewie,20600,more than downpayment,more than downpayment,0,3900
RYSPewie,2000,8/1/2019,8900,RYSPewie,22600,more than downpayment,more than downpayment,0,2000
RZCH9Y9S,10000,7/9/2019,8900,,10000,more than downpayment,,8900,1100
RZCH9Y9S,4000,8/16/2019,8900,RZCH9Y9S,14000,more than downpayment,more than downpayment,0,4000
RZCH9Y9S,4000,9/21/2019,8900,RZCH9Y9S,18000,more than downpayment,more than downpayment,0,4000
RZCH9Y9S,4000,10/22/2019,8900,RZCH9Y9S,22000,more than downpayment,more than downpayment,0,4000
RZCH9Y9S,4000,11/22/2019,8900,RZCH9Y9S,26000,more than downpayment,more than downpayment,0,4000
RZCH9Y9S,4000,12/19/2019,8900,RZCH9Y9S,30000,more than downpayment,more than downpayment,0,4000
RZCH9Y9S,3900,1/20/2020,8900,RZCH9Y9S,33900,more than downpayment,more than downpayment,0,3900
S0lRlEn8,8900,4/25/2019,8900,,8900,equal to downpayment,,8900,0
S0lRlEn8,3900,5/25/2019,8900,S0lRlEn8,12800,more than downpayment,equal to downpayment,0,3900
S0lRlEn8,3900,6/25/2019,8900,S0lRlEn8,16700,more than downpayment,more than downpayment,0,3900
S0lRlEn8,3900,7/27/2019,8900,S0lRlEn8,20600,more than downpayment,more than downpayment,0,3900
S0lRlEn8,3900,9/26/2019,8900,S0lRlEn8,24500,more than downpayment,more than downpayment,0,3900
S0lRlEn8,3900,10/29/2019,8900,S0lRlEn8,28400,more than downpayment,more than downpayment,0,3900
S0lRlEn8,3900,12/2/2019,8900,S0lRlEn8,32300,more than downpayment,more than downpayment,0,3900
S0lRlEn8,3900,1/1/2020,8900,S0lRlEn8,36200,more than downpayment,more than downpayment,0,3900
S0lRlEn8,3900,2/2/2020,8900,S0lRlEn8,40100,more than downpayment,more than downpayment,0,3900
s1ACDGBQ,8900,4/10/2019,8900,,8900,equal to downpayment,,8900,0
s1ACDGBQ,3900,6/5/2019,8900,s1ACDGBQ,12800,more than downpayment,equal to downpayment,0,3900
s1ACDGBQ,3900,7/7/2019,8900,s1ACDGBQ,16700,more than downpayment,more than downpayment,0,3900
s1ACDGBQ,3900,8/5/2019,8900,s1ACDGBQ,20600,more than downpayment,more than downpayment,0,3900
s1ACDGBQ,3900,9/5/2019,8900,s1ACDGBQ,24500,more than downpayment,more than downpayment,0,3900
s1ACDGBQ,3900,10/7/2019,8900,s1ACDGBQ,28400,more than downpayment,more than downpayment,0,3900
s1ACDGBQ,3900,11/11/2019,8900,s1ACDGBQ,32300,more than downpayment,more than downpayment,0,3900
s1ACDGBQ,3900,12/11/2019,8900,s1ACDGBQ,36200,more than downpayment,more than downpayment,0,3900
s1ACDGBQ,3900,1/7/2020,8900,s1ACDGBQ,40100,more than downpayment,more than downpayment,0,3900
s1ACDGBQ,3900,2/6/2020,8900,s1ACDGBQ,44000,more than downpayment,more than downpayment,0,3900
s1pzDS7T,8900,3/29/2019,8900,,8900,equal to downpayment,,8900,0
s1pzDS7T,3900,5/6/2019,8900,s1pzDS7T,12800,more than downpayment,equal to downpayment,0,3900
s1pzDS7T,3500,6/13/2019,8900,s1pzDS7T,16300,more than downpayment,more than downpayment,0,3500
s1pzDS7T,400,6/15/2019,8900,s1pzDS7T,16700,more than downpayment,more than downpayment,0,400
s1pzDS7T,2400,7/5/2019,8900,s1pzDS7T,19100,more than downpayment,more than downpayment,0,2400
s1pzDS7T,1300,7/15/2019,8900,s1pzDS7T,20400,more than downpayment,more than downpayment,0,1300
s1pzDS7T,1000,7/18/2019,8900,s1pzDS7T,21400,more than downpayment,more than downpayment,0,1000
s1pzDS7T,1900,8/5/2019,8900,s1pzDS7T,23300,more than downpayment,more than downpayment,0,1900
s1pzDS7T,600,8/7/2019,8900,s1pzDS7T,23900,more than downpayment,more than downpayment,0,600
s1pzDS7T,900,8/14/2019,8900,s1pzDS7T,24800,more than downpayment,more than downpayment,0,900
s1pzDS7T,2400,9/6/2019,8900,s1pzDS7T,27200,more than downpayment,more than downpayment,0,2400
s1pzDS7T,500,9/10/2019,8900,s1pzDS7T,27700,more than downpayment,more than downpayment,0,500
s1pzDS7T,900,9/12/2019,8900,s1pzDS7T,28600,more than downpayment,more than downpayment,0,900
s1pzDS7T,900,9/22/2019,8900,s1pzDS7T,29500,more than downpayment,more than downpayment,0,900
s1pzDS7T,900,9/30/2019,8900,s1pzDS7T,30400,more than downpayment,more than downpayment,0,900
s1pzDS7T,900,10/5/2019,8900,s1pzDS7T,31300,more than downpayment,more than downpayment,0,900
s1pzDS7T,400,10/6/2019,8900,s1pzDS7T,31700,more than downpayment,more than downpayment,0,400
s1pzDS7T,900,10/15/2019,8900,s1pzDS7T,32600,more than downpayment,more than downpayment,0,900
s1pzDS7T,500,10/21/2019,8900,s1pzDS7T,33100,more than downpayment,more than downpayment,0,500
s1pzDS7T,700,11/4/2019,8900,s1pzDS7T,33800,more than downpayment,more than downpayment,0,700
s1pzDS7T,400,11/15/2019,8900,s1pzDS7T,34200,more than downpayment,more than downpayment,0,400
s1pzDS7T,600,11/16/2019,8900,s1pzDS7T,34800,more than downpayment,more than downpayment,0,600
s1pzDS7T,400,11/17/2019,8900,s1pzDS7T,35200,more than downpayment,more than downpayment,0,400
s1pzDS7T,400,11/18/2019,8900,s1pzDS7T,35600,more than downpayment,more than downpayment,0,400
s1pzDS7T,600,11/19/2019,8900,s1pzDS7T,36200,more than downpayment,more than downpayment,0,600
s1pzDS7T,2900,12/4/2019,8900,s1pzDS7T,39100,more than downpayment,more than downpayment,0,2900
s1pzDS7T,1000,12/5/2019,8900,s1pzDS7T,40100,more than downpayment,more than downpayment,0,1000
s1pzDS7T,1000,12/21/2019,8900,s1pzDS7T,41100,more than downpayment,more than downpayment,0,1000
s1pzDS7T,1000,12/24/2019,8900,s1pzDS7T,42100,more than downpayment,more than downpayment,0,1000
s1pzDS7T,1000,1/3/2020,8900,s1pzDS7T,43100,more than downpayment,more than downpayment,0,1000
s1pzDS7T,900,1/15/2020,8900,s1pzDS7T,44000,more than downpayment,more than downpayment,0,900
s1pzDS7T,1000,2/3/2020,8900,s1pzDS7T,45000,more than downpayment,more than downpayment,0,1000
s4keRtOh,8900,7/1/2019,8900,,8900,equal to downpayment,,8900,0
s4keRtOh,1000,7/2/2019,8900,s4keRtOh,9900,more than downpayment,equal to downpayment,0,1000
s4keRtOh,3900,8/19/2019,8900,s4keRtOh,13800,more than downpayment,more than downpayment,0,3900
s4keRtOh,3900,9/24/2019,8900,s4keRtOh,17700,more than downpayment,more than downpayment,0,3900
s4keRtOh,3900,10/24/2019,8900,s4keRtOh,21600,more than downpayment,more than downpayment,0,3900
s4keRtOh,3900,11/24/2019,8900,s4keRtOh,25500,more than downpayment,more than downpayment,0,3900
s4keRtOh,3900,12/26/2019,8900,s4keRtOh,29400,more than downpayment,more than downpayment,0,3900
s4keRtOh,3900,1/26/2020,8900,s4keRtOh,33300,more than downpayment,more than downpayment,0,3900
S5SW4RCI,9900,11/19/2019,9900,,9900,equal to downpayment,,9900,0
S6R8ERTB,9900,12/20/2019,9900,,9900,equal to downpayment,,9900,0
S6S4wAI2,9000,7/24/2019,9900,,9000,less than downpayment,,9000,0
S6S4wAI2,900,7/25/2019,9900,S6S4wAI2,9900,equal to downpayment,less than downpayment,900,0
S6S4wAI2,4000,9/5/2019,9900,S6S4wAI2,13900,more than downpayment,equal to downpayment,0,4000
S6S4wAI2,3900,11/5/2019,9900,S6S4wAI2,17800,more than downpayment,more than downpayment,0,3900
S6S4wAI2,3900,12/6/2019,9900,S6S4wAI2,21700,more than downpayment,more than downpayment,0,3900
S6S4wAI2,2000,2/6/2020,9900,S6S4wAI2,23700,more than downpayment,more than downpayment,0,2000
S8I4KHYJ,9900,10/9/2019,9900,,9900,equal to downpayment,,9900,0
S8I4KHYJ,4000,12/19/2019,9900,S8I4KHYJ,13900,more than downpayment,equal to downpayment,0,4000
S8I4KHYJ,3900,1/16/2020,9900,S8I4KHYJ,17800,more than downpayment,more than downpayment,0,3900
S8K6VDDY,9900,8/11/2019,9900,,9900,equal to downpayment,,9900,0
S8K6VDDY,10100,9/27/2019,9900,S8K6VDDY,20000,more than downpayment,equal to downpayment,0,10100
S8K6VDDY,4000,10/3/2019,9900,S8K6VDDY,24000,more than downpayment,more than downpayment,0,4000
S8K6VDDY,2750,11/7/2019,9900,S8K6VDDY,26750,more than downpayment,more than downpayment,0,2750
S8K6VDDY,6000,11/13/2019,9900,S8K6VDDY,32750,more than downpayment,more than downpayment,0,6000
S8K6VDDY,6650,2/4/2020,9900,S8K6VDDY,39400,more than downpayment,more than downpayment,0,6650
S8UC5NPO,9900,11/8/2019,9900,,9900,equal to downpayment,,9900,0
s8xP0gGu,8900,1/14/2019,8900,,8900,equal to downpayment,,8900,0
s8xP0gGu,3900,2/15/2019,8900,s8xP0gGu,12800,more than downpayment,equal to downpayment,0,3900
s8xP0gGu,3900,4/4/2019,8900,s8xP0gGu,16700,more than downpayment,more than downpayment,0,3900
s8xP0gGu,3900,5/8/2019,8900,s8xP0gGu,20600,more than downpayment,more than downpayment,0,3900
s8xP0gGu,3900,6/3/2019,8900,s8xP0gGu,24500,more than downpayment,more than downpayment,0,3900
s8xP0gGu,3900,7/19/2019,8900,s8xP0gGu,28400,more than downpayment,more than downpayment,0,3900
s8xP0gGu,3900,8/1/2019,8900,s8xP0gGu,32300,more than downpayment,more than downpayment,0,3900
s8xP0gGu,3900,9/5/2019,8900,s8xP0gGu,36200,more than downpayment,more than downpayment,0,3900
s8xP0gGu,3900,10/27/2019,8900,s8xP0gGu,40100,more than downpayment,more than downpayment,0,3900
s8xP0gGu,3000,11/16/2019,8900,s8xP0gGu,43100,more than downpayment,more than downpayment,0,3000
s8xP0gGu,900,11/17/2019,8900,s8xP0gGu,44000,more than downpayment,more than downpayment,0,900
s8xP0gGu,3900,12/9/2019,8900,s8xP0gGu,47900,more than downpayment,more than downpayment,0,3900
s8xP0gGu,2800,1/9/2020,8900,s8xP0gGu,50700,more than downpayment,more than downpayment,0,2800
s8xP0gGu,5000,1/31/2020,8900,s8xP0gGu,55700,more than downpayment,more than downpayment,0,5000
SASrosBi,10000,11/3/2018,10000,,10000,equal to downpayment,,10000,0
SASrosBi,4500,12/31/2018,10000,SASrosBi,14500,more than downpayment,equal to downpayment,0,4500
SASrosBi,4500,1/31/2019,10000,SASrosBi,19000,more than downpayment,more than downpayment,0,4500
SASrosBi,4500,2/28/2019,10000,SASrosBi,23500,more than downpayment,more than downpayment,0,4500
SASrosBi,4500,3/27/2019,10000,SASrosBi,28000,more than downpayment,more than downpayment,0,4500
SASrosBi,4500,4/30/2019,10000,SASrosBi,32500,more than downpayment,more than downpayment,0,4500
SASrosBi,4500,5/31/2019,10000,SASrosBi,37000,more than downpayment,more than downpayment,0,4500
SASrosBi,4500,6/26/2019,10000,SASrosBi,41500,more than downpayment,more than downpayment,0,4500
SASrosBi,4500,7/27/2019,10000,SASrosBi,46000,more than downpayment,more than downpayment,0,4500
SASrosBi,4500,8/31/2019,10000,SASrosBi,50500,more than downpayment,more than downpayment,0,4500
SASrosBi,4500,9/28/2019,10000,SASrosBi,55000,more than downpayment,more than downpayment,0,4500
SASrosBi,4500,10/31/2019,10000,SASrosBi,59500,more than downpayment,more than downpayment,0,4500
SASrosBi,4500,11/27/2019,10000,SASrosBi,64000,more than downpayment,more than downpayment,0,4500
SBXH89SL,9900,9/14/2019,8900,,9900,more than downpayment,,8900,1000
SBXH89SL,2900,11/19/2019,8900,SBXH89SL,12800,more than downpayment,more than downpayment,0,2900
SBXH89SL,3900,12/5/2019,8900,SBXH89SL,16700,more than downpayment,more than downpayment,0,3900
SBXH89SL,3900,1/4/2020,8900,SBXH89SL,20600,more than downpayment,more than downpayment,0,3900
SBXH89SL,3900,2/4/2020,8900,SBXH89SL,24500,more than downpayment,more than downpayment,0,3900
SC9H331C,3200,12/24/2019,9900,,3200,less than downpayment,,3200,0
SC9H331C,4500,1/13/2020,9900,SC9H331C,7700,less than downpayment,less than downpayment,4500,0
SC9H331C,2200,1/15/2020,9900,SC9H331C,9900,equal to downpayment,less than downpayment,2200,0
sck6qBZq,8900,1/30/2019,8900,,8900,equal to downpayment,,8900,0
sck6qBZq,3600,3/10/2019,8900,sck6qBZq,12500,more than downpayment,equal to downpayment,0,3600
sck6qBZq,300,3/13/2019,8900,sck6qBZq,12800,more than downpayment,more than downpayment,0,300
sck6qBZq,3900,4/16/2019,8900,sck6qBZq,16700,more than downpayment,more than downpayment,0,3900
sck6qBZq,2000,5/17/2019,8900,sck6qBZq,18700,more than downpayment,more than downpayment,0,2000
sck6qBZq,1900,5/20/2019,8900,sck6qBZq,20600,more than downpayment,more than downpayment,0,1900
sck6qBZq,3900,6/14/2019,8900,sck6qBZq,24500,more than downpayment,more than downpayment,0,3900
sck6qBZq,3900,7/17/2019,8900,sck6qBZq,28400,more than downpayment,more than downpayment,0,3900
sck6qBZq,3900,8/16/2019,8900,sck6qBZq,32300,more than downpayment,more than downpayment,0,3900
sck6qBZq,3900,10/4/2019,8900,sck6qBZq,36200,more than downpayment,more than downpayment,0,3900
sck6qBZq,2000,10/30/2019,8900,sck6qBZq,38200,more than downpayment,more than downpayment,0,2000
sck6qBZq,1900,11/14/2019,8900,sck6qBZq,40100,more than downpayment,more than downpayment,0,1900
sck6qBZq,2000,12/23/2019,8900,sck6qBZq,42100,more than downpayment,more than downpayment,0,2000
sck6qBZq,2000,1/9/2020,8900,sck6qBZq,44100,more than downpayment,more than downpayment,0,2000
sck6qBZq,2000,1/19/2020,8900,sck6qBZq,46100,more than downpayment,more than downpayment,0,2000
sck6qBZq,2000,2/3/2020,8900,sck6qBZq,48100,more than downpayment,more than downpayment,0,2000
SDU4EH65,9900,12/8/2019,9900,,9900,equal to downpayment,,9900,0
SF3J1773,9900,6/3/2019,9900,,9900,equal to downpayment,,9900,0
SF3J1773,3900,7/1/2019,9900,SF3J1773,13800,more than downpayment,equal to downpayment,0,3900
SF3J1773,3900,8/12/2019,9900,SF3J1773,17700,more than downpayment,more than downpayment,0,3900
SF3J1773,7800,10/25/2019,9900,SF3J1773,25500,more than downpayment,more than downpayment,0,7800
SF3J1773,3900,11/11/2019,9900,SF3J1773,29400,more than downpayment,more than downpayment,0,3900
SF3J1773,3600,12/22/2019,9900,SF3J1773,33000,more than downpayment,more than downpayment,0,3600
SF3J1773,1900,1/24/2020,9900,SF3J1773,34900,more than downpayment,more than downpayment,0,1900
SF3J1773,2200,1/28/2020,9900,SF3J1773,37100,more than downpayment,more than downpayment,0,2200
SF72A7LG,9000,9/11/2019,8900,,9000,more than downpayment,,8900,100
SF72A7LG,3800,11/5/2019,8900,SF72A7LG,12800,more than downpayment,more than downpayment,0,3800
SF72A7LG,1300,12/10/2019,8900,SF72A7LG,14100,more than downpayment,more than downpayment,0,1300
SF72A7LG,2600,12/21/2019,8900,SF72A7LG,16700,more than downpayment,more than downpayment,0,2600
SF72A7LG,1300,1/16/2020,8900,SF72A7LG,18000,more than downpayment,more than downpayment,0,1300
SF72A7LG,1500,1/24/2020,8900,SF72A7LG,19500,more than downpayment,more than downpayment,0,1500
SF72A7LG,1100,1/28/2020,8900,SF72A7LG,20600,more than downpayment,more than downpayment,0,1100
Sf9R79jB,10000,4/1/2019,10000,,10000,equal to downpayment,,10000,0
Sf9R79jB,4500,5/7/2019,10000,Sf9R79jB,14500,more than downpayment,equal to downpayment,0,4500
Sf9R79jB,5000,9/13/2019,10000,Sf9R79jB,19500,more than downpayment,more than downpayment,0,5000
Sf9R79jB,5000,10/29/2019,10000,Sf9R79jB,24500,more than downpayment,more than downpayment,0,5000
SFH1SVXE,10000,7/8/2019,9900,,10000,more than downpayment,,9900,100
SFH1SVXE,8000,8/25/2019,9900,SFH1SVXE,18000,more than downpayment,more than downpayment,0,8000
SFH1SVXE,8000,10/25/2019,9900,SFH1SVXE,26000,more than downpayment,more than downpayment,0,8000
SFH1SVXE,4000,12/22/2019,9900,SFH1SVXE,30000,more than downpayment,more than downpayment,0,4000
SFH1SVXE,4000,1/25/2020,9900,SFH1SVXE,34000,more than downpayment,more than downpayment,0,4000
SGHVP8IX,9900,11/2/2019,9900,,9900,equal to downpayment,,9900,0
SGHVP8IX,11700,11/30/2019,9900,SGHVP8IX,21600,more than downpayment,equal to downpayment,0,11700
sgK107lv,2,8/2/2019,8900,,2,less than downpayment,,2,0
sGqLvKaQ,10000,6/30/2017,10000,,10000,equal to downpayment,,10000,0
sGqLvKaQ,3500,9/4/2017,10000,sGqLvKaQ,13500,more than downpayment,equal to downpayment,0,3500
sGqLvKaQ,3500,10/2/2017,10000,sGqLvKaQ,17000,more than downpayment,more than downpayment,0,3500
sGqLvKaQ,3500,11/3/2017,10000,sGqLvKaQ,20500,more than downpayment,more than downpayment,0,3500
sGqLvKaQ,3500,12/14/2017,10000,sGqLvKaQ,24000,more than downpayment,more than downpayment,0,3500
sGqLvKaQ,3500,1/15/2018,10000,sGqLvKaQ,27500,more than downpayment,more than downpayment,0,3500
sGqLvKaQ,3500,3/7/2018,10000,sGqLvKaQ,31000,more than downpayment,more than downpayment,0,3500
sGqLvKaQ,3500,4/27/2018,10000,sGqLvKaQ,34500,more than downpayment,more than downpayment,0,3500
sGqLvKaQ,3500,6/9/2018,10000,sGqLvKaQ,38000,more than downpayment,more than downpayment,0,3500
sGqLvKaQ,3500,7/24/2018,10000,sGqLvKaQ,41500,more than downpayment,more than downpayment,0,3500
sGqLvKaQ,3500,9/7/2018,10000,sGqLvKaQ,45000,more than downpayment,more than downpayment,0,3500
SHA23SNV,9900,1/29/2020,9900,,9900,equal to downpayment,,9900,0
SHCS4RZI,9900,11/13/2019,9900,,9900,equal to downpayment,,9900,0
SHCS4RZI,3900,12/10/2019,9900,SHCS4RZI,13800,more than downpayment,equal to downpayment,0,3900
SHCS4RZI,3900,1/14/2020,9900,SHCS4RZI,17700,more than downpayment,more than downpayment,0,3900
ShG3tBX7,8900,3/11/2019,10000,,8900,less than downpayment,,8900,0
ShG3tBX7,1100,4/17/2019,10000,ShG3tBX7,10000,equal to downpayment,less than downpayment,1100,0
ShG3tBX7,4500,5/25/2019,10000,ShG3tBX7,14500,more than downpayment,equal to downpayment,0,4500
ShG3tBX7,5000,6/29/2019,10000,ShG3tBX7,19500,more than downpayment,more than downpayment,0,5000
ShG3tBX7,4500,8/24/2019,10000,ShG3tBX7,24000,more than downpayment,more than downpayment,0,4500
ShG3tBX7,17000,11/9/2019,10000,ShG3tBX7,41000,more than downpayment,more than downpayment,0,17000
ShG3tBX7,500,12/7/2019,10000,ShG3tBX7,41500,more than downpayment,more than downpayment,0,500
SI5LDGKJ,8900,10/7/2019,8900,,8900,equal to downpayment,,8900,0
SI5LDGKJ,4000,11/8/2019,8900,SI5LDGKJ,12900,more than downpayment,equal to downpayment,0,4000
SI5LDGKJ,4000,12/4/2019,8900,SI5LDGKJ,16900,more than downpayment,more than downpayment,0,4000
SI5LDGKJ,4000,1/1/2020,8900,SI5LDGKJ,20900,more than downpayment,more than downpayment,0,4000
SI5LDGKJ,4000,2/6/2020,8900,SI5LDGKJ,24900,more than downpayment,more than downpayment,0,4000
sIhXa89Z,8900,1/2/2019,8900,,8900,equal to downpayment,,8900,0
sIhXa89Z,3900,2/6/2019,8900,sIhXa89Z,12800,more than downpayment,equal to downpayment,0,3900
sIhXa89Z,3900,3/25/2019,8900,sIhXa89Z,16700,more than downpayment,more than downpayment,0,3900
sIhXa89Z,3900,4/25/2019,8900,sIhXa89Z,20600,more than downpayment,more than downpayment,0,3900
sIhXa89Z,3900,5/25/2019,8900,sIhXa89Z,24500,more than downpayment,more than downpayment,0,3900
sIhXa89Z,4000,6/25/2019,8900,sIhXa89Z,28500,more than downpayment,more than downpayment,0,4000
sIhXa89Z,4000,7/25/2019,8900,sIhXa89Z,32500,more than downpayment,more than downpayment,0,4000
sIhXa89Z,3900,8/25/2019,8900,sIhXa89Z,36400,more than downpayment,more than downpayment,0,3900
sIhXa89Z,4000,9/25/2019,8900,sIhXa89Z,40400,more than downpayment,more than downpayment,0,4000
sIhXa89Z,4000,11/27/2019,8900,sIhXa89Z,44400,more than downpayment,more than downpayment,0,4000
sIhXa89Z,4000,12/18/2019,8900,sIhXa89Z,48400,more than downpayment,more than downpayment,0,4000
sIhXa89Z,4000,1/6/2020,8900,sIhXa89Z,52400,more than downpayment,more than downpayment,0,4000
sIhXa89Z,4000,1/26/2020,8900,sIhXa89Z,56400,more than downpayment,more than downpayment,0,4000
SKJpMRIG,8900,8/27/2019,8900,,8900,equal to downpayment,,8900,0
SKJpMRIG,3900,11/18/2019,8900,SKJpMRIG,12800,more than downpayment,equal to downpayment,0,3900
SKJpMRIG,3900,12/6/2019,8900,SKJpMRIG,16700,more than downpayment,more than downpayment,0,3900
SKJpMRIG,3900,1/27/2020,8900,SKJpMRIG,20600,more than downpayment,more than downpayment,0,3900
SkqoM626,12800,7/15/2019,8900,,12800,more than downpayment,,8900,3900
SkqoM626,1000,7/19/2019,8900,SkqoM626,13800,more than downpayment,more than downpayment,0,1000
SkqoM626,950,9/26/2019,8900,SkqoM626,14750,more than downpayment,more than downpayment,0,950
SkqoM626,950,10/5/2019,8900,SkqoM626,15700,more than downpayment,more than downpayment,0,950
SkqoM626,1100,10/25/2019,8900,SkqoM626,16800,more than downpayment,more than downpayment,0,1100
SkqoM626,900,10/28/2019,8900,SkqoM626,17700,more than downpayment,more than downpayment,0,900
SkqoM626,3000,11/29/2019,8900,SkqoM626,20700,more than downpayment,more than downpayment,0,3000
SkqoM626,1000,12/17/2019,8900,SkqoM626,21700,more than downpayment,more than downpayment,0,1000
SkqoM626,1000,12/31/2019,8900,SkqoM626,22700,more than downpayment,more than downpayment,0,1000
SkqoM626,3000,1/8/2020,8900,SkqoM626,25700,more than downpayment,more than downpayment,0,3000
SkqoM626,2000,1/31/2020,8900,SkqoM626,27700,more than downpayment,more than downpayment,0,2000
SkqoM626,1900,2/5/2020,8900,SkqoM626,29600,more than downpayment,more than downpayment,0,1900
SLIGZlCQ,8900,4/23/2019,8900,,8900,equal to downpayment,,8900,0
SLIGZlCQ,3900,5/15/2019,8900,SLIGZlCQ,12800,more than downpayment,equal to downpayment,0,3900
SLIGZlCQ,3900,6/20/2019,8900,SLIGZlCQ,16700,more than downpayment,more than downpayment,0,3900
SLIGZlCQ,3900,7/11/2019,8900,SLIGZlCQ,20600,more than downpayment,more than downpayment,0,3900
SLIGZlCQ,3900,8/14/2019,8900,SLIGZlCQ,24500,more than downpayment,more than downpayment,0,3900
SLIGZlCQ,3900,9/30/2019,8900,SLIGZlCQ,28400,more than downpayment,more than downpayment,0,3900
SLIGZlCQ,3900,10/23/2019,8900,SLIGZlCQ,32300,more than downpayment,more than downpayment,0,3900
SLIGZlCQ,3900,11/27/2019,8900,SLIGZlCQ,36200,more than downpayment,more than downpayment,0,3900
SLIGZlCQ,3900,12/28/2019,8900,SLIGZlCQ,40100,more than downpayment,more than downpayment,0,3900
SLIGZlCQ,3900,1/22/2020,8900,SLIGZlCQ,44000,more than downpayment,more than downpayment,0,3900
sLWwsd88,9900,6/28/2019,9900,,9900,equal to downpayment,,9900,0
sLWwsd88,4000,8/7/2019,9900,sLWwsd88,13900,more than downpayment,equal to downpayment,0,4000
sLWwsd88,4000,8/30/2019,9900,sLWwsd88,17900,more than downpayment,more than downpayment,0,4000
sLWwsd88,4000,9/30/2019,9900,sLWwsd88,21900,more than downpayment,more than downpayment,0,4000
sLWwsd88,4000,10/30/2019,9900,sLWwsd88,25900,more than downpayment,more than downpayment,0,4000
sLWwsd88,5000,12/4/2019,9900,sLWwsd88,30900,more than downpayment,more than downpayment,0,5000
sLWwsd88,3900,1/4/2020,9900,sLWwsd88,34800,more than downpayment,more than downpayment,0,3900
sLWwsd88,5000,2/4/2020,9900,sLWwsd88,39800,more than downpayment,more than downpayment,0,5000
SMeH94C7,8900,4/23/2019,8900,,8900,equal to downpayment,,8900,0
SMeH94C7,4000,6/9/2019,8900,SMeH94C7,12900,more than downpayment,equal to downpayment,0,4000
SMeH94C7,3900,7/26/2019,8900,SMeH94C7,16800,more than downpayment,more than downpayment,0,3900
SMeH94C7,3900,8/31/2019,8900,SMeH94C7,20700,more than downpayment,more than downpayment,0,3900
SMeH94C7,3900,10/3/2019,8900,SMeH94C7,24600,more than downpayment,more than downpayment,0,3900
SMeH94C7,3900,11/19/2019,8900,SMeH94C7,28500,more than downpayment,more than downpayment,0,3900
SMeH94C7,2450,11/30/2019,8900,SMeH94C7,30950,more than downpayment,more than downpayment,0,2450
SMeH94C7,1350,12/7/2019,8900,SMeH94C7,32300,more than downpayment,more than downpayment,0,1350
SMeH94C7,3900,1/11/2020,8900,SMeH94C7,36200,more than downpayment,more than downpayment,0,3900
SMm7o78d,10000,9/27/2017,10000,,10000,equal to downpayment,,10000,0
SMm7o78d,4000,10/31/2017,10000,SMm7o78d,14000,more than downpayment,equal to downpayment,0,4000
SMm7o78d,3500,12/6/2017,10000,SMm7o78d,17500,more than downpayment,more than downpayment,0,3500
SMm7o78d,3500,1/7/2018,10000,SMm7o78d,21000,more than downpayment,more than downpayment,0,3500
SMm7o78d,3500,3/8/2018,10000,SMm7o78d,24500,more than downpayment,more than downpayment,0,3500
SMm7o78d,3500,4/9/2018,10000,SMm7o78d,28000,more than downpayment,more than downpayment,0,3500
SMm7o78d,3500,5/9/2018,10000,SMm7o78d,31500,more than downpayment,more than downpayment,0,3500
SMm7o78d,3500,6/11/2018,10000,SMm7o78d,35000,more than downpayment,more than downpayment,0,3500
SMm7o78d,3500,7/10/2018,10000,SMm7o78d,38500,more than downpayment,more than downpayment,0,3500
SMm7o78d,3500,8/12/2018,10000,SMm7o78d,42000,more than downpayment,more than downpayment,0,3500
SMm7o78d,3500,8/20/2018,10000,SMm7o78d,45500,more than downpayment,more than downpayment,0,3500
SMm7o78d,3500,9/10/2018,10000,SMm7o78d,49000,more than downpayment,more than downpayment,0,3500
SMm7o78d,3000,10/5/2018,10000,SMm7o78d,52000,more than downpayment,more than downpayment,0,3000
SMm7o78d,3030,7/19/2019,10000,SMm7o78d,55030,more than downpayment,more than downpayment,0,3030
Sn0YvOlP,9900,7/5/2019,9900,,9900,equal to downpayment,,9900,0
Sn0YvOlP,1000,7/16/2019,9900,Sn0YvOlP,10900,more than downpayment,equal to downpayment,0,1000
Sn0YvOlP,500,7/29/2019,9900,Sn0YvOlP,11400,more than downpayment,more than downpayment,0,500
Sn0YvOlP,500,7/31/2019,9900,Sn0YvOlP,11900,more than downpayment,more than downpayment,0,500
Sn0YvOlP,2500,8/5/2019,9900,Sn0YvOlP,14400,more than downpayment,more than downpayment,0,2500
Sn0YvOlP,400,8/26/2019,9900,Sn0YvOlP,14800,more than downpayment,more than downpayment,0,400
Sn0YvOlP,2100,9/8/2019,9900,Sn0YvOlP,16900,more than downpayment,more than downpayment,0,2100
Sn0YvOlP,800,9/21/2019,9900,Sn0YvOlP,17700,more than downpayment,more than downpayment,0,800
Sn0YvOlP,3900,10/7/2019,9900,Sn0YvOlP,21600,more than downpayment,more than downpayment,0,3900
Sn0YvOlP,2100,11/13/2019,9900,Sn0YvOlP,23700,more than downpayment,more than downpayment,0,2100
Sn0YvOlP,900,11/19/2019,9900,Sn0YvOlP,24600,more than downpayment,more than downpayment,0,900
Sn0YvOlP,1000,12/4/2019,9900,Sn0YvOlP,25600,more than downpayment,more than downpayment,0,1000
Sn0YvOlP,300,12/9/2019,9900,Sn0YvOlP,25900,more than downpayment,more than downpayment,0,300
Sn0YvOlP,3000,12/14/2019,9900,Sn0YvOlP,28900,more than downpayment,more than downpayment,0,3000
Sn0YvOlP,3500,1/12/2020,9900,Sn0YvOlP,32400,more than downpayment,more than downpayment,0,3500
Sn0YvOlP,1500,1/29/2020,9900,Sn0YvOlP,33900,more than downpayment,more than downpayment,0,1500
Sn0YvOlP,200,1/30/2020,9900,Sn0YvOlP,34100,more than downpayment,more than downpayment,0,200
Sn0YvOlP,2100,2/9/2020,9900,Sn0YvOlP,36200,more than downpayment,more than downpayment,0,2100
SN85CVWX,9900,11/25/2019,9900,,9900,equal to downpayment,,9900,0
SnNEqhMs,10000,7/24/2017,10000,,10000,equal to downpayment,,10000,0
SnNEqhMs,6000,10/4/2017,10000,SnNEqhMs,16000,more than downpayment,equal to downpayment,0,6000
SnNEqhMs,3900,11/15/2017,10000,SnNEqhMs,19900,more than downpayment,more than downpayment,0,3900
SnNEqhMs,3000,12/15/2017,10000,SnNEqhMs,22900,more than downpayment,more than downpayment,0,3000
SnNEqhMs,3000,1/19/2018,10000,SnNEqhMs,25900,more than downpayment,more than downpayment,0,3000
SnNEqhMs,3000,2/16/2018,10000,SnNEqhMs,28900,more than downpayment,more than downpayment,0,3000
SnNEqhMs,3000,4/28/2018,10000,SnNEqhMs,31900,more than downpayment,more than downpayment,0,3000
SnNEqhMs,3000,5/24/2018,10000,SnNEqhMs,34900,more than downpayment,more than downpayment,0,3000
SnNEqhMs,3000,6/15/2018,10000,SnNEqhMs,37900,more than downpayment,more than downpayment,0,3000
SnNEqhMs,2000,7/16/2018,10000,SnNEqhMs,39900,more than downpayment,more than downpayment,0,2000
SnNEqhMs,2000,8/15/2018,10000,SnNEqhMs,41900,more than downpayment,more than downpayment,0,2000
SnNEqhMs,2900,1/18/2019,10000,SnNEqhMs,44800,more than downpayment,more than downpayment,0,2900
SnNEqhMs,200,4/3/2019,10000,SnNEqhMs,45000,more than downpayment,more than downpayment,0,200
SNQACQLJ,10000,12/15/2019,9900,,10000,more than downpayment,,9900,100
SNQACQLJ,3900,2/2/2020,9900,SNQACQLJ,13900,more than downpayment,more than downpayment,0,3900
sNvETDRC,10000,1/25/2019,9900,,10000,more than downpayment,,9900,100
sNvETDRC,4500,3/2/2019,9900,sNvETDRC,14500,more than downpayment,more than downpayment,0,4500
sNvETDRC,4500,3/28/2019,9900,sNvETDRC,19000,more than downpayment,more than downpayment,0,4500
sNvETDRC,4500,4/30/2019,9900,sNvETDRC,23500,more than downpayment,more than downpayment,0,4500
sNvETDRC,4500,6/15/2019,9900,sNvETDRC,28000,more than downpayment,more than downpayment,0,4500
sNvETDRC,4500,7/20/2019,9900,sNvETDRC,32500,more than downpayment,more than downpayment,0,4500
sNvETDRC,4500,8/27/2019,9900,sNvETDRC,37000,more than downpayment,more than downpayment,0,4500
sNvETDRC,4500,10/1/2019,9900,sNvETDRC,41500,more than downpayment,more than downpayment,0,4500
sNvETDRC,2000,10/30/2019,9900,sNvETDRC,43500,more than downpayment,more than downpayment,0,2000
sNvETDRC,6800,11/25/2019,9900,sNvETDRC,50300,more than downpayment,more than downpayment,0,6800
sNvETDRC,100,12/11/2019,9900,sNvETDRC,50400,more than downpayment,more than downpayment,0,100
sNvETDRC,2000,1/10/2020,9900,sNvETDRC,52400,more than downpayment,more than downpayment,0,2000
sNvETDRC,4500,1/28/2020,9900,sNvETDRC,56900,more than downpayment,more than downpayment,0,4500
sNvETDRC,2500,2/7/2020,9900,sNvETDRC,59400,more than downpayment,more than downpayment,0,2500
SnvYJgCI,9000,12/21/2018,8900,,9000,more than downpayment,,8900,100
SnvYJgCI,5000,2/12/2019,8900,SnvYJgCI,14000,more than downpayment,more than downpayment,0,5000
SnvYJgCI,4000,3/13/2019,8900,SnvYJgCI,18000,more than downpayment,more than downpayment,0,4000
SnvYJgCI,4000,4/12/2019,8900,SnvYJgCI,22000,more than downpayment,more than downpayment,0,4000
SnvYJgCI,3900,5/14/2019,8900,SnvYJgCI,25900,more than downpayment,more than downpayment,0,3900
SnvYJgCI,4000,6/12/2019,8900,SnvYJgCI,29900,more than downpayment,more than downpayment,0,4000
SnvYJgCI,5000,7/10/2019,8900,SnvYJgCI,34900,more than downpayment,more than downpayment,0,5000
SnvYJgCI,4500,8/19/2019,8900,SnvYJgCI,39400,more than downpayment,more than downpayment,0,4500
SnvYJgCI,4000,9/15/2019,8900,SnvYJgCI,43400,more than downpayment,more than downpayment,0,4000
SnvYJgCI,4000,10/12/2019,8900,SnvYJgCI,47400,more than downpayment,more than downpayment,0,4000
SnvYJgCI,4000,11/22/2019,8900,SnvYJgCI,51400,more than downpayment,more than downpayment,0,4000
SnvYJgCI,4000,12/16/2019,8900,SnvYJgCI,55400,more than downpayment,more than downpayment,0,4000
SnvYJgCI,1300,1/23/2020,8900,SnvYJgCI,56700,more than downpayment,more than downpayment,0,1300
SnvYJgCI,2700,1/31/2020,8900,SnvYJgCI,59400,more than downpayment,more than downpayment,0,2700
SowL5rr4,10000,11/23/2018,8900,,10000,more than downpayment,,8900,1100
SowL5rr4,12000,11/26/2018,8900,SowL5rr4,22000,more than downpayment,more than downpayment,0,12000
SowL5rr4,2000,1/24/2019,8900,SowL5rr4,24000,more than downpayment,more than downpayment,0,2000
sP2muY6Z,8900,5/24/2019,8900,,8900,equal to downpayment,,8900,0
sP2muY6Z,3900,7/22/2019,8900,sP2muY6Z,12800,more than downpayment,equal to downpayment,0,3900
sP2muY6Z,3900,8/26/2019,8900,sP2muY6Z,16700,more than downpayment,more than downpayment,0,3900
sP2muY6Z,3900,9/27/2019,8900,sP2muY6Z,20600,more than downpayment,more than downpayment,0,3900
sP2muY6Z,3900,11/16/2019,8900,sP2muY6Z,24500,more than downpayment,more than downpayment,0,3900
sP2muY6Z,3900,11/26/2019,8900,sP2muY6Z,28400,more than downpayment,more than downpayment,0,3900
sP2muY6Z,3900,1/15/2020,8900,sP2muY6Z,32300,more than downpayment,more than downpayment,0,3900
sP2muY6Z,3900,1/29/2020,8900,sP2muY6Z,36200,more than downpayment,more than downpayment,0,3900
SP6AX1M8,9900,1/16/2020,9900,,9900,equal to downpayment,,9900,0
spCen0pN,8900,1/25/2019,8900,,8900,equal to downpayment,,8900,0
spCen0pN,3900,2/23/2019,8900,spCen0pN,12800,more than downpayment,equal to downpayment,0,3900
spCen0pN,3900,3/28/2019,8900,spCen0pN,16700,more than downpayment,more than downpayment,0,3900
spCen0pN,3900,4/26/2019,8900,spCen0pN,20600,more than downpayment,more than downpayment,0,3900
spCen0pN,7800,6/27/2019,8900,spCen0pN,28400,more than downpayment,more than downpayment,0,7800
spCen0pN,3900,8/1/2019,8900,spCen0pN,32300,more than downpayment,more than downpayment,0,3900
spCen0pN,7800,10/15/2019,8900,spCen0pN,40100,more than downpayment,more than downpayment,0,7800
spCen0pN,3900,10/31/2019,8900,spCen0pN,44000,more than downpayment,more than downpayment,0,3900
spCen0pN,3900,12/31/2019,8900,spCen0pN,47900,more than downpayment,more than downpayment,0,3900
spCen0pN,3900,1/17/2020,8900,spCen0pN,51800,more than downpayment,more than downpayment,0,3900
spCen0pN,3900,2/5/2020,8900,spCen0pN,55700,more than downpayment,more than downpayment,0,3900
sPMPJGys,9900,7/8/2019,9900,,9900,equal to downpayment,,9900,0
sPMPJGys,4000,8/14/2019,9900,sPMPJGys,13900,more than downpayment,equal to downpayment,0,4000
sPMPJGys,4000,9/16/2019,9900,sPMPJGys,17900,more than downpayment,more than downpayment,0,4000
sPMPJGys,4000,10/9/2019,9900,sPMPJGys,21900,more than downpayment,more than downpayment,0,4000
sPMPJGys,4000,11/6/2019,9900,sPMPJGys,25900,more than downpayment,more than downpayment,0,4000
sPMPJGys,4000,12/9/2019,9900,sPMPJGys,29900,more than downpayment,more than downpayment,0,4000
sPMPJGys,4000,1/13/2020,9900,sPMPJGys,33900,more than downpayment,more than downpayment,0,4000
sPMPJGys,4000,2/5/2020,9900,sPMPJGys,37900,more than downpayment,more than downpayment,0,4000
SpRsXA1i,10000,2/13/2019,0,,10000,more than downpayment,,0,10000
SpRsXA1i,5000,3/11/2019,0,SpRsXA1i,15000,more than downpayment,more than downpayment,0,5000
SpRsXA1i,5000,4/6/2019,0,SpRsXA1i,20000,more than downpayment,more than downpayment,0,5000
SpRsXA1i,5000,5/15/2019,0,SpRsXA1i,25000,more than downpayment,more than downpayment,0,5000
SpRsXA1i,5000,6/8/2019,0,SpRsXA1i,30000,more than downpayment,more than downpayment,0,5000
SpRsXA1i,5000,7/9/2019,0,SpRsXA1i,35000,more than downpayment,more than downpayment,0,5000
SpRsXA1i,5000,8/13/2019,0,SpRsXA1i,40000,more than downpayment,more than downpayment,0,5000
SpRsXA1i,5000,9/12/2019,0,SpRsXA1i,45000,more than downpayment,more than downpayment,0,5000
SpRsXA1i,5000,10/22/2019,0,SpRsXA1i,50000,more than downpayment,more than downpayment,0,5000
SpRsXA1i,5000,11/21/2019,0,SpRsXA1i,55000,more than downpayment,more than downpayment,0,5000
SpRsXA1i,5000,1/18/2020,0,SpRsXA1i,60000,more than downpayment,more than downpayment,0,5000
sQICtliT,8900,8/29/2019,8900,,8900,equal to downpayment,,8900,0
sQICtliT,55300,10/25/2019,8900,sQICtliT,64200,more than downpayment,equal to downpayment,0,55300
sQICtliT,3900,12/2/2019,8900,sQICtliT,68100,more than downpayment,more than downpayment,0,3900
sQICtliT,3900,12/24/2019,8900,sQICtliT,72000,more than downpayment,more than downpayment,0,3900
sQICtliT,3900,1/25/2020,8900,sQICtliT,75900,more than downpayment,more than downpayment,0,3900
SqJJaQdA,9900,12/24/2018,9900,,9900,equal to downpayment,,9900,0
SqJJaQdA,4500,1/27/2019,9900,SqJJaQdA,14400,more than downpayment,equal to downpayment,0,4500
SqJJaQdA,4500,2/25/2019,9900,SqJJaQdA,18900,more than downpayment,more than downpayment,0,4500
SqJJaQdA,4500,3/28/2019,9900,SqJJaQdA,23400,more than downpayment,more than downpayment,0,4500
SqJJaQdA,4500,4/26/2019,9900,SqJJaQdA,27900,more than downpayment,more than downpayment,0,4500
SqJJaQdA,4500,5/28/2019,9900,SqJJaQdA,32400,more than downpayment,more than downpayment,0,4500
SqJJaQdA,4500,6/28/2019,9900,SqJJaQdA,36900,more than downpayment,more than downpayment,0,4500
SqJJaQdA,4500,8/3/2019,9900,SqJJaQdA,41400,more than downpayment,more than downpayment,0,4500
SqJJaQdA,4500,8/28/2019,9900,SqJJaQdA,45900,more than downpayment,more than downpayment,0,4500
SqJJaQdA,4500,9/28/2019,9900,SqJJaQdA,50400,more than downpayment,more than downpayment,0,4500
SqJJaQdA,4500,10/29/2019,9900,SqJJaQdA,54900,more than downpayment,more than downpayment,0,4500
SqJJaQdA,4500,11/25/2019,9900,SqJJaQdA,59400,more than downpayment,more than downpayment,0,4500
SqJJaQdA,4500,12/22/2019,9900,SqJJaQdA,63900,more than downpayment,more than downpayment,0,4500
SqJJaQdA,4500,2/1/2020,9900,SqJJaQdA,68400,more than downpayment,more than downpayment,0,4500
sqk1X293,9900,8/16/2019,9900,,9900,equal to downpayment,,9900,0
sqk1X293,3900,9/19/2019,9900,sqk1X293,13800,more than downpayment,equal to downpayment,0,3900
sqk1X293,3900,10/17/2019,9900,sqk1X293,17700,more than downpayment,more than downpayment,0,3900
sqk1X293,3900,11/21/2019,9900,sqk1X293,21600,more than downpayment,more than downpayment,0,3900
sqk1X293,3900,12/19/2019,9900,sqk1X293,25500,more than downpayment,more than downpayment,0,3900
sqk1X293,3900,1/21/2020,9900,sqk1X293,29400,more than downpayment,more than downpayment,0,3900
SQYEMJQW,1599,10/16/2019,9900,,1599,less than downpayment,,1599,0
SQYEMJQW,3400,12/17/2019,9900,SQYEMJQW,4999,less than downpayment,less than downpayment,3400,0
SQYEMJQW,5000,1/16/2020,9900,SQYEMJQW,9999,more than downpayment,less than downpayment,4901,99
SR4PEGH7,9900,12/13/2019,9900,,9900,equal to downpayment,,9900,0
sRtDvxKH,10000,11/7/2018,10000,,10000,equal to downpayment,,10000,0
sRtDvxKH,4500,12/8/2018,10000,sRtDvxKH,14500,more than downpayment,equal to downpayment,0,4500
sRtDvxKH,4500,1/10/2019,10000,sRtDvxKH,19000,more than downpayment,more than downpayment,0,4500
sRtDvxKH,4500,2/12/2019,10000,sRtDvxKH,23500,more than downpayment,more than downpayment,0,4500
sRtDvxKH,4500,3/8/2019,10000,sRtDvxKH,28000,more than downpayment,more than downpayment,0,4500
sRtDvxKH,8900,4/8/2019,10000,sRtDvxKH,36900,more than downpayment,more than downpayment,0,8900
sRtDvxKH,4500,5/6/2019,10000,sRtDvxKH,41400,more than downpayment,more than downpayment,0,4500
sRtDvxKH,4500,6/15/2019,10000,sRtDvxKH,45900,more than downpayment,more than downpayment,0,4500
sRtDvxKH,4500,7/13/2019,10000,sRtDvxKH,50400,more than downpayment,more than downpayment,0,4500
sRtDvxKH,4500,8/12/2019,10000,sRtDvxKH,54900,more than downpayment,more than downpayment,0,4500
sRtDvxKH,4500,9/20/2019,10000,sRtDvxKH,59400,more than downpayment,more than downpayment,0,4500
sRtDvxKH,4500,11/15/2019,10000,sRtDvxKH,63900,more than downpayment,more than downpayment,0,4500
sRtDvxKH,100,12/4/2019,10000,sRtDvxKH,64000,more than downpayment,more than downpayment,0,100
SRxulAjP,8900,4/17/2019,8900,,8900,equal to downpayment,,8900,0
SRxulAjP,4000,5/20/2019,8900,SRxulAjP,12900,more than downpayment,equal to downpayment,0,4000
SRxulAjP,3900,6/24/2019,8900,SRxulAjP,16800,more than downpayment,more than downpayment,0,3900
SRxulAjP,4000,7/25/2019,8900,SRxulAjP,20800,more than downpayment,more than downpayment,0,4000
SRxulAjP,3900,8/24/2019,8900,SRxulAjP,24700,more than downpayment,more than downpayment,0,3900
SRxulAjP,3900,9/24/2019,8900,SRxulAjP,28600,more than downpayment,more than downpayment,0,3900
SRxulAjP,3900,10/29/2019,8900,SRxulAjP,32500,more than downpayment,more than downpayment,0,3900
SRxulAjP,3900,11/26/2019,8900,SRxulAjP,36400,more than downpayment,more than downpayment,0,3900
SRxulAjP,3700,1/6/2020,8900,SRxulAjP,40100,more than downpayment,more than downpayment,0,3700
SRxulAjP,3900,1/30/2020,8900,SRxulAjP,44000,more than downpayment,more than downpayment,0,3900
SSBf7qbO,13000,4/15/2019,8900,,13000,more than downpayment,,8900,4100
SSI31ZLG,1594,10/14/2019,1594,,1594,equal to downpayment,,1594,0
SSI31ZLG,3100,12/3/2019,1594,SSI31ZLG,4694,more than downpayment,equal to downpayment,0,3100
SSI31ZLG,6200,12/29/2019,1594,SSI31ZLG,10894,more than downpayment,more than downpayment,0,6200
SSI31ZLG,3100,1/28/2020,1594,SSI31ZLG,13994,more than downpayment,more than downpayment,0,3100
SSTE6N5B,9900,11/16/2019,9900,,9900,equal to downpayment,,9900,0
SSTE6N5B,7800,2/5/2020,9900,SSTE6N5B,17700,more than downpayment,equal to downpayment,0,7800
ST5jkOIb,9900,6/21/2019,9900,,9900,equal to downpayment,,9900,0
ST5jkOIb,3900,8/3/2019,9900,ST5jkOIb,13800,more than downpayment,equal to downpayment,0,3900
ST5jkOIb,3900,9/4/2019,9900,ST5jkOIb,17700,more than downpayment,more than downpayment,0,3900
ST5jkOIb,3900,10/4/2019,9900,ST5jkOIb,21600,more than downpayment,more than downpayment,0,3900
ST5jkOIb,3900,11/6/2019,9900,ST5jkOIb,25500,more than downpayment,more than downpayment,0,3900
ST5jkOIb,3900,12/4/2019,9900,ST5jkOIb,29400,more than downpayment,more than downpayment,0,3900
ST5jkOIb,3999,1/5/2020,9900,ST5jkOIb,33399,more than downpayment,more than downpayment,0,3999
ST5jkOIb,3900,2/4/2020,9900,ST5jkOIb,37299,more than downpayment,more than downpayment,0,3900
StqCdz9B,8900,2/11/2019,8900,,8900,equal to downpayment,,8900,0
StqCdz9B,3900,3/9/2019,8900,StqCdz9B,12800,more than downpayment,equal to downpayment,0,3900
StqCdz9B,4000,4/5/2019,8900,StqCdz9B,16800,more than downpayment,more than downpayment,0,4000
StqCdz9B,3900,5/6/2019,8900,StqCdz9B,20700,more than downpayment,more than downpayment,0,3900
StqCdz9B,3900,6/11/2019,8900,StqCdz9B,24600,more than downpayment,more than downpayment,0,3900
StqCdz9B,3900,7/16/2019,8900,StqCdz9B,28500,more than downpayment,more than downpayment,0,3900
StqCdz9B,3900,8/16/2019,8900,StqCdz9B,32400,more than downpayment,more than downpayment,0,3900
StqCdz9B,3900,9/17/2019,8900,StqCdz9B,36300,more than downpayment,more than downpayment,0,3900
StqCdz9B,3900,10/15/2019,8900,StqCdz9B,40200,more than downpayment,more than downpayment,0,3900
StqCdz9B,3900,11/20/2019,8900,StqCdz9B,44100,more than downpayment,more than downpayment,0,3900
StqCdz9B,3900,12/27/2019,8900,StqCdz9B,48000,more than downpayment,more than downpayment,0,3900
StqCdz9B,3900,1/16/2020,8900,StqCdz9B,51900,more than downpayment,more than downpayment,0,3900
StqCdz9B,3900,2/2/2020,8900,StqCdz9B,55800,more than downpayment,more than downpayment,0,3900
STYOHJDF,9900,1/3/2020,9900,,9900,equal to downpayment,,9900,0
sufcBBYa,8900,6/17/2019,8900,,8900,equal to downpayment,,8900,0
sufcBBYa,3900,7/9/2019,8900,sufcBBYa,12800,more than downpayment,equal to downpayment,0,3900
sufcBBYa,3900,8/8/2019,8900,sufcBBYa,16700,more than downpayment,more than downpayment,0,3900
sufcBBYa,3900,9/25/2019,8900,sufcBBYa,20600,more than downpayment,more than downpayment,0,3900
sufcBBYa,3900,10/28/2019,8900,sufcBBYa,24500,more than downpayment,more than downpayment,0,3900
sufcBBYa,3900,11/30/2019,8900,sufcBBYa,28400,more than downpayment,more than downpayment,0,3900
sufcBBYa,3900,12/23/2019,8900,sufcBBYa,32300,more than downpayment,more than downpayment,0,3900
sufcBBYa,3900,1/29/2020,8900,sufcBBYa,36200,more than downpayment,more than downpayment,0,3900
SUprfQNt,9900,6/7/2019,8900,,9900,more than downpayment,,8900,1000
SUprfQNt,3900,7/19/2019,8900,SUprfQNt,13800,more than downpayment,more than downpayment,0,3900
SUprfQNt,3900,8/26/2019,8900,SUprfQNt,17700,more than downpayment,more than downpayment,0,3900
SUprfQNt,3900,10/1/2019,8900,SUprfQNt,21600,more than downpayment,more than downpayment,0,3900
SUprfQNt,3900,11/5/2019,8900,SUprfQNt,25500,more than downpayment,more than downpayment,0,3900
SUprfQNt,4000,12/5/2019,8900,SUprfQNt,29500,more than downpayment,more than downpayment,0,4000
SUprfQNt,3900,12/26/2019,8900,SUprfQNt,33400,more than downpayment,more than downpayment,0,3900
SVFVTSQP,9900,11/18/2019,9900,,9900,equal to downpayment,,9900,0
sVml8sfo,10000,12/15/2017,10000,,10000,equal to downpayment,,10000,0
sVml8sfo,16000,12/19/2017,10000,sVml8sfo,26000,more than downpayment,equal to downpayment,0,16000
sVml8sfo,2000,2/18/2018,10000,sVml8sfo,28000,more than downpayment,more than downpayment,0,2000
sVml8sfo,1500,3/10/2018,10000,sVml8sfo,29500,more than downpayment,more than downpayment,0,1500
sVml8sfo,1500,3/26/2018,10000,sVml8sfo,31000,more than downpayment,more than downpayment,0,1500
sVml8sfo,5000,4/16/2018,10000,sVml8sfo,36000,more than downpayment,more than downpayment,0,5000
sVml8sfo,1900,5/27/2018,10000,sVml8sfo,37900,more than downpayment,more than downpayment,0,1900
sVml8sfo,1200,6/25/2018,10000,sVml8sfo,39100,more than downpayment,more than downpayment,0,1200
sVml8sfo,1000,7/16/2018,10000,sVml8sfo,40100,more than downpayment,more than downpayment,0,1000
sVml8sfo,1000,7/17/2018,10000,sVml8sfo,41100,more than downpayment,more than downpayment,0,1000
sVml8sfo,1000,7/25/2018,10000,sVml8sfo,42100,more than downpayment,more than downpayment,0,1000
sVml8sfo,3000,8/6/2018,10000,sVml8sfo,45100,more than downpayment,more than downpayment,0,3000
sVml8sfo,500,8/27/2018,10000,sVml8sfo,45600,more than downpayment,more than downpayment,0,500
sVml8sfo,500,8/28/2018,10000,sVml8sfo,46100,more than downpayment,more than downpayment,0,500
sVml8sfo,17900,10/1/2018,10000,sVml8sfo,64000,more than downpayment,more than downpayment,0,17900
swI61M5D,5000,4/28/2017,5000,,5000,equal to downpayment,,5000,0
swI61M5D,1000,6/9/2017,5000,swI61M5D,6000,more than downpayment,equal to downpayment,0,1000
swI61M5D,2000,2/19/2018,5000,swI61M5D,8000,more than downpayment,more than downpayment,0,2000
swI61M5D,2000,3/2/2018,5000,swI61M5D,10000,more than downpayment,more than downpayment,0,2000
swI61M5D,2000,3/26/2018,5000,swI61M5D,12000,more than downpayment,more than downpayment,0,2000
swI61M5D,2000,4/20/2018,5000,swI61M5D,14000,more than downpayment,more than downpayment,0,2000
swI61M5D,2000,5/15/2018,5000,swI61M5D,16000,more than downpayment,more than downpayment,0,2000
swI61M5D,2000,6/13/2018,5000,swI61M5D,18000,more than downpayment,more than downpayment,0,2000
swI61M5D,2000,7/11/2018,5000,swI61M5D,20000,more than downpayment,more than downpayment,0,2000
swI61M5D,2000,8/20/2018,5000,swI61M5D,22000,more than downpayment,more than downpayment,0,2000
swI61M5D,2000,9/18/2018,5000,swI61M5D,24000,more than downpayment,more than downpayment,0,2000
swI61M5D,2000,10/18/2018,5000,swI61M5D,26000,more than downpayment,more than downpayment,0,2000
swI61M5D,2000,1/15/2019,5000,swI61M5D,28000,more than downpayment,more than downpayment,0,2000
swI61M5D,2000,2/15/2019,5000,swI61M5D,30000,more than downpayment,more than downpayment,0,2000
swI61M5D,2000,3/21/2019,5000,swI61M5D,32000,more than downpayment,more than downpayment,0,2000
swI61M5D,1000,4/18/2019,5000,swI61M5D,33000,more than downpayment,more than downpayment,0,1000
SWONKsmR,8900,8/31/2019,9900,,8900,less than downpayment,,8900,0
SWONKsmR,3900,11/6/2019,9900,SWONKsmR,12800,more than downpayment,less than downpayment,1000,2900
SWONKsmR,5000,12/2/2019,9900,SWONKsmR,17800,more than downpayment,more than downpayment,0,5000
SWONKsmR,3900,1/2/2020,9900,SWONKsmR,21700,more than downpayment,more than downpayment,0,3900
SWONKsmR,3900,2/2/2020,9900,SWONKsmR,25600,more than downpayment,more than downpayment,0,3900
SWQWPALT,7400,7/31/2019,9900,,7400,less than downpayment,,7400,0
SWQWPALT,1000,9/30/2019,9900,SWQWPALT,8400,less than downpayment,less than downpayment,1000,0
SWQWPALT,3000,10/14/2019,9900,SWQWPALT,11400,more than downpayment,less than downpayment,1500,1500
SWQWPALT,5000,10/17/2019,9900,SWQWPALT,16400,more than downpayment,more than downpayment,0,5000
SWQWPALT,2000,12/26/2019,9900,SWQWPALT,18400,more than downpayment,more than downpayment,0,2000
SWQWPALT,3900,1/9/2020,9900,SWQWPALT,22300,more than downpayment,more than downpayment,0,3900
SY694766,9900,1/7/2020,9900,,9900,equal to downpayment,,9900,0
SzcM70GQ,8900,3/15/2019,8900,,8900,equal to downpayment,,8900,0
SzcM70GQ,3900,4/22/2019,8900,SzcM70GQ,12800,more than downpayment,equal to downpayment,0,3900
SzcM70GQ,3900,5/25/2019,8900,SzcM70GQ,16700,more than downpayment,more than downpayment,0,3900
SzcM70GQ,3900,6/25/2019,8900,SzcM70GQ,20600,more than downpayment,more than downpayment,0,3900
SzcM70GQ,3900,7/23/2019,8900,SzcM70GQ,24500,more than downpayment,more than downpayment,0,3900
SzcM70GQ,3900,8/22/2019,8900,SzcM70GQ,28400,more than downpayment,more than downpayment,0,3900
SzcM70GQ,3900,9/23/2019,8900,SzcM70GQ,32300,more than downpayment,more than downpayment,0,3900
SzcM70GQ,3900,10/25/2019,8900,SzcM70GQ,36200,more than downpayment,more than downpayment,0,3900
SzcM70GQ,3900,11/21/2019,8900,SzcM70GQ,40100,more than downpayment,more than downpayment,0,3900
SzcM70GQ,3900,12/20/2019,8900,SzcM70GQ,44000,more than downpayment,more than downpayment,0,3900
SzcM70GQ,3900,1/24/2020,8900,SzcM70GQ,47900,more than downpayment,more than downpayment,0,3900
sZp77v7B,13000,1/17/2019,8900,,13000,more than downpayment,,8900,4100
sZp77v7B,5000,2/1/2019,8900,sZp77v7B,18000,more than downpayment,more than downpayment,0,5000
sZp77v7B,5000,3/25/2019,8900,sZp77v7B,23000,more than downpayment,more than downpayment,0,5000
sZp77v7B,4000,5/19/2019,8900,sZp77v7B,27000,more than downpayment,more than downpayment,0,4000
sZp77v7B,3900,6/20/2019,8900,sZp77v7B,30900,more than downpayment,more than downpayment,0,3900
sZp77v7B,3000,7/25/2019,8900,sZp77v7B,33900,more than downpayment,more than downpayment,0,3000
sZp77v7B,4800,8/17/2019,8900,sZp77v7B,38700,more than downpayment,more than downpayment,0,4800
sZp77v7B,3900,9/24/2019,8900,sZp77v7B,42600,more than downpayment,more than downpayment,0,3900
sZp77v7B,3900,10/20/2019,8900,sZp77v7B,46500,more than downpayment,more than downpayment,0,3900
sZp77v7B,3900,11/23/2019,8900,sZp77v7B,50400,more than downpayment,more than downpayment,0,3900
sZp77v7B,3900,12/25/2019,8900,sZp77v7B,54300,more than downpayment,more than downpayment,0,3900
sZp77v7B,3900,1/22/2020,8900,sZp77v7B,58200,more than downpayment,more than downpayment,0,3900
T0Ay2IPd,9900,6/28/2019,8900,,9900,more than downpayment,,8900,1000
T0Ay2IPd,3900,8/25/2019,8900,T0Ay2IPd,13800,more than downpayment,more than downpayment,0,3900
T0Ay2IPd,3900,9/25/2019,8900,T0Ay2IPd,17700,more than downpayment,more than downpayment,0,3900
T0Ay2IPd,3900,10/28/2019,8900,T0Ay2IPd,21600,more than downpayment,more than downpayment,0,3900
T0Ay2IPd,3900,11/25/2019,8900,T0Ay2IPd,25500,more than downpayment,more than downpayment,0,3900
T0Ay2IPd,2900,12/25/2019,8900,T0Ay2IPd,28400,more than downpayment,more than downpayment,0,2900
T0Ay2IPd,3900,1/27/2020,8900,T0Ay2IPd,32300,more than downpayment,more than downpayment,0,3900
T1YKJA3N,1600,10/14/2019,1594,,1600,more than downpayment,,1594,6
T1YKJA3N,3100,10/29/2019,1594,T1YKJA3N,4700,more than downpayment,more than downpayment,0,3100
T1YKJA3N,3100,12/3/2019,1594,T1YKJA3N,7800,more than downpayment,more than downpayment,0,3100
T1YKJA3N,3100,1/2/2020,1594,T1YKJA3N,10900,more than downpayment,more than downpayment,0,3100
T2GCXIA8,8900,8/9/2019,8900,,8900,equal to downpayment,,8900,0
T2GCXIA8,3900,10/15/2019,8900,T2GCXIA8,12800,more than downpayment,equal to downpayment,0,3900
T2GCXIA8,3900,11/26/2019,8900,T2GCXIA8,16700,more than downpayment,more than downpayment,0,3900
T2GCXIA8,3900,12/20/2019,8900,T2GCXIA8,20600,more than downpayment,more than downpayment,0,3900
T2GCXIA8,3900,1/25/2020,8900,T2GCXIA8,24500,more than downpayment,more than downpayment,0,3900
T2I34HH5,9900,12/19/2019,9900,,9900,equal to downpayment,,9900,0
T2I34HH5,4000,2/4/2020,9900,T2I34HH5,13900,more than downpayment,equal to downpayment,0,4000
t35rngrG,9900,11/7/2018,9900,,9900,equal to downpayment,,9900,0
t35rngrG,7000,2/25/2019,9900,t35rngrG,16900,more than downpayment,equal to downpayment,0,7000
t35rngrG,4500,5/9/2019,9900,t35rngrG,21400,more than downpayment,more than downpayment,0,4500
t35rngrG,4500,7/5/2019,9900,t35rngrG,25900,more than downpayment,more than downpayment,0,4500
t35rngrG,4500,7/23/2019,9900,t35rngrG,30400,more than downpayment,more than downpayment,0,4500
t35rngrG,10000,9/13/2019,9900,t35rngrG,40400,more than downpayment,more than downpayment,0,10000
t35rngrG,5000,11/8/2019,9900,t35rngrG,45400,more than downpayment,more than downpayment,0,5000
t35rngrG,5000,12/6/2019,9900,t35rngrG,50400,more than downpayment,more than downpayment,0,5000
t35rngrG,10000,12/10/2019,9900,t35rngrG,60400,more than downpayment,more than downpayment,0,10000
t35rngrG,3500,1/2/2020,9900,t35rngrG,63900,more than downpayment,more than downpayment,0,3500
T3O8m6Yc,9900,6/6/2019,8900,,9900,more than downpayment,,8900,1000
T3O8m6Yc,3900,7/23/2019,8900,T3O8m6Yc,13800,more than downpayment,more than downpayment,0,3900
T3O8m6Yc,3900,8/25/2019,8900,T3O8m6Yc,17700,more than downpayment,more than downpayment,0,3900
T3O8m6Yc,3900,9/24/2019,8900,T3O8m6Yc,21600,more than downpayment,more than downpayment,0,3900
T3O8m6Yc,3900,10/26/2019,8900,T3O8m6Yc,25500,more than downpayment,more than downpayment,0,3900
T3O8m6Yc,3900,11/26/2019,8900,T3O8m6Yc,29400,more than downpayment,more than downpayment,0,3900
T3O8m6Yc,3900,12/24/2019,8900,T3O8m6Yc,33300,more than downpayment,more than downpayment,0,3900
T3O8m6Yc,3900,1/30/2020,8900,T3O8m6Yc,37200,more than downpayment,more than downpayment,0,3900
T3PPt3PZ,9900,8/5/2019,8900,,9900,more than downpayment,,8900,1000
T3PPt3PZ,2900,9/2/2019,8900,T3PPt3PZ,12800,more than downpayment,more than downpayment,0,2900
T3PPt3PZ,3900,10/13/2019,8900,T3PPt3PZ,16700,more than downpayment,more than downpayment,0,3900
T3PPt3PZ,3900,11/2/2019,8900,T3PPt3PZ,20600,more than downpayment,more than downpayment,0,3900
T3PPt3PZ,3900,12/7/2019,8900,T3PPt3PZ,24500,more than downpayment,more than downpayment,0,3900
T3PPt3PZ,3900,1/13/2020,8900,T3PPt3PZ,28400,more than downpayment,more than downpayment,0,3900
T41VBOX5,9900,10/8/2019,9900,,9900,equal to downpayment,,9900,0
T41VBOX5,3900,12/2/2019,9900,T41VBOX5,13800,more than downpayment,equal to downpayment,0,3900
T41VBOX5,3900,1/6/2020,9900,T41VBOX5,17700,more than downpayment,more than downpayment,0,3900
T41VBOX5,3900,2/8/2020,9900,T41VBOX5,21600,more than downpayment,more than downpayment,0,3900
T4E9C71Z,8900,10/24/2019,8900,,8900,equal to downpayment,,8900,0
T4E9C71Z,3900,1/5/2020,8900,T4E9C71Z,12800,more than downpayment,equal to downpayment,0,3900
T4E9C71Z,3900,1/25/2020,8900,T4E9C71Z,16700,more than downpayment,more than downpayment,0,3900
T4L1645H,10000,2/5/2020,9900,,10000,more than downpayment,,9900,100
T5367V1J,8900,9/19/2019,8900,,8900,equal to downpayment,,8900,0
T5367V1J,3900,11/14/2019,8900,T5367V1J,12800,more than downpayment,equal to downpayment,0,3900
T5367V1J,3900,12/15/2019,8900,T5367V1J,16700,more than downpayment,more than downpayment,0,3900
T5367V1J,3900,1/13/2020,8900,T5367V1J,20600,more than downpayment,more than downpayment,0,3900
t5KrJ7lN,10500,7/21/2017,10000,,10500,more than downpayment,,10000,500
t5KrJ7lN,2500,7/30/2017,10000,t5KrJ7lN,13000,more than downpayment,more than downpayment,0,2500
t5KrJ7lN,3450,9/26/2017,10000,t5KrJ7lN,16450,more than downpayment,more than downpayment,0,3450
t5KrJ7lN,3500,11/25/2017,10000,t5KrJ7lN,19950,more than downpayment,more than downpayment,0,3500
t5KrJ7lN,3500,1/9/2018,10000,t5KrJ7lN,23450,more than downpayment,more than downpayment,0,3500
t5KrJ7lN,3450,1/29/2018,10000,t5KrJ7lN,26900,more than downpayment,more than downpayment,0,3450
t5KrJ7lN,3500,3/10/2018,10000,t5KrJ7lN,30400,more than downpayment,more than downpayment,0,3500
t5KrJ7lN,1500,3/21/2019,10000,t5KrJ7lN,31900,more than downpayment,more than downpayment,0,1500
T5OJBXQ4,9900,10/12/2019,9900,,9900,equal to downpayment,,9900,0
T5OJBXQ4,3900,12/14/2019,9900,T5OJBXQ4,13800,more than downpayment,equal to downpayment,0,3900
T5OJBXQ4,3900,1/12/2020,9900,T5OJBXQ4,17700,more than downpayment,more than downpayment,0,3900
T5OJBXQ4,3900,2/5/2020,9900,T5OJBXQ4,21600,more than downpayment,more than downpayment,0,3900
t5p8QQmx,8900,3/29/2019,8900,,8900,equal to downpayment,,8900,0
t5p8QQmx,3900,5/4/2019,8900,t5p8QQmx,12800,more than downpayment,equal to downpayment,0,3900
t5p8QQmx,3900,6/3/2019,8900,t5p8QQmx,16700,more than downpayment,more than downpayment,0,3900
t5p8QQmx,3900,7/3/2019,8900,t5p8QQmx,20600,more than downpayment,more than downpayment,0,3900
t5p8QQmx,3900,8/2/2019,8900,t5p8QQmx,24500,more than downpayment,more than downpayment,0,3900
t5p8QQmx,3900,9/2/2019,8900,t5p8QQmx,28400,more than downpayment,more than downpayment,0,3900
t5p8QQmx,3900,10/2/2019,8900,t5p8QQmx,32300,more than downpayment,more than downpayment,0,3900
t5p8QQmx,3900,11/4/2019,8900,t5p8QQmx,36200,more than downpayment,more than downpayment,0,3900
t5p8QQmx,3900,12/2/2019,8900,t5p8QQmx,40100,more than downpayment,more than downpayment,0,3900
t5p8QQmx,3900,1/2/2020,8900,t5p8QQmx,44000,more than downpayment,more than downpayment,0,3900
t5p8QQmx,3900,2/5/2020,8900,t5p8QQmx,47900,more than downpayment,more than downpayment,0,3900
T5QIKQYY,8900,1/2/2020,8900,,8900,equal to downpayment,,8900,0
T5UCePsx,10000,8/11/2017,10000,,10000,equal to downpayment,,10000,0
T5UCePsx,3500,10/2/2017,10000,T5UCePsx,13500,more than downpayment,equal to downpayment,0,3500
T5UCePsx,3500,10/31/2017,10000,T5UCePsx,17000,more than downpayment,more than downpayment,0,3500
T5UCePsx,3500,12/1/2017,10000,T5UCePsx,20500,more than downpayment,more than downpayment,0,3500
T5UCePsx,3500,12/30/2017,10000,T5UCePsx,24000,more than downpayment,more than downpayment,0,3500
T5UCePsx,3500,1/30/2018,10000,T5UCePsx,27500,more than downpayment,more than downpayment,0,3500
T5UCePsx,3500,2/28/2018,10000,T5UCePsx,31000,more than downpayment,more than downpayment,0,3500
T5UCePsx,3500,3/31/2018,10000,T5UCePsx,34500,more than downpayment,more than downpayment,0,3500
T5UCePsx,3500,4/30/2018,10000,T5UCePsx,38000,more than downpayment,more than downpayment,0,3500
T5UCePsx,3500,6/1/2018,10000,T5UCePsx,41500,more than downpayment,more than downpayment,0,3500
T5UCePsx,3500,6/30/2018,10000,T5UCePsx,45000,more than downpayment,more than downpayment,0,3500
T5UCePsx,3500,7/30/2018,10000,T5UCePsx,48500,more than downpayment,more than downpayment,0,3500
T5UCePsx,3500,8/31/2018,10000,T5UCePsx,52000,more than downpayment,more than downpayment,0,3500
T639RJLY,9900,1/2/2020,9900,,9900,equal to downpayment,,9900,0
T71D73FG,9900,11/18/2019,9900,,9900,equal to downpayment,,9900,0
T75G9SHQ,1594,10/14/2019,1594,,1594,equal to downpayment,,1594,0
T75G9SHQ,3100,11/25/2019,1594,T75G9SHQ,4694,more than downpayment,equal to downpayment,0,3100
T75G9SHQ,3100,1/1/2020,1594,T75G9SHQ,7794,more than downpayment,more than downpayment,0,3100
T75G9SHQ,3100,1/28/2020,1594,T75G9SHQ,10894,more than downpayment,more than downpayment,0,3100
t7akaGEJ,10000,8/3/2017,10000,,10000,equal to downpayment,,10000,0
t7akaGEJ,2000,3/24/2018,10000,t7akaGEJ,12000,more than downpayment,equal to downpayment,0,2000
t7akaGEJ,1000,1/28/2019,10000,t7akaGEJ,13000,more than downpayment,more than downpayment,0,1000
t7akaGEJ,1000,4/8/2019,10000,t7akaGEJ,14000,more than downpayment,more than downpayment,0,1000
t7akaGEJ,1000,5/1/2019,10000,t7akaGEJ,15000,more than downpayment,more than downpayment,0,1000
t7akaGEJ,2000,6/4/2019,10000,t7akaGEJ,17000,more than downpayment,more than downpayment,0,2000
t7akaGEJ,2000,7/9/2019,10000,t7akaGEJ,19000,more than downpayment,more than downpayment,0,2000
t7akaGEJ,2000,8/5/2019,10000,t7akaGEJ,21000,more than downpayment,more than downpayment,0,2000
t7akaGEJ,2000,10/21/2019,10000,t7akaGEJ,23000,more than downpayment,more than downpayment,0,2000
t7akaGEJ,2000,11/22/2019,10000,t7akaGEJ,25000,more than downpayment,more than downpayment,0,2000
t7akaGEJ,2000,1/21/2020,10000,t7akaGEJ,27000,more than downpayment,more than downpayment,0,2000
T7tsF1L0,9900,7/5/2019,9900,,9900,equal to downpayment,,9900,0
T7tsF1L0,4000,8/10/2019,9900,T7tsF1L0,13900,more than downpayment,equal to downpayment,0,4000
T7tsF1L0,10000,9/6/2019,9900,T7tsF1L0,23900,more than downpayment,more than downpayment,0,10000
T7tsF1L0,4000,10/7/2019,9900,T7tsF1L0,27900,more than downpayment,more than downpayment,0,4000
T7tsF1L0,4000,11/7/2019,9900,T7tsF1L0,31900,more than downpayment,more than downpayment,0,4000
T7tsF1L0,4000,12/6/2019,9900,T7tsF1L0,35900,more than downpayment,more than downpayment,0,4000
T7tsF1L0,4000,2/9/2020,9900,T7tsF1L0,39900,more than downpayment,more than downpayment,0,4000
T7X9u5Dd,8900,4/18/2019,8900,,8900,equal to downpayment,,8900,0
T7X9u5Dd,3900,5/8/2019,8900,T7X9u5Dd,12800,more than downpayment,equal to downpayment,0,3900
T7X9u5Dd,1000,6/28/2019,8900,T7X9u5Dd,13800,more than downpayment,more than downpayment,0,1000
T7X9u5Dd,2900,7/3/2019,8900,T7X9u5Dd,16700,more than downpayment,more than downpayment,0,2900
T7X9u5Dd,3900,7/30/2019,8900,T7X9u5Dd,20600,more than downpayment,more than downpayment,0,3900
T7X9u5Dd,2000,9/3/2019,8900,T7X9u5Dd,22600,more than downpayment,more than downpayment,0,2000
T7X9u5Dd,1900,9/20/2019,8900,T7X9u5Dd,24500,more than downpayment,more than downpayment,0,1900
T7X9u5Dd,2000,10/22/2019,8900,T7X9u5Dd,26500,more than downpayment,more than downpayment,0,2000
T7X9u5Dd,1500,11/22/2019,8900,T7X9u5Dd,28000,more than downpayment,more than downpayment,0,1500
T7X9u5Dd,1000,11/27/2019,8900,T7X9u5Dd,29000,more than downpayment,more than downpayment,0,1000
T7X9u5Dd,6000,12/24/2019,8900,T7X9u5Dd,35000,more than downpayment,more than downpayment,0,6000
T7X9u5Dd,15000,1/23/2020,8900,T7X9u5Dd,50000,more than downpayment,more than downpayment,0,15000
T8B9SLC2,9900,7/25/2019,9900,,9900,equal to downpayment,,9900,0
T8B9SLC2,3900,10/30/2019,9900,T8B9SLC2,13800,more than downpayment,equal to downpayment,0,3900
T8B9SLC2,3900,11/27/2019,9900,T8B9SLC2,17700,more than downpayment,more than downpayment,0,3900
T8B9SLC2,3900,12/27/2019,9900,T8B9SLC2,21600,more than downpayment,more than downpayment,0,3900
T8B9SLC2,3900,1/18/2020,9900,T8B9SLC2,25500,more than downpayment,more than downpayment,0,3900
T8WFX77G,10000,1/20/2020,9900,,10000,more than downpayment,,9900,100
T9CZOYSI,8900,10/17/2019,8900,,8900,equal to downpayment,,8900,0
T9CZOYSI,4000,12/5/2019,8900,T9CZOYSI,12900,more than downpayment,equal to downpayment,0,4000
T9CZOYSI,4000,1/29/2020,8900,T9CZOYSI,16900,more than downpayment,more than downpayment,0,4000
T9JA2RZX,9900,11/8/2019,9900,,9900,equal to downpayment,,9900,0
T9JA2RZX,4000,12/21/2019,9900,T9JA2RZX,13900,more than downpayment,equal to downpayment,0,4000
T9JA2RZX,4000,1/24/2020,9900,T9JA2RZX,17900,more than downpayment,more than downpayment,0,4000
T9NVAI2M,8900,10/31/2019,9900,,8900,less than downpayment,,8900,0
T9NVAI2M,1000,11/2/2019,9900,T9NVAI2M,9900,equal to downpayment,less than downpayment,1000,0
T9NVAI2M,3900,12/15/2019,9900,T9NVAI2M,13800,more than downpayment,equal to downpayment,0,3900
T9NVAI2M,3900,1/14/2020,9900,T9NVAI2M,17700,more than downpayment,more than downpayment,0,3900
TADE7L6M,10010,12/15/2019,9900,,10010,more than downpayment,,9900,110
TAF651VU,9900,11/27/2019,9900,,9900,equal to downpayment,,9900,0
TALMRW7O,9900,6/4/2019,8900,,9900,more than downpayment,,8900,1000
TALMRW7O,4000,8/1/2019,8900,TALMRW7O,13900,more than downpayment,more than downpayment,0,4000
TALMRW7O,4000,9/11/2019,8900,TALMRW7O,17900,more than downpayment,more than downpayment,0,4000
TALMRW7O,4000,10/11/2019,8900,TALMRW7O,21900,more than downpayment,more than downpayment,0,4000
TALMRW7O,4000,10/30/2019,8900,TALMRW7O,25900,more than downpayment,more than downpayment,0,4000
TALMRW7O,4000,12/14/2019,8900,TALMRW7O,29900,more than downpayment,more than downpayment,0,4000
TALMRW7O,4000,12/30/2019,8900,TALMRW7O,33900,more than downpayment,more than downpayment,0,4000
TALMRW7O,4000,1/30/2020,8900,TALMRW7O,37900,more than downpayment,more than downpayment,0,4000
TCIOMP9I,7900,11/14/2019,7900,,7900,equal to downpayment,,7900,0
TCIOMP9I,3100,1/2/2020,7900,TCIOMP9I,11000,more than downpayment,equal to downpayment,0,3100
TCIOMP9I,3100,2/4/2020,7900,TCIOMP9I,14100,more than downpayment,more than downpayment,0,3100
TDB44YTP,9900,11/7/2019,9900,,9900,equal to downpayment,,9900,0
teenIo2E,8900,3/21/2019,8900,,8900,equal to downpayment,,8900,0
teenIo2E,3200,5/17/2019,8900,teenIo2E,12100,more than downpayment,equal to downpayment,0,3200
teenIo2E,500,5/21/2019,8900,teenIo2E,12600,more than downpayment,more than downpayment,0,500
teenIo2E,200,5/30/2019,8900,teenIo2E,12800,more than downpayment,more than downpayment,0,200
teenIo2E,1000,6/5/2019,8900,teenIo2E,13800,more than downpayment,more than downpayment,0,1000
TemZYWy4,10000,2/5/2019,10000,,10000,equal to downpayment,,10000,0
TemZYWy4,13500,5/30/2019,10000,TemZYWy4,23500,more than downpayment,equal to downpayment,0,13500
TFllVYkj,97000,11/16/2018,8900,,97000,more than downpayment,,8900,88100
TGQ4M48J,50000,1/22/2020,8900,,50000,more than downpayment,,8900,41100
TGT5BWL4,8900,1/27/2020,8900,,8900,equal to downpayment,,8900,0
tGy9HsIc,10000,7/9/2017,10000,,10000,equal to downpayment,,10000,0
tGy9HsIc,3500,9/8/2017,10000,tGy9HsIc,13500,more than downpayment,equal to downpayment,0,3500
tGy9HsIc,3500,10/1/2017,10000,tGy9HsIc,17000,more than downpayment,more than downpayment,0,3500
tGy9HsIc,3500,11/2/2017,10000,tGy9HsIc,20500,more than downpayment,more than downpayment,0,3500
tGy9HsIc,3500,12/4/2017,10000,tGy9HsIc,24000,more than downpayment,more than downpayment,0,3500
tGy9HsIc,3500,1/20/2018,10000,tGy9HsIc,27500,more than downpayment,more than downpayment,0,3500
tGy9HsIc,3500,2/23/2018,10000,tGy9HsIc,31000,more than downpayment,more than downpayment,0,3500
tGy9HsIc,3500,4/7/2018,10000,tGy9HsIc,34500,more than downpayment,more than downpayment,0,3500
tGy9HsIc,3500,5/5/2018,10000,tGy9HsIc,38000,more than downpayment,more than downpayment,0,3500
tGy9HsIc,3500,6/3/2018,10000,tGy9HsIc,41500,more than downpayment,more than downpayment,0,3500
tGy9HsIc,3500,7/10/2018,10000,tGy9HsIc,45000,more than downpayment,more than downpayment,0,3500
tGzsny6D,8900,3/18/2019,8900,,8900,equal to downpayment,,8900,0
tGzsny6D,3900,5/18/2019,8900,tGzsny6D,12800,more than downpayment,equal to downpayment,0,3900
tGzsny6D,4000,6/28/2019,8900,tGzsny6D,16800,more than downpayment,more than downpayment,0,4000
tGzsny6D,4000,8/30/2019,8900,tGzsny6D,20800,more than downpayment,more than downpayment,0,4000
tGzsny6D,7800,10/30/2019,8900,tGzsny6D,28600,more than downpayment,more than downpayment,0,7800
tGzsny6D,7800,11/27/2019,8900,tGzsny6D,36400,more than downpayment,more than downpayment,0,7800
TIeJXM5h,10000,7/1/2017,10000,,10000,equal to downpayment,,10000,0
TIeJXM5h,5000,9/23/2017,10000,TIeJXM5h,15000,more than downpayment,equal to downpayment,0,5000
TIeJXM5h,5000,11/4/2017,10000,TIeJXM5h,20000,more than downpayment,more than downpayment,0,5000
TIeJXM5h,5000,12/13/2017,10000,TIeJXM5h,25000,more than downpayment,more than downpayment,0,5000
TIeJXM5h,5000,1/13/2018,10000,TIeJXM5h,30000,more than downpayment,more than downpayment,0,5000
TIeJXM5h,5000,2/14/2018,10000,TIeJXM5h,35000,more than downpayment,more than downpayment,0,5000
TIeJXM5h,5000,3/14/2018,10000,TIeJXM5h,40000,more than downpayment,more than downpayment,0,5000
TIeJXM5h,5000,4/13/2018,10000,TIeJXM5h,45000,more than downpayment,more than downpayment,0,5000
TIeJXM5h,7000,5/14/2018,10000,TIeJXM5h,52000,more than downpayment,more than downpayment,0,7000
TIRGRREH,9900,8/31/2019,9900,,9900,equal to downpayment,,9900,0
TiTQSpEh,10000,6/13/2017,10000,,10000,equal to downpayment,,10000,0
TiTQSpEh,3000,9/7/2017,10000,TiTQSpEh,13000,more than downpayment,equal to downpayment,0,3000
TiTQSpEh,3000,11/23/2017,10000,TiTQSpEh,16000,more than downpayment,more than downpayment,0,3000
TiTQSpEh,4000,1/8/2018,10000,TiTQSpEh,20000,more than downpayment,more than downpayment,0,4000
TiTQSpEh,4000,2/14/2018,10000,TiTQSpEh,24000,more than downpayment,more than downpayment,0,4000
TiTQSpEh,4000,3/15/2018,10000,TiTQSpEh,28000,more than downpayment,more than downpayment,0,4000
TiTQSpEh,4000,4/23/2018,10000,TiTQSpEh,32000,more than downpayment,more than downpayment,0,4000
TiTQSpEh,4000,5/22/2018,10000,TiTQSpEh,36000,more than downpayment,more than downpayment,0,4000
TiTQSpEh,4000,7/9/2018,10000,TiTQSpEh,40000,more than downpayment,more than downpayment,0,4000
tjkqRoUd,10000,11/8/2018,10000,,10000,equal to downpayment,,10000,0
tjkqRoUd,4500,12/24/2018,10000,tjkqRoUd,14500,more than downpayment,equal to downpayment,0,4500
tjkqRoUd,4500,2/6/2019,10000,tjkqRoUd,19000,more than downpayment,more than downpayment,0,4500
tjkqRoUd,4500,2/18/2019,10000,tjkqRoUd,23500,more than downpayment,more than downpayment,0,4500
tjkqRoUd,4500,3/20/2019,10000,tjkqRoUd,28000,more than downpayment,more than downpayment,0,4500
tjkqRoUd,4400,4/23/2019,10000,tjkqRoUd,32400,more than downpayment,more than downpayment,0,4400
tjkqRoUd,100,5/8/2019,10000,tjkqRoUd,32500,more than downpayment,more than downpayment,0,100
tjkqRoUd,4500,5/15/2019,10000,tjkqRoUd,37000,more than downpayment,more than downpayment,0,4500
tjkqRoUd,4500,6/12/2019,10000,tjkqRoUd,41500,more than downpayment,more than downpayment,0,4500
tjkqRoUd,4500,7/2/2019,10000,tjkqRoUd,46000,more than downpayment,more than downpayment,0,4500
tjkqRoUd,4500,8/20/2019,10000,tjkqRoUd,50500,more than downpayment,more than downpayment,0,4500
tjkqRoUd,4500,9/13/2019,10000,tjkqRoUd,55000,more than downpayment,more than downpayment,0,4500
tjkqRoUd,4500,10/15/2019,10000,tjkqRoUd,59500,more than downpayment,more than downpayment,0,4500
tjkqRoUd,4500,12/10/2019,10000,tjkqRoUd,64000,more than downpayment,more than downpayment,0,4500
TJY4CNLF,9900,2/3/2020,9900,,9900,equal to downpayment,,9900,0
TKGINI22,9900,2/8/2020,9900,,9900,equal to downpayment,,9900,0
tkmvqS16,2000,7/1/2019,1999,,2000,more than downpayment,,1999,1
TL2T1CBO,9900,1/4/2020,9900,,9900,equal to downpayment,,9900,0
TL2T1CBO,5000,2/4/2020,9900,TL2T1CBO,14900,more than downpayment,equal to downpayment,0,5000
tLCapW2M,8900,4/1/2019,8900,,8900,equal to downpayment,,8900,0
tLCapW2M,5000,4/29/2019,8900,tLCapW2M,13900,more than downpayment,equal to downpayment,0,5000
tLCapW2M,3900,6/6/2019,8900,tLCapW2M,17800,more than downpayment,more than downpayment,0,3900
tLCapW2M,3900,7/4/2019,8900,tLCapW2M,21700,more than downpayment,more than downpayment,0,3900
tLCapW2M,3900,8/5/2019,8900,tLCapW2M,25600,more than downpayment,more than downpayment,0,3900
tLCapW2M,2000,9/6/2019,8900,tLCapW2M,27600,more than downpayment,more than downpayment,0,2000
tLCapW2M,1900,9/13/2019,8900,tLCapW2M,29500,more than downpayment,more than downpayment,0,1900
tLCapW2M,3900,10/4/2019,8900,tLCapW2M,33400,more than downpayment,more than downpayment,0,3900
tLCapW2M,2000,11/8/2019,8900,tLCapW2M,35400,more than downpayment,more than downpayment,0,2000
tLCapW2M,1900,11/10/2019,8900,tLCapW2M,37300,more than downpayment,more than downpayment,0,1900
tLCapW2M,3900,12/6/2019,8900,tLCapW2M,41200,more than downpayment,more than downpayment,0,3900
tLCapW2M,3900,1/7/2020,8900,tLCapW2M,45100,more than downpayment,more than downpayment,0,3900
tLCapW2M,2900,2/5/2020,8900,tLCapW2M,48000,more than downpayment,more than downpayment,0,2900
TLRCJXT6,9900,1/27/2020,9900,,9900,equal to downpayment,,9900,0
tmVV1jK7,10000,8/31/2018,10000,,10000,equal to downpayment,,10000,0
tmVV1jK7,1500,10/16/2018,10000,tmVV1jK7,11500,more than downpayment,equal to downpayment,0,1500
tmVV1jK7,2000,11/5/2018,10000,tmVV1jK7,13500,more than downpayment,more than downpayment,0,2000
tmVV1jK7,3500,11/26/2018,10000,tmVV1jK7,17000,more than downpayment,more than downpayment,0,3500
tmVV1jK7,5800,1/21/2019,10000,tmVV1jK7,22800,more than downpayment,more than downpayment,0,5800
tmVV1jK7,1500,5/9/2019,10000,tmVV1jK7,24300,more than downpayment,more than downpayment,0,1500
tmVV1jK7,2000,7/16/2019,10000,tmVV1jK7,26300,more than downpayment,more than downpayment,0,2000
TN2LUTY5,8900,5/7/2019,8900,,8900,equal to downpayment,,8900,0
TN2LUTY5,3900,6/18/2019,8900,TN2LUTY5,12800,more than downpayment,equal to downpayment,0,3900
TN2LUTY5,3900,7/18/2019,8900,TN2LUTY5,16700,more than downpayment,more than downpayment,0,3900
TN2LUTY5,3900,8/21/2019,8900,TN2LUTY5,20600,more than downpayment,more than downpayment,0,3900
TN2LUTY5,3900,9/20/2019,8900,TN2LUTY5,24500,more than downpayment,more than downpayment,0,3900
TN2LUTY5,3900,10/28/2019,8900,TN2LUTY5,28400,more than downpayment,more than downpayment,0,3900
TN2LUTY5,3900,11/1/2019,8900,TN2LUTY5,32300,more than downpayment,more than downpayment,0,3900
TN2LUTY5,3900,12/27/2019,8900,TN2LUTY5,36200,more than downpayment,more than downpayment,0,3900
TN2LUTY5,3900,1/31/2020,8900,TN2LUTY5,40100,more than downpayment,more than downpayment,0,3900
To2A0qe0,9900,7/10/2019,9900,,9900,equal to downpayment,,9900,0
To2A0qe0,3900,10/17/2019,9900,To2A0qe0,13800,more than downpayment,equal to downpayment,0,3900
To2A0qe0,7850,1/21/2020,9900,To2A0qe0,21650,more than downpayment,more than downpayment,0,7850
To6v7k4Q,8900,4/26/2019,8900,,8900,equal to downpayment,,8900,0
To6v7k4Q,3900,6/5/2019,8900,To6v7k4Q,12800,more than downpayment,equal to downpayment,0,3900
To6v7k4Q,3900,7/5/2019,8900,To6v7k4Q,16700,more than downpayment,more than downpayment,0,3900
To6v7k4Q,3900,8/4/2019,8900,To6v7k4Q,20600,more than downpayment,more than downpayment,0,3900
To6v7k4Q,3900,9/5/2019,8900,To6v7k4Q,24500,more than downpayment,more than downpayment,0,3900
To6v7k4Q,3900,10/5/2019,8900,To6v7k4Q,28400,more than downpayment,more than downpayment,0,3900
To6v7k4Q,3900,11/5/2019,8900,To6v7k4Q,32300,more than downpayment,more than downpayment,0,3900
To6v7k4Q,3900,12/5/2019,8900,To6v7k4Q,36200,more than downpayment,more than downpayment,0,3900
To6v7k4Q,3900,1/5/2020,8900,To6v7k4Q,40100,more than downpayment,more than downpayment,0,3900
To6v7k4Q,3900,2/5/2020,8900,To6v7k4Q,44000,more than downpayment,more than downpayment,0,3900
tOc7YFC1,16210,8/1/2019,8900,,16210,more than downpayment,,8900,7310
tOc7YFC1,5000,9/3/2019,8900,tOc7YFC1,21210,more than downpayment,more than downpayment,0,5000
tOc7YFC1,5000,10/1/2019,8900,tOc7YFC1,26210,more than downpayment,more than downpayment,0,5000
tOc7YFC1,6000,11/1/2019,8900,tOc7YFC1,32210,more than downpayment,more than downpayment,0,6000
tOc7YFC1,5500,12/4/2019,8900,tOc7YFC1,37710,more than downpayment,more than downpayment,0,5500
tOc7YFC1,4000,12/27/2019,8900,tOc7YFC1,41710,more than downpayment,more than downpayment,0,4000
tOc7YFC1,5500,2/4/2020,8900,tOc7YFC1,47210,more than downpayment,more than downpayment,0,5500
tOfnXcO9,15000,9/4/2018,0,,15000,more than downpayment,,0,15000
tOfnXcO9,30000,9/10/2018,0,tOfnXcO9,45000,more than downpayment,more than downpayment,0,30000
tOfnXcO9,25000,9/16/2018,0,tOfnXcO9,70000,more than downpayment,more than downpayment,0,25000
TOIqd3LB,10000,9/4/2018,10000,,10000,equal to downpayment,,10000,0
TOIqd3LB,4500,10/12/2018,10000,TOIqd3LB,14500,more than downpayment,equal to downpayment,0,4500
TOIqd3LB,43500,11/9/2018,10000,TOIqd3LB,58000,more than downpayment,more than downpayment,0,43500
ToMRBf4k,51000,7/5/2019,24400,,51000,more than downpayment,,24400,26600
ToMRBf4k,8000,8/2/2019,24400,ToMRBf4k,59000,more than downpayment,more than downpayment,0,8000
ToMRBf4k,21000,12/9/2019,24400,ToMRBf4k,80000,more than downpayment,more than downpayment,0,21000
ToMRBf4k,31000,1/20/2020,24400,ToMRBf4k,111000,more than downpayment,more than downpayment,0,31000
ToVKMMT1,9900,11/27/2018,9900,,9900,equal to downpayment,,9900,0
ToVKMMT1,4500,2/28/2019,9900,ToVKMMT1,14400,more than downpayment,equal to downpayment,0,4500
ToVKMMT1,9000,5/20/2019,9900,ToVKMMT1,23400,more than downpayment,more than downpayment,0,9000
tOweGtRn,9900,7/16/2019,9900,,9900,equal to downpayment,,9900,0
tOweGtRn,5700,8/15/2019,9900,tOweGtRn,15600,more than downpayment,equal to downpayment,0,5700
tOweGtRn,5000,8/24/2019,9900,tOweGtRn,20600,more than downpayment,more than downpayment,0,5000
tOweGtRn,4400,9/21/2019,9900,tOweGtRn,25000,more than downpayment,more than downpayment,0,4400
tOweGtRn,3900,10/23/2019,9900,tOweGtRn,28900,more than downpayment,more than downpayment,0,3900
tOweGtRn,3900,11/16/2019,9900,tOweGtRn,32800,more than downpayment,more than downpayment,0,3900
tOweGtRn,2000,12/16/2019,9900,tOweGtRn,34800,more than downpayment,more than downpayment,0,2000
tOweGtRn,3900,1/25/2020,9900,tOweGtRn,38700,more than downpayment,more than downpayment,0,3900
ToxvnA7c,8900,5/13/2019,8900,,8900,equal to downpayment,,8900,0
ToxvnA7c,3900,8/25/2019,8900,ToxvnA7c,12800,more than downpayment,equal to downpayment,0,3900
ToxvnA7c,3900,9/10/2019,8900,ToxvnA7c,16700,more than downpayment,more than downpayment,0,3900
ToxvnA7c,5000,2/5/2020,8900,ToxvnA7c,21700,more than downpayment,more than downpayment,0,5000
TP1K8BZ9,5,1/17/2020,9900,,5,less than downpayment,,5,0
tpH8Ukm0,8900,2/12/2019,8900,,8900,equal to downpayment,,8900,0
tpH8Ukm0,3900,3/20/2019,8900,tpH8Ukm0,12800,more than downpayment,equal to downpayment,0,3900
tpH8Ukm0,3900,4/19/2019,8900,tpH8Ukm0,16700,more than downpayment,more than downpayment,0,3900
tpH8Ukm0,3900,5/21/2019,8900,tpH8Ukm0,20600,more than downpayment,more than downpayment,0,3900
tpH8Ukm0,3100,6/25/2019,8900,tpH8Ukm0,23700,more than downpayment,more than downpayment,0,3100
tpH8Ukm0,800,6/26/2019,8900,tpH8Ukm0,24500,more than downpayment,more than downpayment,0,800
tpH8Ukm0,3900,7/22/2019,8900,tpH8Ukm0,28400,more than downpayment,more than downpayment,0,3900
tpH8Ukm0,1400,8/23/2019,8900,tpH8Ukm0,29800,more than downpayment,more than downpayment,0,1400
tpH8Ukm0,2500,8/26/2019,8900,tpH8Ukm0,32300,more than downpayment,more than downpayment,0,2500
tpH8Ukm0,2000,9/25/2019,8900,tpH8Ukm0,34300,more than downpayment,more than downpayment,0,2000
tpH8Ukm0,1900,10/10/2019,8900,tpH8Ukm0,36200,more than downpayment,more than downpayment,0,1900
tpH8Ukm0,2000,10/29/2019,8900,tpH8Ukm0,38200,more than downpayment,more than downpayment,0,2000
tpH8Ukm0,1900,11/22/2019,8900,tpH8Ukm0,40100,more than downpayment,more than downpayment,0,1900
tpH8Ukm0,3900,12/21/2019,8900,tpH8Ukm0,44000,more than downpayment,more than downpayment,0,3900
tpH8Ukm0,3900,1/4/2020,8900,tpH8Ukm0,47900,more than downpayment,more than downpayment,0,3900
tpH8Ukm0,2500,1/27/2020,8900,tpH8Ukm0,50400,more than downpayment,more than downpayment,0,2500
TPTYNGPQ,9900,6/21/2019,9900,,9900,equal to downpayment,,9900,0
TPTYNGPQ,3900,8/15/2019,9900,TPTYNGPQ,13800,more than downpayment,equal to downpayment,0,3900
TPTYNGPQ,3900,9/14/2019,9900,TPTYNGPQ,17700,more than downpayment,more than downpayment,0,3900
TPTYNGPQ,3900,10/13/2019,9900,TPTYNGPQ,21600,more than downpayment,more than downpayment,0,3900
TPTYNGPQ,3900,11/15/2019,9900,TPTYNGPQ,25500,more than downpayment,more than downpayment,0,3900
TPTYNGPQ,3900,12/15/2019,9900,TPTYNGPQ,29400,more than downpayment,more than downpayment,0,3900
TPTYNGPQ,3900,1/15/2020,9900,TPTYNGPQ,33300,more than downpayment,more than downpayment,0,3900
TPUDKLDJ,9900,7/15/2019,9900,,9900,equal to downpayment,,9900,0
TPUDKLDJ,4000,9/4/2019,9900,TPUDKLDJ,13900,more than downpayment,equal to downpayment,0,4000
TPUDKLDJ,3900,10/5/2019,9900,TPUDKLDJ,17800,more than downpayment,more than downpayment,0,3900
TPUDKLDJ,4000,11/5/2019,9900,TPUDKLDJ,21800,more than downpayment,more than downpayment,0,4000
TPUDKLDJ,3900,12/4/2019,9900,TPUDKLDJ,25700,more than downpayment,more than downpayment,0,3900
TPUDKLDJ,3900,12/25/2019,9900,TPUDKLDJ,29600,more than downpayment,more than downpayment,0,3900
TPUDKLDJ,3900,1/25/2020,9900,TPUDKLDJ,33500,more than downpayment,more than downpayment,0,3900
tpVPBdw8,9900,8/6/2019,9900,,9900,equal to downpayment,,9900,0
tpVPBdw8,5000,9/29/2019,9900,tpVPBdw8,14900,more than downpayment,equal to downpayment,0,5000
tpVPBdw8,5000,10/28/2019,9900,tpVPBdw8,19900,more than downpayment,more than downpayment,0,5000
tpVPBdw8,5000,12/3/2019,9900,tpVPBdw8,24900,more than downpayment,more than downpayment,0,5000
tpVPBdw8,5000,1/3/2020,9900,tpVPBdw8,29900,more than downpayment,more than downpayment,0,5000
tpVPBdw8,5000,1/27/2020,9900,tpVPBdw8,34900,more than downpayment,more than downpayment,0,5000
tqSYnfIQ,8900,6/1/2019,8900,,8900,equal to downpayment,,8900,0
tqSYnfIQ,3900,7/24/2019,8900,tqSYnfIQ,12800,more than downpayment,equal to downpayment,0,3900
tqSYnfIQ,3900,8/23/2019,8900,tqSYnfIQ,16700,more than downpayment,more than downpayment,0,3900
tqSYnfIQ,10000,8/24/2019,8900,tqSYnfIQ,26700,more than downpayment,more than downpayment,0,10000
tqSYnfIQ,3900,9/24/2019,8900,tqSYnfIQ,30600,more than downpayment,more than downpayment,0,3900
tqSYnfIQ,3900,10/23/2019,8900,tqSYnfIQ,34500,more than downpayment,more than downpayment,0,3900
tqSYnfIQ,3900,11/23/2019,8900,tqSYnfIQ,38400,more than downpayment,more than downpayment,0,3900
tqSYnfIQ,3900,12/26/2019,8900,tqSYnfIQ,42300,more than downpayment,more than downpayment,0,3900
tqSYnfIQ,3900,1/25/2020,8900,tqSYnfIQ,46200,more than downpayment,more than downpayment,0,3900
TRZRRL6F,9900,11/22/2019,9900,,9900,equal to downpayment,,9900,0
TRZRRL6F,3900,2/5/2020,9900,TRZRRL6F,13800,more than downpayment,equal to downpayment,0,3900
TSDLCKHP,9900,6/29/2019,9900,,9900,equal to downpayment,,9900,0
TSDLCKHP,3000,10/5/2019,9900,TSDLCKHP,12900,more than downpayment,equal to downpayment,0,3000
TSDLCKHP,4000,10/26/2019,9900,TSDLCKHP,16900,more than downpayment,more than downpayment,0,4000
TSDLCKHP,4700,11/3/2019,9900,TSDLCKHP,21600,more than downpayment,more than downpayment,0,4700
TSDLCKHP,5000,1/26/2020,9900,TSDLCKHP,26600,more than downpayment,more than downpayment,0,5000
TSDLCKHP,2000,2/4/2020,9900,TSDLCKHP,28600,more than downpayment,more than downpayment,0,2000
Tu7y4wbN,7500,6/6/2017,10000,,7500,less than downpayment,,7500,0
Tu7y4wbN,3000,7/4/2017,10000,Tu7y4wbN,10500,more than downpayment,less than downpayment,2500,500
Tu7y4wbN,10000,8/5/2017,10000,Tu7y4wbN,20500,more than downpayment,more than downpayment,0,10000
Tu7y4wbN,10000,10/5/2017,10000,Tu7y4wbN,30500,more than downpayment,more than downpayment,0,10000
Tu7y4wbN,3500,12/22/2017,10000,Tu7y4wbN,34000,more than downpayment,more than downpayment,0,3500
Tu7y4wbN,3500,1/22/2018,10000,Tu7y4wbN,37500,more than downpayment,more than downpayment,0,3500
Tu7y4wbN,2500,1/31/2018,10000,Tu7y4wbN,40000,more than downpayment,more than downpayment,0,2500
Tu7y4wbN,13400,4/23/2019,10000,Tu7y4wbN,53400,more than downpayment,more than downpayment,0,13400
TUcDjAEb,8900,4/2/2019,8900,,8900,equal to downpayment,,8900,0
TUcDjAEb,3900,5/12/2019,8900,TUcDjAEb,12800,more than downpayment,equal to downpayment,0,3900
TUcDjAEb,3900,6/10/2019,8900,TUcDjAEb,16700,more than downpayment,more than downpayment,0,3900
TUcDjAEb,2200,7/30/2019,8900,TUcDjAEb,18900,more than downpayment,more than downpayment,0,2200
TUcDjAEb,1700,8/1/2019,8900,TUcDjAEb,20600,more than downpayment,more than downpayment,0,1700
TUcDjAEb,3900,9/11/2019,8900,TUcDjAEb,24500,more than downpayment,more than downpayment,0,3900
TUcDjAEb,3900,10/5/2019,8900,TUcDjAEb,28400,more than downpayment,more than downpayment,0,3900
TUcDjAEb,400,12/6/2019,8900,TUcDjAEb,28800,more than downpayment,more than downpayment,0,400
TUcDjAEb,7400,12/30/2019,8900,TUcDjAEb,36200,more than downpayment,more than downpayment,0,7400
TUcDjAEb,3000,1/27/2020,8900,TUcDjAEb,39200,more than downpayment,more than downpayment,0,3000
TUcDjAEb,900,1/28/2020,8900,TUcDjAEb,40100,more than downpayment,more than downpayment,0,900
Tut2za4Z,8900,8/3/2019,8900,,8900,equal to downpayment,,8900,0
Tut2za4Z,3900,10/15/2019,8900,Tut2za4Z,12800,more than downpayment,equal to downpayment,0,3900
Tut2za4Z,3900,11/11/2019,8900,Tut2za4Z,16700,more than downpayment,more than downpayment,0,3900
Tut2za4Z,3900,12/5/2019,8900,Tut2za4Z,20600,more than downpayment,more than downpayment,0,3900
Tut2za4Z,3900,1/13/2020,8900,Tut2za4Z,24500,more than downpayment,more than downpayment,0,3900
TVHSWOQE,9900,9/2/2019,9900,,9900,equal to downpayment,,9900,0
TVHSWOQE,3900,10/25/2019,9900,TVHSWOQE,13800,more than downpayment,equal to downpayment,0,3900
TVHSWOQE,3900,11/25/2019,9900,TVHSWOQE,17700,more than downpayment,more than downpayment,0,3900
TVHSWOQE,3900,12/25/2019,9900,TVHSWOQE,21600,more than downpayment,more than downpayment,0,3900
TVHSWOQE,3900,1/27/2020,9900,TVHSWOQE,25500,more than downpayment,more than downpayment,0,3900
tVkcJtiF,10000,10/24/2018,10000,,10000,equal to downpayment,,10000,0
tVkcJtiF,9000,11/30/2018,10000,tVkcJtiF,19000,more than downpayment,equal to downpayment,0,9000
tVkcJtiF,13500,2/4/2019,10000,tVkcJtiF,32500,more than downpayment,more than downpayment,0,13500
tVkcJtiF,18000,4/23/2019,10000,tVkcJtiF,50500,more than downpayment,more than downpayment,0,18000
tVkcJtiF,9000,8/21/2019,10000,tVkcJtiF,59500,more than downpayment,more than downpayment,0,9000
tVkcJtiF,4500,11/9/2019,10000,tVkcJtiF,64000,more than downpayment,more than downpayment,0,4500
tvQfUqhA,9900,7/10/2019,8900,,9900,more than downpayment,,8900,1000
tvQfUqhA,3900,7/31/2019,8900,tvQfUqhA,13800,more than downpayment,more than downpayment,0,3900
tvQfUqhA,3900,9/3/2019,8900,tvQfUqhA,17700,more than downpayment,more than downpayment,0,3900
tvQfUqhA,3900,10/2/2019,8900,tvQfUqhA,21600,more than downpayment,more than downpayment,0,3900
tvQfUqhA,3900,11/13/2019,8900,tvQfUqhA,25500,more than downpayment,more than downpayment,0,3900
tvQfUqhA,3900,12/15/2019,8900,tvQfUqhA,29400,more than downpayment,more than downpayment,0,3900
tvQfUqhA,5000,2/4/2020,8900,tvQfUqhA,34400,more than downpayment,more than downpayment,0,5000
TWCOZI72,15000,7/29/2019,8900,,15000,more than downpayment,,8900,6100
TWCOZI72,10000,11/8/2019,8900,TWCOZI72,25000,more than downpayment,more than downpayment,0,10000
TWCOZI72,4000,12/17/2019,8900,TWCOZI72,29000,more than downpayment,more than downpayment,0,4000
TWCOZI72,4000,1/18/2020,8900,TWCOZI72,33000,more than downpayment,more than downpayment,0,4000
twkENdVS,9900,6/20/2019,9900,,9900,equal to downpayment,,9900,0
twkENdVS,3000,8/27/2019,9900,twkENdVS,12900,more than downpayment,equal to downpayment,0,3000
twkENdVS,900,9/2/2019,9900,twkENdVS,13800,more than downpayment,more than downpayment,0,900
twkENdVS,3900,10/1/2019,9900,twkENdVS,17700,more than downpayment,more than downpayment,0,3900
twkENdVS,7800,12/7/2019,9900,twkENdVS,25500,more than downpayment,more than downpayment,0,7800
twkENdVS,2200,1/19/2020,9900,twkENdVS,27700,more than downpayment,more than downpayment,0,2200
twkENdVS,1000,1/22/2020,9900,twkENdVS,28700,more than downpayment,more than downpayment,0,1000
TXTZI8EX,7900,1/26/2020,7900,,7900,equal to downpayment,,7900,0
tXYIbcPW,10000,9/7/2018,10000,,10000,equal to downpayment,,10000,0
tXYIbcPW,4500,10/4/2018,10000,tXYIbcPW,14500,more than downpayment,equal to downpayment,0,4500
tXYIbcPW,4500,11/6/2018,10000,tXYIbcPW,19000,more than downpayment,more than downpayment,0,4500
tXYIbcPW,4500,12/5/2018,10000,tXYIbcPW,23500,more than downpayment,more than downpayment,0,4500
tXYIbcPW,4500,1/7/2019,10000,tXYIbcPW,28000,more than downpayment,more than downpayment,0,4500
tXYIbcPW,4500,2/5/2019,10000,tXYIbcPW,32500,more than downpayment,more than downpayment,0,4500
tXYIbcPW,4500,3/4/2019,10000,tXYIbcPW,37000,more than downpayment,more than downpayment,0,4500
tXYIbcPW,4500,4/5/2019,10000,tXYIbcPW,41500,more than downpayment,more than downpayment,0,4500
tXYIbcPW,4500,5/5/2019,10000,tXYIbcPW,46000,more than downpayment,more than downpayment,0,4500
tXYIbcPW,4500,6/6/2019,10000,tXYIbcPW,50500,more than downpayment,more than downpayment,0,4500
tXYIbcPW,4500,7/5/2019,10000,tXYIbcPW,55000,more than downpayment,more than downpayment,0,4500
tXYIbcPW,4500,8/5/2019,10000,tXYIbcPW,59500,more than downpayment,more than downpayment,0,4500
tXYIbcPW,4500,9/23/2019,10000,tXYIbcPW,64000,more than downpayment,more than downpayment,0,4500
TYD5FE2T,8900,11/23/2019,8900,,8900,equal to downpayment,,8900,0
TyIrNv1c,10000,6/6/2017,10000,,10000,equal to downpayment,,10000,0
TyIrNv1c,3500,7/1/2017,10000,TyIrNv1c,13500,more than downpayment,equal to downpayment,0,3500
TyIrNv1c,3500,8/1/2017,10000,TyIrNv1c,17000,more than downpayment,more than downpayment,0,3500
TyIrNv1c,3500,9/1/2017,10000,TyIrNv1c,20500,more than downpayment,more than downpayment,0,3500
TyIrNv1c,2942,10/2/2017,10000,TyIrNv1c,23442,more than downpayment,more than downpayment,0,2942
TyIrNv1c,3500,11/1/2017,10000,TyIrNv1c,26942,more than downpayment,more than downpayment,0,3500
TyIrNv1c,3500,12/1/2017,10000,TyIrNv1c,30442,more than downpayment,more than downpayment,0,3500
TyIrNv1c,3500,1/2/2018,10000,TyIrNv1c,33942,more than downpayment,more than downpayment,0,3500
TyIrNv1c,3500,2/1/2018,10000,TyIrNv1c,37442,more than downpayment,more than downpayment,0,3500
TyIrNv1c,3500,3/1/2018,10000,TyIrNv1c,40942,more than downpayment,more than downpayment,0,3500
TyIrNv1c,4058,4/25/2018,10000,TyIrNv1c,45000,more than downpayment,more than downpayment,0,4058
TYYL2AQR,10000,1/8/2020,9900,,10000,more than downpayment,,9900,100
Tza14WIU,8900,1/11/2019,8900,,8900,equal to downpayment,,8900,0
Tza14WIU,3900,2/12/2019,8900,Tza14WIU,12800,more than downpayment,equal to downpayment,0,3900
Tza14WIU,3900,3/21/2019,8900,Tza14WIU,16700,more than downpayment,more than downpayment,0,3900
Tza14WIU,3900,4/24/2019,8900,Tza14WIU,20600,more than downpayment,more than downpayment,0,3900
Tza14WIU,3900,5/28/2019,8900,Tza14WIU,24500,more than downpayment,more than downpayment,0,3900
Tza14WIU,3900,7/12/2019,8900,Tza14WIU,28400,more than downpayment,more than downpayment,0,3900
Tza14WIU,3900,8/23/2019,8900,Tza14WIU,32300,more than downpayment,more than downpayment,0,3900
Tza14WIU,7800,9/25/2019,8900,Tza14WIU,40100,more than downpayment,more than downpayment,0,7800
Tza14WIU,3900,11/22/2019,8900,Tza14WIU,44000,more than downpayment,more than downpayment,0,3900
TZA3U1F3,9900,12/6/2019,9900,,9900,equal to downpayment,,9900,0
TZBZ0sNi,9900,6/15/2019,9900,,9900,equal to downpayment,,9900,0
TZBZ0sNi,4000,7/23/2019,9900,TZBZ0sNi,13900,more than downpayment,equal to downpayment,0,4000
TZBZ0sNi,4000,8/30/2019,9900,TZBZ0sNi,17900,more than downpayment,more than downpayment,0,4000
TZBZ0sNi,4000,9/23/2019,9900,TZBZ0sNi,21900,more than downpayment,more than downpayment,0,4000
TZBZ0sNi,4000,11/4/2019,9900,TZBZ0sNi,25900,more than downpayment,more than downpayment,0,4000
TZBZ0sNi,4000,12/7/2019,9900,TZBZ0sNi,29900,more than downpayment,more than downpayment,0,4000
TZBZ0sNi,3500,1/3/2020,9900,TZBZ0sNi,33400,more than downpayment,more than downpayment,0,3500
TZBZ0sNi,3500,1/31/2020,9900,TZBZ0sNi,36900,more than downpayment,more than downpayment,0,3500
TZE7EIW4,10000,12/14/2019,9900,,10000,more than downpayment,,9900,100
tZetie5e,24300,7/11/2019,9900,,24300,more than downpayment,,9900,14400
tZetie5e,200,7/12/2019,9900,tZetie5e,24500,more than downpayment,more than downpayment,0,200
tZetie5e,13260,7/16/2019,9900,tZetie5e,37760,more than downpayment,more than downpayment,0,13260
tZetie5e,7300,9/5/2019,9900,tZetie5e,45060,more than downpayment,more than downpayment,0,7300
tZetie5e,7300,10/5/2019,9900,tZetie5e,52360,more than downpayment,more than downpayment,0,7300
tZetie5e,7300,11/5/2019,9900,tZetie5e,59660,more than downpayment,more than downpayment,0,7300
tZetie5e,7300,12/6/2019,9900,tZetie5e,66960,more than downpayment,more than downpayment,0,7300
tZetie5e,7300,1/5/2020,9900,tZetie5e,74260,more than downpayment,more than downpayment,0,7300
tZetie5e,7300,2/5/2020,9900,tZetie5e,81560,more than downpayment,more than downpayment,0,7300
U11gsACx,10000,9/20/2018,10000,,10000,equal to downpayment,,10000,0
U11gsACx,4500,10/9/2018,10000,U11gsACx,14500,more than downpayment,equal to downpayment,0,4500
U11gsACx,4500,11/6/2018,10000,U11gsACx,19000,more than downpayment,more than downpayment,0,4500
U11gsACx,4500,12/12/2018,10000,U11gsACx,23500,more than downpayment,more than downpayment,0,4500
U11gsACx,4500,1/14/2019,10000,U11gsACx,28000,more than downpayment,more than downpayment,0,4500
U11gsACx,4500,2/7/2019,10000,U11gsACx,32500,more than downpayment,more than downpayment,0,4500
U11gsACx,4500,3/11/2019,10000,U11gsACx,37000,more than downpayment,more than downpayment,0,4500
U11gsACx,4500,4/4/2019,10000,U11gsACx,41500,more than downpayment,more than downpayment,0,4500
U11gsACx,4500,5/6/2019,10000,U11gsACx,46000,more than downpayment,more than downpayment,0,4500
U11gsACx,4500,6/4/2019,10000,U11gsACx,50500,more than downpayment,more than downpayment,0,4500
U11gsACx,4500,7/6/2019,10000,U11gsACx,55000,more than downpayment,more than downpayment,0,4500
U11gsACx,4500,7/27/2019,10000,U11gsACx,59500,more than downpayment,more than downpayment,0,4500
U11gsACx,4500,9/6/2019,10000,U11gsACx,64000,more than downpayment,more than downpayment,0,4500
U35SR5BJ,9900,11/1/2019,9900,,9900,equal to downpayment,,9900,0
U35SR5BJ,2800,1/10/2020,9900,U35SR5BJ,12700,more than downpayment,equal to downpayment,0,2800
U35SR5BJ,5000,2/4/2020,9900,U35SR5BJ,17700,more than downpayment,more than downpayment,0,5000
U48XJ9RT,13800,11/12/2019,9900,,13800,more than downpayment,,9900,3900
U4QQGIHU,1594,10/14/2019,1594,,1594,equal to downpayment,,1594,0
U4QQGIHU,3100,12/4/2019,1594,U4QQGIHU,4694,more than downpayment,equal to downpayment,0,3100
U4QQGIHU,3100,1/2/2020,1594,U4QQGIHU,7794,more than downpayment,more than downpayment,0,3100
U4QQGIHU,3100,2/4/2020,1594,U4QQGIHU,10894,more than downpayment,more than downpayment,0,3100
U4xHq4AF,10000,1/8/2019,10000,,10000,equal to downpayment,,10000,0
U4xHq4AF,4500,6/5/2019,10000,U4xHq4AF,14500,more than downpayment,equal to downpayment,0,4500
U5E6C5AT,9900,12/21/2019,9900,,9900,equal to downpayment,,9900,0
U5LLPAVQ,8900,11/18/2019,8900,,8900,equal to downpayment,,8900,0
U5LLPAVQ,5000,12/21/2019,8900,U5LLPAVQ,13900,more than downpayment,equal to downpayment,0,5000
U5LLPAVQ,3900,2/2/2020,8900,U5LLPAVQ,17800,more than downpayment,more than downpayment,0,3900
U6FHY2IY,8900,10/26/2018,8900,,8900,equal to downpayment,,8900,0
U6FHY2IY,3900,11/26/2018,8900,U6FHY2IY,12800,more than downpayment,equal to downpayment,0,3900
U6FHY2IY,3900,12/23/2018,8900,U6FHY2IY,16700,more than downpayment,more than downpayment,0,3900
U6FHY2IY,3900,1/22/2019,8900,U6FHY2IY,20600,more than downpayment,more than downpayment,0,3900
U6FHY2IY,3900,2/21/2019,8900,U6FHY2IY,24500,more than downpayment,more than downpayment,0,3900
U6FHY2IY,3900,3/23/2019,8900,U6FHY2IY,28400,more than downpayment,more than downpayment,0,3900
U6FHY2IY,3900,4/26/2019,8900,U6FHY2IY,32300,more than downpayment,more than downpayment,0,3900
U6FHY2IY,3900,5/22/2019,8900,U6FHY2IY,36200,more than downpayment,more than downpayment,0,3900
U6FHY2IY,3900,6/29/2019,8900,U6FHY2IY,40100,more than downpayment,more than downpayment,0,3900
U6FHY2IY,3900,7/25/2019,8900,U6FHY2IY,44000,more than downpayment,more than downpayment,0,3900
U6FHY2IY,3900,8/27/2019,8900,U6FHY2IY,47900,more than downpayment,more than downpayment,0,3900
U6FHY2IY,3900,9/24/2019,8900,U6FHY2IY,51800,more than downpayment,more than downpayment,0,3900
U6FHY2IY,3900,10/25/2019,8900,U6FHY2IY,55700,more than downpayment,more than downpayment,0,3900
U6FHY2IY,3900,12/5/2019,8900,U6FHY2IY,59600,more than downpayment,more than downpayment,0,3900
U6FHY2IY,3900,1/2/2020,8900,U6FHY2IY,63500,more than downpayment,more than downpayment,0,3900
U6FHY2IY,3900,1/30/2020,8900,U6FHY2IY,67400,more than downpayment,more than downpayment,0,3900
U6S3M28F,10000,6/13/2019,8900,,10000,more than downpayment,,8900,1100
U6S3M28F,4000,9/3/2019,8900,U6S3M28F,14000,more than downpayment,more than downpayment,0,4000
U6S3M28F,7600,11/4/2019,8900,U6S3M28F,21600,more than downpayment,more than downpayment,0,7600
U6S3M28F,1000,11/5/2019,8900,U6S3M28F,22600,more than downpayment,more than downpayment,0,1000
U6S3M28F,2900,12/2/2019,8900,U6S3M28F,25500,more than downpayment,more than downpayment,0,2900
U6S3M28F,3900,1/2/2020,8900,U6S3M28F,29400,more than downpayment,more than downpayment,0,3900
U6S3M28F,3900,2/3/2020,8900,U6S3M28F,33300,more than downpayment,more than downpayment,0,3900
u7qXgLWL,10000,10/24/2018,0,,10000,more than downpayment,,0,10000
u7qXgLWL,10000,12/15/2018,0,u7qXgLWL,20000,more than downpayment,more than downpayment,0,10000
u7qXgLWL,30000,2/13/2019,0,u7qXgLWL,50000,more than downpayment,more than downpayment,0,30000
u7qXgLWL,4100,2/21/2019,0,u7qXgLWL,54100,more than downpayment,more than downpayment,0,4100
U7VK2OIR,9900,1/28/2020,9900,,9900,equal to downpayment,,9900,0
U7YIA347,4,11/23/2019,9900,,4,less than downpayment,,4,0
U8EC4M2W,7000,8/30/2019,9900,,7000,less than downpayment,,7000,0
U8EC4M2W,2900,9/3/2019,9900,U8EC4M2W,9900,equal to downpayment,less than downpayment,2900,0
U8EC4M2W,3350,10/29/2019,9900,U8EC4M2W,13250,more than downpayment,equal to downpayment,0,3350
U8EC4M2W,200,11/20/2019,9900,U8EC4M2W,13450,more than downpayment,more than downpayment,0,200
U8EC4M2W,50,11/21/2019,9900,U8EC4M2W,13500,more than downpayment,more than downpayment,0,50
U8EC4M2W,200,11/30/2019,9900,U8EC4M2W,13700,more than downpayment,more than downpayment,0,200
U8EC4M2W,100,12/3/2019,9900,U8EC4M2W,13800,more than downpayment,more than downpayment,0,100
U8EC4M2W,200,12/8/2019,9900,U8EC4M2W,14000,more than downpayment,more than downpayment,0,200
U8EC4M2W,1950,12/10/2019,9900,U8EC4M2W,15950,more than downpayment,more than downpayment,0,1950
U8EC4M2W,1500,12/23/2019,9900,U8EC4M2W,17450,more than downpayment,more than downpayment,0,1500
U8EC4M2W,300,1/11/2020,9900,U8EC4M2W,17750,more than downpayment,more than downpayment,0,300
U8EC4M2W,500,1/16/2020,9900,U8EC4M2W,18250,more than downpayment,more than downpayment,0,500
U8EC4M2W,800,1/24/2020,9900,U8EC4M2W,19050,more than downpayment,more than downpayment,0,800
U8EC4M2W,1500,1/31/2020,9900,U8EC4M2W,20550,more than downpayment,more than downpayment,0,1500
u8Py9PQi,8900,7/20/2019,8900,,8900,equal to downpayment,,8900,0
u8Py9PQi,3900,10/5/2019,8900,u8Py9PQi,12800,more than downpayment,equal to downpayment,0,3900
u8Py9PQi,3900,11/15/2019,8900,u8Py9PQi,16700,more than downpayment,more than downpayment,0,3900
u8Py9PQi,3900,1/3/2020,8900,u8Py9PQi,20600,more than downpayment,more than downpayment,0,3900
u8Py9PQi,3900,1/20/2020,8900,u8Py9PQi,24500,more than downpayment,more than downpayment,0,3900
UAahHjGp,10000,9/15/2018,10000,,10000,equal to downpayment,,10000,0
UAahHjGp,4500,10/15/2018,10000,UAahHjGp,14500,more than downpayment,equal to downpayment,0,4500
UAahHjGp,4500,11/16/2018,10000,UAahHjGp,19000,more than downpayment,more than downpayment,0,4500
UAahHjGp,2300,12/18/2018,10000,UAahHjGp,21300,more than downpayment,more than downpayment,0,2300
UAahHjGp,2300,1/4/2019,10000,UAahHjGp,23600,more than downpayment,more than downpayment,0,2300
UAahHjGp,4500,2/4/2019,10000,UAahHjGp,28100,more than downpayment,more than downpayment,0,4500
UAahHjGp,4500,3/3/2019,10000,UAahHjGp,32600,more than downpayment,more than downpayment,0,4500
UAahHjGp,2000,3/31/2019,10000,UAahHjGp,34600,more than downpayment,more than downpayment,0,2000
UAahHjGp,2400,4/3/2019,10000,UAahHjGp,37000,more than downpayment,more than downpayment,0,2400
UAahHjGp,3000,4/15/2019,10000,UAahHjGp,40000,more than downpayment,more than downpayment,0,3000
UAahHjGp,1500,4/30/2019,10000,UAahHjGp,41500,more than downpayment,more than downpayment,0,1500
UAahHjGp,4500,6/3/2019,10000,UAahHjGp,46000,more than downpayment,more than downpayment,0,4500
UAahHjGp,4500,7/1/2019,10000,UAahHjGp,50500,more than downpayment,more than downpayment,0,4500
UAahHjGp,4500,7/22/2019,10000,UAahHjGp,55000,more than downpayment,more than downpayment,0,4500
UAahHjGp,4500,8/21/2019,10000,UAahHjGp,59500,more than downpayment,more than downpayment,0,4500
UAahHjGp,1500,10/23/2019,10000,UAahHjGp,61000,more than downpayment,more than downpayment,0,1500
UAahHjGp,1500,12/2/2019,10000,UAahHjGp,62500,more than downpayment,more than downpayment,0,1500
UAahHjGp,500,12/3/2019,10000,UAahHjGp,63000,more than downpayment,more than downpayment,0,500
UAahHjGp,1000,12/11/2019,10000,UAahHjGp,64000,more than downpayment,more than downpayment,0,1000
UAT62G2Y,8900,11/12/2019,8900,,8900,equal to downpayment,,8900,0
UAT62G2Y,3900,1/17/2020,8900,UAT62G2Y,12800,more than downpayment,equal to downpayment,0,3900
UAWpgyAs,9900,11/5/2018,9900,,9900,equal to downpayment,,9900,0
UAWpgyAs,4500,11/28/2018,9900,UAWpgyAs,14400,more than downpayment,equal to downpayment,0,4500
UAWpgyAs,4500,12/23/2018,9900,UAWpgyAs,18900,more than downpayment,more than downpayment,0,4500
UAWpgyAs,9000,1/22/2019,9900,UAWpgyAs,27900,more than downpayment,more than downpayment,0,9000
UAWpgyAs,4500,2/21/2019,9900,UAWpgyAs,32400,more than downpayment,more than downpayment,0,4500
UAWpgyAs,4500,3/19/2019,9900,UAWpgyAs,36900,more than downpayment,more than downpayment,0,4500
UAWpgyAs,4500,4/20/2019,9900,UAWpgyAs,41400,more than downpayment,more than downpayment,0,4500
UAWpgyAs,4500,5/20/2019,9900,UAWpgyAs,45900,more than downpayment,more than downpayment,0,4500
UAWpgyAs,4500,6/21/2019,9900,UAWpgyAs,50400,more than downpayment,more than downpayment,0,4500
UAWpgyAs,4500,7/24/2019,9900,UAWpgyAs,54900,more than downpayment,more than downpayment,0,4500
UAWpgyAs,4500,8/22/2019,9900,UAWpgyAs,59400,more than downpayment,more than downpayment,0,4500
UAWpgyAs,4500,9/23/2019,9900,UAWpgyAs,63900,more than downpayment,more than downpayment,0,4500
UAWpgyAs,4500,10/23/2019,9900,UAWpgyAs,68400,more than downpayment,more than downpayment,0,4500
UAWpgyAs,4500,11/25/2019,9900,UAWpgyAs,72900,more than downpayment,more than downpayment,0,4500
UAWpgyAs,4500,12/23/2019,9900,UAWpgyAs,77400,more than downpayment,more than downpayment,0,4500
UbIAwyAn,10000,12/11/2018,10000,,10000,equal to downpayment,,10000,0
UbIAwyAn,4500,1/24/2019,10000,UbIAwyAn,14500,more than downpayment,equal to downpayment,0,4500
UbIAwyAn,4500,2/23/2019,10000,UbIAwyAn,19000,more than downpayment,more than downpayment,0,4500
UbIAwyAn,4500,3/25/2019,10000,UbIAwyAn,23500,more than downpayment,more than downpayment,0,4500
UbIAwyAn,4500,5/2/2019,10000,UbIAwyAn,28000,more than downpayment,more than downpayment,0,4500
UbIAwyAn,4500,5/27/2019,10000,UbIAwyAn,32500,more than downpayment,more than downpayment,0,4500
UbIAwyAn,4500,6/24/2019,10000,UbIAwyAn,37000,more than downpayment,more than downpayment,0,4500
UbIAwyAn,4500,7/26/2019,10000,UbIAwyAn,41500,more than downpayment,more than downpayment,0,4500
UbIAwyAn,4500,8/24/2019,10000,UbIAwyAn,46000,more than downpayment,more than downpayment,0,4500
UBmM6QyJ,2500,6/7/2019,8900,,2500,less than downpayment,,2500,0
UBmM6QyJ,1900,6/8/2019,8900,UBmM6QyJ,4400,less than downpayment,less than downpayment,1900,0
UBmM6QyJ,5500,6/10/2019,8900,UBmM6QyJ,9900,more than downpayment,less than downpayment,4500,1000
UBmM6QyJ,3900,8/2/2019,8900,UBmM6QyJ,13800,more than downpayment,more than downpayment,0,3900
UBmM6QyJ,700,9/3/2019,8900,UBmM6QyJ,14500,more than downpayment,more than downpayment,0,700
UBmM6QyJ,3000,9/4/2019,8900,UBmM6QyJ,17500,more than downpayment,more than downpayment,0,3000
UBmM6QyJ,500,10/3/2019,8900,UBmM6QyJ,18000,more than downpayment,more than downpayment,0,500
UBmM6QyJ,2800,10/7/2019,8900,UBmM6QyJ,20800,more than downpayment,more than downpayment,0,2800
UBmM6QyJ,1000,10/11/2019,8900,UBmM6QyJ,21800,more than downpayment,more than downpayment,0,1000
UBmM6QyJ,3500,11/12/2019,8900,UBmM6QyJ,25300,more than downpayment,more than downpayment,0,3500
UBmM6QyJ,400,12/1/2019,8900,UBmM6QyJ,25700,more than downpayment,more than downpayment,0,400
UBmM6QyJ,800,12/20/2019,8900,UBmM6QyJ,26500,more than downpayment,more than downpayment,0,800
UBmM6QyJ,800,1/30/2020,8900,UBmM6QyJ,27300,more than downpayment,more than downpayment,0,800
uCAiH1kW,8900,4/18/2019,8900,,8900,equal to downpayment,,8900,0
uCAiH1kW,3900,5/24/2019,8900,uCAiH1kW,12800,more than downpayment,equal to downpayment,0,3900
uCAiH1kW,3900,6/26/2019,8900,uCAiH1kW,16700,more than downpayment,more than downpayment,0,3900
uCAiH1kW,3900,7/24/2019,8900,uCAiH1kW,20600,more than downpayment,more than downpayment,0,3900
uCAiH1kW,3900,8/27/2019,8900,uCAiH1kW,24500,more than downpayment,more than downpayment,0,3900
uCAiH1kW,3900,9/26/2019,8900,uCAiH1kW,28400,more than downpayment,more than downpayment,0,3900
uCAiH1kW,3900,10/25/2019,8900,uCAiH1kW,32300,more than downpayment,more than downpayment,0,3900
uCAiH1kW,3900,11/26/2019,8900,uCAiH1kW,36200,more than downpayment,more than downpayment,0,3900
uCAiH1kW,3900,12/25/2019,8900,uCAiH1kW,40100,more than downpayment,more than downpayment,0,3900
uCAiH1kW,3900,1/27/2020,8900,uCAiH1kW,44000,more than downpayment,more than downpayment,0,3900
UCT8HI9Q,8900,10/1/2019,8900,,8900,equal to downpayment,,8900,0
UCT8HI9Q,4000,11/4/2019,8900,UCT8HI9Q,12900,more than downpayment,equal to downpayment,0,4000
UCT8HI9Q,3900,12/4/2019,8900,UCT8HI9Q,16800,more than downpayment,more than downpayment,0,3900
UCT8HI9Q,3900,1/4/2020,8900,UCT8HI9Q,20700,more than downpayment,more than downpayment,0,3900
UCT8HI9Q,3900,2/4/2020,8900,UCT8HI9Q,24600,more than downpayment,more than downpayment,0,3900
UCV3YGOY,9900,12/23/2019,8900,,9900,more than downpayment,,8900,1000
ueIEWVUC,10000,2/4/2019,10000,,10000,equal to downpayment,,10000,0
ueIEWVUC,4500,2/5/2019,10000,ueIEWVUC,14500,more than downpayment,equal to downpayment,0,4500
ueIEWVUC,4500,3/15/2019,10000,ueIEWVUC,19000,more than downpayment,more than downpayment,0,4500
ueIEWVUC,4500,4/15/2019,10000,ueIEWVUC,23500,more than downpayment,more than downpayment,0,4500
ueIEWVUC,13500,5/15/2019,10000,ueIEWVUC,37000,more than downpayment,more than downpayment,0,13500
ueIEWVUC,4500,6/15/2019,10000,ueIEWVUC,41500,more than downpayment,more than downpayment,0,4500
ueIEWVUC,4500,7/15/2019,10000,ueIEWVUC,46000,more than downpayment,more than downpayment,0,4500
ueIEWVUC,4500,8/21/2019,10000,ueIEWVUC,50500,more than downpayment,more than downpayment,0,4500
ueIEWVUC,4500,1/15/2020,10000,ueIEWVUC,55000,more than downpayment,more than downpayment,0,4500
uEWtcPdO,10000,6/24/2019,10000,,10000,equal to downpayment,,10000,0
uEWtcPdO,4500,8/5/2019,10000,uEWtcPdO,14500,more than downpayment,equal to downpayment,0,4500
uEWtcPdO,4500,9/3/2019,10000,uEWtcPdO,19000,more than downpayment,more than downpayment,0,4500
uEWtcPdO,4500,10/7/2019,10000,uEWtcPdO,23500,more than downpayment,more than downpayment,0,4500
uEWtcPdO,4500,11/28/2019,10000,uEWtcPdO,28000,more than downpayment,more than downpayment,0,4500
uEWtcPdO,4500,12/5/2019,10000,uEWtcPdO,32500,more than downpayment,more than downpayment,0,4500
uEWtcPdO,4500,1/18/2020,10000,uEWtcPdO,37000,more than downpayment,more than downpayment,0,4500
uf6B7gTY,10000,3/29/2019,8900,,10000,more than downpayment,,8900,1100
uf6B7gTY,5000,5/3/2019,8900,uf6B7gTY,15000,more than downpayment,more than downpayment,0,5000
uf6B7gTY,5000,6/4/2019,8900,uf6B7gTY,20000,more than downpayment,more than downpayment,0,5000
uf6B7gTY,5000,7/6/2019,8900,uf6B7gTY,25000,more than downpayment,more than downpayment,0,5000
uf6B7gTY,5000,8/5/2019,8900,uf6B7gTY,30000,more than downpayment,more than downpayment,0,5000
uf6B7gTY,5000,9/4/2019,8900,uf6B7gTY,35000,more than downpayment,more than downpayment,0,5000
uf6B7gTY,4000,10/3/2019,8900,uf6B7gTY,39000,more than downpayment,more than downpayment,0,4000
uf6B7gTY,4000,11/7/2019,8900,uf6B7gTY,43000,more than downpayment,more than downpayment,0,4000
uf6B7gTY,4000,12/5/2019,8900,uf6B7gTY,47000,more than downpayment,more than downpayment,0,4000
uf6B7gTY,3900,1/9/2020,8900,uf6B7gTY,50900,more than downpayment,more than downpayment,0,3900
UhCejJVI,10000,9/29/2018,10000,,10000,equal to downpayment,,10000,0
UhCejJVI,4500,10/23/2018,10000,UhCejJVI,14500,more than downpayment,equal to downpayment,0,4500
UhCejJVI,4500,11/14/2018,10000,UhCejJVI,19000,more than downpayment,more than downpayment,0,4500
UhCejJVI,4500,12/21/2018,10000,UhCejJVI,23500,more than downpayment,more than downpayment,0,4500
UhCejJVI,4500,1/24/2019,10000,UhCejJVI,28000,more than downpayment,more than downpayment,0,4500
UhCejJVI,4500,2/23/2019,10000,UhCejJVI,32500,more than downpayment,more than downpayment,0,4500
UhCejJVI,4500,3/23/2019,10000,UhCejJVI,37000,more than downpayment,more than downpayment,0,4500
UhCejJVI,4500,4/25/2019,10000,UhCejJVI,41500,more than downpayment,more than downpayment,0,4500
UhCejJVI,4500,5/24/2019,10000,UhCejJVI,46000,more than downpayment,more than downpayment,0,4500
UhCejJVI,4500,6/25/2019,10000,UhCejJVI,50500,more than downpayment,more than downpayment,0,4500
UhCejJVI,4500,7/25/2019,10000,UhCejJVI,55000,more than downpayment,more than downpayment,0,4500
UhCejJVI,4500,10/4/2019,10000,UhCejJVI,59500,more than downpayment,more than downpayment,0,4500
UhCejJVI,4500,10/22/2019,10000,UhCejJVI,64000,more than downpayment,more than downpayment,0,4500
uhD1AvmN,9900,7/15/2019,9900,,9900,equal to downpayment,,9900,0
uhD1AvmN,3900,8/13/2019,9900,uhD1AvmN,13800,more than downpayment,equal to downpayment,0,3900
uhD1AvmN,3900,9/19/2019,9900,uhD1AvmN,17700,more than downpayment,more than downpayment,0,3900
uhD1AvmN,3900,10/14/2019,9900,uhD1AvmN,21600,more than downpayment,more than downpayment,0,3900
uhD1AvmN,3900,11/22/2019,9900,uhD1AvmN,25500,more than downpayment,more than downpayment,0,3900
uhD1AvmN,3900,12/17/2019,9900,uhD1AvmN,29400,more than downpayment,more than downpayment,0,3900
uhD1AvmN,3900,1/19/2020,9900,uhD1AvmN,33300,more than downpayment,more than downpayment,0,3900
UHFYriTK,10000,10/31/2018,10000,,10000,equal to downpayment,,10000,0
UHFYriTK,5000,11/26/2018,10000,UHFYriTK,15000,more than downpayment,equal to downpayment,0,5000
UHFYriTK,5000,1/1/2019,10000,UHFYriTK,20000,more than downpayment,more than downpayment,0,5000
UHFYriTK,5000,2/1/2019,10000,UHFYriTK,25000,more than downpayment,more than downpayment,0,5000
UHFYriTK,5000,3/15/2019,10000,UHFYriTK,30000,more than downpayment,more than downpayment,0,5000
UHFYriTK,5000,4/19/2019,10000,UHFYriTK,35000,more than downpayment,more than downpayment,0,5000
UHFYriTK,5000,5/23/2019,10000,UHFYriTK,40000,more than downpayment,more than downpayment,0,5000
UHFYriTK,2000,6/28/2019,10000,UHFYriTK,42000,more than downpayment,more than downpayment,0,2000
UHFYriTK,3000,7/3/2019,10000,UHFYriTK,45000,more than downpayment,more than downpayment,0,3000
UHFYriTK,2500,7/31/2019,10000,UHFYriTK,47500,more than downpayment,more than downpayment,0,2500
UHFYriTK,2500,8/4/2019,10000,UHFYriTK,50000,more than downpayment,more than downpayment,0,2500
UHFYriTK,500,8/29/2019,10000,UHFYriTK,50500,more than downpayment,more than downpayment,0,500
UHFYriTK,5000,10/11/2019,10000,UHFYriTK,55500,more than downpayment,more than downpayment,0,5000
UHFYriTK,2000,10/30/2019,10000,UHFYriTK,57500,more than downpayment,more than downpayment,0,2000
UHFYriTK,3000,11/30/2019,10000,UHFYriTK,60500,more than downpayment,more than downpayment,0,3000
UHFYriTK,3000,12/23/2019,10000,UHFYriTK,63500,more than downpayment,more than downpayment,0,3000
UHFYriTK,500,1/15/2020,10000,UHFYriTK,64000,more than downpayment,more than downpayment,0,500
uHlCOr1I,9900,1/11/2019,8900,,9900,more than downpayment,,8900,1000
uHlCOr1I,3450,3/11/2019,8900,uHlCOr1I,13350,more than downpayment,more than downpayment,0,3450
uHlCOr1I,5000,6/13/2019,8900,uHlCOr1I,18350,more than downpayment,more than downpayment,0,5000
uHlCOr1I,1780,6/17/2019,8900,uHlCOr1I,20130,more than downpayment,more than downpayment,0,1780
uHlCOr1I,4370,6/19/2019,8900,uHlCOr1I,24500,more than downpayment,more than downpayment,0,4370
uHlCOr1I,7100,8/31/2019,8900,uHlCOr1I,31600,more than downpayment,more than downpayment,0,7100
uHlCOr1I,1000,9/2/2019,8900,uHlCOr1I,32600,more than downpayment,more than downpayment,0,1000
UIELEKOY,10000,2/9/2020,9900,,10000,more than downpayment,,9900,100
UIHLUKB1,9900,12/30/2019,9900,,9900,equal to downpayment,,9900,0
UiiQ18qV,8900,3/25/2019,8900,,8900,equal to downpayment,,8900,0
UiiQ18qV,7800,4/24/2019,8900,UiiQ18qV,16700,more than downpayment,equal to downpayment,0,7800
UiiQ18qV,3900,5/24/2019,8900,UiiQ18qV,20600,more than downpayment,more than downpayment,0,3900
UiiQ18qV,3900,6/26/2019,8900,UiiQ18qV,24500,more than downpayment,more than downpayment,0,3900
UiiQ18qV,3900,7/25/2019,8900,UiiQ18qV,28400,more than downpayment,more than downpayment,0,3900
UiiQ18qV,3900,8/26/2019,8900,UiiQ18qV,32300,more than downpayment,more than downpayment,0,3900
UiiQ18qV,3900,9/27/2019,8900,UiiQ18qV,36200,more than downpayment,more than downpayment,0,3900
UiiQ18qV,3900,10/25/2019,8900,UiiQ18qV,40100,more than downpayment,more than downpayment,0,3900
UiiQ18qV,3900,12/27/2019,8900,UiiQ18qV,44000,more than downpayment,more than downpayment,0,3900
UiiQ18qV,3900,1/1/2020,8900,UiiQ18qV,47900,more than downpayment,more than downpayment,0,3900
UiiQ18qV,3900,2/4/2020,8900,UiiQ18qV,51800,more than downpayment,more than downpayment,0,3900
uijAM0eH,8900,2/18/2019,8900,,8900,equal to downpayment,,8900,0
uijAM0eH,3900,4/9/2019,8900,uijAM0eH,12800,more than downpayment,equal to downpayment,0,3900
uijAM0eH,3900,5/6/2019,8900,uijAM0eH,16700,more than downpayment,more than downpayment,0,3900
uijAM0eH,3900,8/1/2019,8900,uijAM0eH,20600,more than downpayment,more than downpayment,0,3900
uijAM0eH,11700,8/26/2019,8900,uijAM0eH,32300,more than downpayment,more than downpayment,0,11700
uijAM0eH,15600,12/18/2019,8900,uijAM0eH,47900,more than downpayment,more than downpayment,0,15600
uijAM0eH,7800,2/7/2020,8900,uijAM0eH,55700,more than downpayment,more than downpayment,0,7800
UIJKPCNW,9900,12/13/2019,9900,,9900,equal to downpayment,,9900,0
UjhWD8Ue,9900,8/1/2019,9900,,9900,equal to downpayment,,9900,0
UjhWD8Ue,4000,9/4/2019,9900,UjhWD8Ue,13900,more than downpayment,equal to downpayment,0,4000
UjhWD8Ue,3900,10/4/2019,9900,UjhWD8Ue,17800,more than downpayment,more than downpayment,0,3900
UjhWD8Ue,3900,11/2/2019,9900,UjhWD8Ue,21700,more than downpayment,more than downpayment,0,3900
UjhWD8Ue,4000,12/3/2019,9900,UjhWD8Ue,25700,more than downpayment,more than downpayment,0,4000
UjhWD8Ue,4000,1/4/2020,9900,UjhWD8Ue,29700,more than downpayment,more than downpayment,0,4000
UjhWD8Ue,4000,2/3/2020,9900,UjhWD8Ue,33700,more than downpayment,more than downpayment,0,4000
Ujr9bqw9,8900,1/30/2019,8900,,8900,equal to downpayment,,8900,0
Ujr9bqw9,3990,3/4/2019,8900,Ujr9bqw9,12890,more than downpayment,equal to downpayment,0,3990
Ujr9bqw9,3900,4/4/2019,8900,Ujr9bqw9,16790,more than downpayment,more than downpayment,0,3900
Ujr9bqw9,3900,5/6/2019,8900,Ujr9bqw9,20690,more than downpayment,more than downpayment,0,3900
Ujr9bqw9,3900,6/4/2019,8900,Ujr9bqw9,24590,more than downpayment,more than downpayment,0,3900
Ujr9bqw9,3900,7/3/2019,8900,Ujr9bqw9,28490,more than downpayment,more than downpayment,0,3900
Ujr9bqw9,3900,8/6/2019,8900,Ujr9bqw9,32390,more than downpayment,more than downpayment,0,3900
Ujr9bqw9,3900,9/7/2019,8900,Ujr9bqw9,36290,more than downpayment,more than downpayment,0,3900
Ujr9bqw9,3900,10/15/2019,8900,Ujr9bqw9,40190,more than downpayment,more than downpayment,0,3900
Ujr9bqw9,3900,11/6/2019,8900,Ujr9bqw9,44090,more than downpayment,more than downpayment,0,3900
Ujr9bqw9,3900,12/6/2019,8900,Ujr9bqw9,47990,more than downpayment,more than downpayment,0,3900
Ujr9bqw9,3900,1/23/2020,8900,Ujr9bqw9,51890,more than downpayment,more than downpayment,0,3900
Ujr9bqw9,3900,2/6/2020,8900,Ujr9bqw9,55790,more than downpayment,more than downpayment,0,3900
Ujv0iSN1,9900,11/13/2018,9900,,9900,equal to downpayment,,9900,0
Ujv0iSN1,10000,11/26/2018,9900,Ujv0iSN1,19900,more than downpayment,equal to downpayment,0,10000
Ujv0iSN1,4500,1/6/2019,9900,Ujv0iSN1,24400,more than downpayment,more than downpayment,0,4500
Ujv0iSN1,5000,1/29/2019,9900,Ujv0iSN1,29400,more than downpayment,more than downpayment,0,5000
Ujv0iSN1,10000,3/20/2019,9900,Ujv0iSN1,39400,more than downpayment,more than downpayment,0,10000
Ujv0iSN1,5000,6/20/2019,9900,Ujv0iSN1,44400,more than downpayment,more than downpayment,0,5000
Ujv0iSN1,5000,7/24/2019,9900,Ujv0iSN1,49400,more than downpayment,more than downpayment,0,5000
Ujv0iSN1,3000,7/25/2019,9900,Ujv0iSN1,52400,more than downpayment,more than downpayment,0,3000
Ujv0iSN1,4500,8/22/2019,9900,Ujv0iSN1,56900,more than downpayment,more than downpayment,0,4500
Ujv0iSN1,4500,10/1/2019,9900,Ujv0iSN1,61400,more than downpayment,more than downpayment,0,4500
Ujv0iSN1,4000,11/25/2019,9900,Ujv0iSN1,65400,more than downpayment,more than downpayment,0,4000
Ujv0iSN1,3000,12/31/2019,9900,Ujv0iSN1,68400,more than downpayment,more than downpayment,0,3000
Ujv0iSN1,4500,1/31/2020,9900,Ujv0iSN1,72900,more than downpayment,more than downpayment,0,4500
ukbIqviC,10500,8/24/2017,10000,,10500,more than downpayment,,10000,500
ukbIqviC,1000,11/6/2017,10000,ukbIqviC,11500,more than downpayment,more than downpayment,0,1000
ukbIqviC,2000,1/29/2018,10000,ukbIqviC,13500,more than downpayment,more than downpayment,0,2000
ukbIqviC,1000,3/2/2018,10000,ukbIqviC,14500,more than downpayment,more than downpayment,0,1000
ukbIqviC,2000,5/22/2018,10000,ukbIqviC,16500,more than downpayment,more than downpayment,0,2000
ukbIqviC,1000,7/18/2018,10000,ukbIqviC,17500,more than downpayment,more than downpayment,0,1000
ukbIqviC,5000,11/2/2018,10000,ukbIqviC,22500,more than downpayment,more than downpayment,0,5000
ukbIqviC,5000,4/23/2019,10000,ukbIqviC,27500,more than downpayment,more than downpayment,0,5000
ukbIqviC,1000,6/7/2019,10000,ukbIqviC,28500,more than downpayment,more than downpayment,0,1000
ukbIqviC,1000,12/12/2019,10000,ukbIqviC,29500,more than downpayment,more than downpayment,0,1000
UL87OX13,8900,9/10/2019,8900,,8900,equal to downpayment,,8900,0
UL87OX13,4000,11/6/2019,8900,UL87OX13,12900,more than downpayment,equal to downpayment,0,4000
UL87OX13,4000,11/16/2019,8900,UL87OX13,16900,more than downpayment,more than downpayment,0,4000
UL87OX13,4000,12/24/2019,8900,UL87OX13,20900,more than downpayment,more than downpayment,0,4000
UL87OX13,4000,1/16/2020,8900,UL87OX13,24900,more than downpayment,more than downpayment,0,4000
UL8BdG8n,8900,1/22/2019,8900,,8900,equal to downpayment,,8900,0
UL8BdG8n,3900,3/14/2019,8900,UL8BdG8n,12800,more than downpayment,equal to downpayment,0,3900
UL8BdG8n,3700,4/16/2019,8900,UL8BdG8n,16500,more than downpayment,more than downpayment,0,3700
UL8BdG8n,200,4/17/2019,8900,UL8BdG8n,16700,more than downpayment,more than downpayment,0,200
UL8BdG8n,5700,8/2/2019,8900,UL8BdG8n,22400,more than downpayment,more than downpayment,0,5700
UL8BdG8n,6000,8/8/2019,8900,UL8BdG8n,28400,more than downpayment,more than downpayment,0,6000
UL8BdG8n,10000,1/31/2020,8900,UL8BdG8n,38400,more than downpayment,more than downpayment,0,10000
UMLOGKW8,9900,12/6/2019,9900,,9900,equal to downpayment,,9900,0
UMLOGKW8,5000,2/5/2020,9900,UMLOGKW8,14900,more than downpayment,equal to downpayment,0,5000
UMWXBVQF,9900,1/20/2020,9900,,9900,equal to downpayment,,9900,0
UMWYQD5I,8900,9/23/2019,8900,,8900,equal to downpayment,,8900,0
UMWYQD5I,3900,11/5/2019,8900,UMWYQD5I,12800,more than downpayment,equal to downpayment,0,3900
UMWYQD5I,3900,12/2/2019,8900,UMWYQD5I,16700,more than downpayment,more than downpayment,0,3900
UMWYQD5I,3900,12/25/2019,8900,UMWYQD5I,20600,more than downpayment,more than downpayment,0,3900
UMWYQD5I,3900,2/3/2020,8900,UMWYQD5I,24500,more than downpayment,more than downpayment,0,3900
UOCuj2Q2,8900,4/15/2019,8900,,8900,equal to downpayment,,8900,0
UOCuj2Q2,3900,5/29/2019,8900,UOCuj2Q2,12800,more than downpayment,equal to downpayment,0,3900
UOCuj2Q2,3900,7/1/2019,8900,UOCuj2Q2,16700,more than downpayment,more than downpayment,0,3900
UOCuj2Q2,3900,7/24/2019,8900,UOCuj2Q2,20600,more than downpayment,more than downpayment,0,3900
UOCuj2Q2,3900,8/26/2019,8900,UOCuj2Q2,24500,more than downpayment,more than downpayment,0,3900
UOCuj2Q2,3900,9/28/2019,8900,UOCuj2Q2,28400,more than downpayment,more than downpayment,0,3900
UOCuj2Q2,3900,10/30/2019,8900,UOCuj2Q2,32300,more than downpayment,more than downpayment,0,3900
UOCuj2Q2,3900,11/29/2019,8900,UOCuj2Q2,36200,more than downpayment,more than downpayment,0,3900
UOCuj2Q2,4000,12/27/2019,8900,UOCuj2Q2,40200,more than downpayment,more than downpayment,0,4000
uOHJuOtw,10000,7/12/2017,10000,,10000,equal to downpayment,,10000,0
uOHJuOtw,4000,8/25/2017,10000,uOHJuOtw,14000,more than downpayment,equal to downpayment,0,4000
uOHJuOtw,4000,10/6/2017,10000,uOHJuOtw,18000,more than downpayment,more than downpayment,0,4000
uOHJuOtw,4000,11/19/2017,10000,uOHJuOtw,22000,more than downpayment,more than downpayment,0,4000
uOHJuOtw,4000,1/15/2018,10000,uOHJuOtw,26000,more than downpayment,more than downpayment,0,4000
uOHJuOtw,5000,2/19/2018,10000,uOHJuOtw,31000,more than downpayment,more than downpayment,0,5000
uOHJuOtw,4000,4/3/2018,10000,uOHJuOtw,35000,more than downpayment,more than downpayment,0,4000
uOHJuOtw,5000,7/25/2018,10000,uOHJuOtw,40000,more than downpayment,more than downpayment,0,5000
uOHJuOtw,1000,10/8/2018,10000,uOHJuOtw,41000,more than downpayment,more than downpayment,0,1000
uoIWZ927,8900,11/24/2018,8900,,8900,equal to downpayment,,8900,0
uoIWZ927,3900,12/26/2018,8900,uoIWZ927,12800,more than downpayment,equal to downpayment,0,3900
uoIWZ927,3900,1/22/2019,8900,uoIWZ927,16700,more than downpayment,more than downpayment,0,3900
uoIWZ927,3900,2/24/2019,8900,uoIWZ927,20600,more than downpayment,more than downpayment,0,3900
uoIWZ927,4000,3/19/2019,8900,uoIWZ927,24600,more than downpayment,more than downpayment,0,4000
uoIWZ927,3900,4/21/2019,8900,uoIWZ927,28500,more than downpayment,more than downpayment,0,3900
uoIWZ927,1800,5/22/2019,8900,uoIWZ927,30300,more than downpayment,more than downpayment,0,1800
uoIWZ927,2700,5/23/2019,8900,uoIWZ927,33000,more than downpayment,more than downpayment,0,2700
uoIWZ927,3500,6/26/2019,8900,uoIWZ927,36500,more than downpayment,more than downpayment,0,3500
uoIWZ927,3900,7/28/2019,8900,uoIWZ927,40400,more than downpayment,more than downpayment,0,3900
uoIWZ927,3900,8/27/2019,8900,uoIWZ927,44300,more than downpayment,more than downpayment,0,3900
uoIWZ927,3900,9/26/2019,8900,uoIWZ927,48200,more than downpayment,more than downpayment,0,3900
uoIWZ927,3170,10/25/2019,8900,uoIWZ927,51370,more than downpayment,more than downpayment,0,3170
uoIWZ927,430,10/28/2019,8900,uoIWZ927,51800,more than downpayment,more than downpayment,0,430
uoIWZ927,3900,11/21/2019,8900,uoIWZ927,55700,more than downpayment,more than downpayment,0,3900
uoIWZ927,3900,12/25/2019,8900,uoIWZ927,59600,more than downpayment,more than downpayment,0,3900
uoIWZ927,3900,1/22/2020,8900,uoIWZ927,63500,more than downpayment,more than downpayment,0,3900
uOL0gBj1,10000,3/18/2019,10000,,10000,equal to downpayment,,10000,0
uOL0gBj1,4500,4/15/2019,10000,uOL0gBj1,14500,more than downpayment,equal to downpayment,0,4500
uOL0gBj1,4500,5/16/2019,10000,uOL0gBj1,19000,more than downpayment,more than downpayment,0,4500
uOL0gBj1,4500,6/17/2019,10000,uOL0gBj1,23500,more than downpayment,more than downpayment,0,4500
uOL0gBj1,4500,7/29/2019,10000,uOL0gBj1,28000,more than downpayment,more than downpayment,0,4500
uOL0gBj1,4500,8/15/2019,10000,uOL0gBj1,32500,more than downpayment,more than downpayment,0,4500
uOL0gBj1,4500,10/3/2019,10000,uOL0gBj1,37000,more than downpayment,more than downpayment,0,4500
uOL0gBj1,4500,10/31/2019,10000,uOL0gBj1,41500,more than downpayment,more than downpayment,0,4500
uOL0gBj1,4500,12/9/2019,10000,uOL0gBj1,46000,more than downpayment,more than downpayment,0,4500
uOL0gBj1,4500,1/3/2020,10000,uOL0gBj1,50500,more than downpayment,more than downpayment,0,4500
uOL0gBj1,4500,1/29/2020,10000,uOL0gBj1,55000,more than downpayment,more than downpayment,0,4500
uOsIxCwg,20000,5/18/2019,8900,,20000,more than downpayment,,8900,11100
uOsIxCwg,10000,8/20/2019,8900,uOsIxCwg,30000,more than downpayment,more than downpayment,0,10000
uOsIxCwg,7800,9/25/2019,8900,uOsIxCwg,37800,more than downpayment,more than downpayment,0,7800
uOsIxCwg,7800,2/1/2020,8900,uOsIxCwg,45600,more than downpayment,more than downpayment,0,7800
UOuer2ty,8900,4/11/2019,8900,,8900,equal to downpayment,,8900,0
UOuer2ty,3900,5/13/2019,8900,UOuer2ty,12800,more than downpayment,equal to downpayment,0,3900
UOuer2ty,3900,6/19/2019,8900,UOuer2ty,16700,more than downpayment,more than downpayment,0,3900
UOuer2ty,4000,8/9/2019,8900,UOuer2ty,20700,more than downpayment,more than downpayment,0,4000
UOuer2ty,3900,8/24/2019,8900,UOuer2ty,24600,more than downpayment,more than downpayment,0,3900
UOuer2ty,3900,9/25/2019,8900,UOuer2ty,28500,more than downpayment,more than downpayment,0,3900
UOuer2ty,3900,10/26/2019,8900,UOuer2ty,32400,more than downpayment,more than downpayment,0,3900
UOuer2ty,3900,12/11/2019,8900,UOuer2ty,36300,more than downpayment,more than downpayment,0,3900
upthD5vG,10000,1/10/2018,10000,,10000,equal to downpayment,,10000,0
upthD5vG,4500,3/9/2018,10000,upthD5vG,14500,more than downpayment,equal to downpayment,0,4500
upthD5vG,4500,4/11/2018,10000,upthD5vG,19000,more than downpayment,more than downpayment,0,4500
upthD5vG,4500,5/15/2018,10000,upthD5vG,23500,more than downpayment,more than downpayment,0,4500
upthD5vG,10000,7/19/2018,10000,upthD5vG,33500,more than downpayment,more than downpayment,0,10000
upthD5vG,4500,8/20/2018,10000,upthD5vG,38000,more than downpayment,more than downpayment,0,4500
upthD5vG,4500,10/13/2018,10000,upthD5vG,42500,more than downpayment,more than downpayment,0,4500
upthD5vG,4500,10/29/2018,10000,upthD5vG,47000,more than downpayment,more than downpayment,0,4500
upthD5vG,5000,11/19/2018,10000,upthD5vG,52000,more than downpayment,more than downpayment,0,5000
upthD5vG,3000,1/31/2019,10000,upthD5vG,55000,more than downpayment,more than downpayment,0,3000
upthD5vG,3000,3/25/2019,10000,upthD5vG,58000,more than downpayment,more than downpayment,0,3000
upthD5vG,1500,5/20/2019,10000,upthD5vG,59500,more than downpayment,more than downpayment,0,1500
upthD5vG,2000,1/13/2020,10000,upthD5vG,61500,more than downpayment,more than downpayment,0,2000
UQFXGJJW,9900,2/5/2020,9900,,9900,equal to downpayment,,9900,0
uQnHOwpw,3900,5/31/2018,8900,,3900,less than downpayment,,3900,0
uQnHOwpw,8900,2/5/2019,8900,uQnHOwpw,12800,more than downpayment,less than downpayment,5000,3900
uQnHOwpw,3900,2/28/2019,8900,uQnHOwpw,16700,more than downpayment,more than downpayment,0,3900
uQnHOwpw,3900,4/1/2019,8900,uQnHOwpw,20600,more than downpayment,more than downpayment,0,3900
uQnHOwpw,1500,4/13/2019,8900,uQnHOwpw,22100,more than downpayment,more than downpayment,0,1500
uQnHOwpw,2400,4/30/2019,8900,uQnHOwpw,24500,more than downpayment,more than downpayment,0,2400
uQnHOwpw,1500,6/18/2019,8900,uQnHOwpw,26000,more than downpayment,more than downpayment,0,1500
uQnHOwpw,1000,6/25/2019,8900,uQnHOwpw,27000,more than downpayment,more than downpayment,0,1000
uQnHOwpw,1400,6/29/2019,8900,uQnHOwpw,28400,more than downpayment,more than downpayment,0,1400
uQnHOwpw,1000,7/12/2019,8900,uQnHOwpw,29400,more than downpayment,more than downpayment,0,1000
uQnHOwpw,2900,7/31/2019,8900,uQnHOwpw,32300,more than downpayment,more than downpayment,0,2900
uQnHOwpw,2000,8/16/2019,8900,uQnHOwpw,34300,more than downpayment,more than downpayment,0,2000
uQnHOwpw,1000,8/18/2019,8900,uQnHOwpw,35300,more than downpayment,more than downpayment,0,1000
uQnHOwpw,900,9/7/2019,8900,uQnHOwpw,36200,more than downpayment,more than downpayment,0,900
uQnHOwpw,3900,10/2/2019,8900,uQnHOwpw,40100,more than downpayment,more than downpayment,0,3900
uQnHOwpw,3900,11/2/2019,8900,uQnHOwpw,44000,more than downpayment,more than downpayment,0,3900
uQnHOwpw,3900,12/9/2019,8900,uQnHOwpw,47900,more than downpayment,more than downpayment,0,3900
uQnHOwpw,3900,1/2/2020,8900,uQnHOwpw,51800,more than downpayment,more than downpayment,0,3900
uQnHOwpw,5000,2/2/2020,8900,uQnHOwpw,56800,more than downpayment,more than downpayment,0,5000
Uqsr551e,9000,2/7/2019,8900,,9000,more than downpayment,,8900,100
Uqsr551e,4000,3/30/2019,8900,Uqsr551e,13000,more than downpayment,more than downpayment,0,4000
Uqsr551e,3900,5/4/2019,8900,Uqsr551e,16900,more than downpayment,more than downpayment,0,3900
Uqsr551e,4000,5/31/2019,8900,Uqsr551e,20900,more than downpayment,more than downpayment,0,4000
Uqsr551e,3900,7/1/2019,8900,Uqsr551e,24800,more than downpayment,more than downpayment,0,3900
Uqsr551e,4000,7/29/2019,8900,Uqsr551e,28800,more than downpayment,more than downpayment,0,4000
Uqsr551e,4000,8/27/2019,8900,Uqsr551e,32800,more than downpayment,more than downpayment,0,4000
Uqsr551e,4000,10/2/2019,8900,Uqsr551e,36800,more than downpayment,more than downpayment,0,4000
Uqsr551e,4000,10/29/2019,8900,Uqsr551e,40800,more than downpayment,more than downpayment,0,4000
Uqsr551e,4000,11/25/2019,8900,Uqsr551e,44800,more than downpayment,more than downpayment,0,4000
Uqsr551e,3900,1/24/2020,8900,Uqsr551e,48700,more than downpayment,more than downpayment,0,3900
urceofId,2500,7/30/2019,9900,,2500,less than downpayment,,2500,0
urceofId,8900,8/9/2019,9900,urceofId,11400,more than downpayment,less than downpayment,7400,1500
URK6SY8H,8900,11/15/2019,8900,,8900,equal to downpayment,,8900,0
URK6SY8H,3900,1/28/2020,8900,URK6SY8H,12800,more than downpayment,equal to downpayment,0,3900
URK7BH1K,8900,2/6/2020,8900,,8900,equal to downpayment,,8900,0
usAKf46d,10000,8/30/2019,9900,,10000,more than downpayment,,9900,100
usAKf46d,3900,11/4/2019,9900,usAKf46d,13900,more than downpayment,more than downpayment,0,3900
usAKf46d,3900,12/4/2019,9900,usAKf46d,17800,more than downpayment,more than downpayment,0,3900
usAKf46d,3900,12/26/2019,9900,usAKf46d,21700,more than downpayment,more than downpayment,0,3900
usAKf46d,3900,1/4/2020,9900,usAKf46d,25600,more than downpayment,more than downpayment,0,3900
usAKf46d,3900,2/4/2020,9900,usAKf46d,29500,more than downpayment,more than downpayment,0,3900
usTCIhhJ,10000,6/30/2017,10000,,10000,equal to downpayment,,10000,0
usTCIhhJ,3500,8/3/2017,10000,usTCIhhJ,13500,more than downpayment,equal to downpayment,0,3500
usTCIhhJ,7000,11/2/2017,10000,usTCIhhJ,20500,more than downpayment,more than downpayment,0,7000
usTCIhhJ,10500,1/22/2018,10000,usTCIhhJ,31000,more than downpayment,more than downpayment,0,10500
usTCIhhJ,14000,4/3/2018,10000,usTCIhhJ,45000,more than downpayment,more than downpayment,0,14000
USYWU25D,9900,6/10/2019,9900,,9900,equal to downpayment,,9900,0
USYWU25D,1500,7/30/2019,9900,USYWU25D,11400,more than downpayment,equal to downpayment,0,1500
USYWU25D,1500,7/31/2019,9900,USYWU25D,12900,more than downpayment,more than downpayment,0,1500
USYWU25D,900,8/4/2019,9900,USYWU25D,13800,more than downpayment,more than downpayment,0,900
USYWU25D,1500,8/21/2019,9900,USYWU25D,15300,more than downpayment,more than downpayment,0,1500
USYWU25D,2400,9/2/2019,9900,USYWU25D,17700,more than downpayment,more than downpayment,0,2400
USYWU25D,3900,10/2/2019,9900,USYWU25D,21600,more than downpayment,more than downpayment,0,3900
Ut0HJ2aw,10000,7/12/2017,10000,,10000,equal to downpayment,,10000,0
Ut0HJ2aw,3000,11/24/2017,10000,Ut0HJ2aw,13000,more than downpayment,equal to downpayment,0,3000
Ut0HJ2aw,2000,2/21/2018,10000,Ut0HJ2aw,15000,more than downpayment,more than downpayment,0,2000
Ut0HJ2aw,1000,3/20/2018,10000,Ut0HJ2aw,16000,more than downpayment,more than downpayment,0,1000
Ut0HJ2aw,1000,6/2/2018,10000,Ut0HJ2aw,17000,more than downpayment,more than downpayment,0,1000
Ut0HJ2aw,1000,8/20/2018,10000,Ut0HJ2aw,18000,more than downpayment,more than downpayment,0,1000
Ut0HJ2aw,1000,10/22/2018,10000,Ut0HJ2aw,19000,more than downpayment,more than downpayment,0,1000
Ut0HJ2aw,1000,12/9/2018,10000,Ut0HJ2aw,20000,more than downpayment,more than downpayment,0,1000
Ut0HJ2aw,500,1/19/2019,10000,Ut0HJ2aw,20500,more than downpayment,more than downpayment,0,500
Ut0HJ2aw,1000,2/4/2019,10000,Ut0HJ2aw,21500,more than downpayment,more than downpayment,0,1000
Ut0HJ2aw,500,2/23/2019,10000,Ut0HJ2aw,22000,more than downpayment,more than downpayment,0,500
Ut0HJ2aw,500,5/15/2019,10000,Ut0HJ2aw,22500,more than downpayment,more than downpayment,0,500
UT1ZThAI,9000,2/21/2019,8900,,9000,more than downpayment,,8900,100
UT1ZThAI,3900,3/25/2019,8900,UT1ZThAI,12900,more than downpayment,more than downpayment,0,3900
UT1ZThAI,7800,4/25/2019,8900,UT1ZThAI,20700,more than downpayment,more than downpayment,0,7800
UT1ZThAI,7800,6/26/2019,8900,UT1ZThAI,28500,more than downpayment,more than downpayment,0,7800
UT1ZThAI,3900,8/31/2019,8900,UT1ZThAI,32400,more than downpayment,more than downpayment,0,3900
UT1ZThAI,3900,9/27/2019,8900,UT1ZThAI,36300,more than downpayment,more than downpayment,0,3900
UT1ZThAI,7800,11/4/2019,8900,UT1ZThAI,44100,more than downpayment,more than downpayment,0,7800
UT1ZThAI,3900,12/13/2019,8900,UT1ZThAI,48000,more than downpayment,more than downpayment,0,3900
UT1ZThAI,3900,1/6/2020,8900,UT1ZThAI,51900,more than downpayment,more than downpayment,0,3900
UT1ZThAI,3900,2/5/2020,8900,UT1ZThAI,55800,more than downpayment,more than downpayment,0,3900
UTKLT94R,16700,8/10/2019,8900,,16700,more than downpayment,,8900,7800
UTKLT94R,3900,11/11/2019,8900,UTKLT94R,20600,more than downpayment,more than downpayment,0,3900
UTKLT94R,3900,12/13/2019,8900,UTKLT94R,24500,more than downpayment,more than downpayment,0,3900
UTKLT94R,3900,1/21/2020,8900,UTKLT94R,28400,more than downpayment,more than downpayment,0,3900
UtO4lWuF,8900,8/26/2019,8900,,8900,equal to downpayment,,8900,0
UtO4lWuF,1900,10/28/2019,8900,UtO4lWuF,10800,more than downpayment,equal to downpayment,0,1900
UtO4lWuF,2000,11/4/2019,8900,UtO4lWuF,12800,more than downpayment,more than downpayment,0,2000
UtO4lWuF,1500,11/19/2019,8900,UtO4lWuF,14300,more than downpayment,more than downpayment,0,1500
UtO4lWuF,1500,12/3/2019,8900,UtO4lWuF,15800,more than downpayment,more than downpayment,0,1500
UtO4lWuF,2400,12/23/2019,8900,UtO4lWuF,18200,more than downpayment,more than downpayment,0,2400
UtO4lWuF,2400,1/6/2020,8900,UtO4lWuF,20600,more than downpayment,more than downpayment,0,2400
UtO4lWuF,3900,1/17/2020,8900,UtO4lWuF,24500,more than downpayment,more than downpayment,0,3900
UTr9OGwD,8900,4/15/2019,8900,,8900,equal to downpayment,,8900,0
UTr9OGwD,3900,5/31/2019,8900,UTr9OGwD,12800,more than downpayment,equal to downpayment,0,3900
UTr9OGwD,3900,7/5/2019,8900,UTr9OGwD,16700,more than downpayment,more than downpayment,0,3900
UTr9OGwD,3900,8/5/2019,8900,UTr9OGwD,20600,more than downpayment,more than downpayment,0,3900
UTr9OGwD,3900,9/5/2019,8900,UTr9OGwD,24500,more than downpayment,more than downpayment,0,3900
UTr9OGwD,3900,10/5/2019,8900,UTr9OGwD,28400,more than downpayment,more than downpayment,0,3900
UTr9OGwD,3900,11/6/2019,8900,UTr9OGwD,32300,more than downpayment,more than downpayment,0,3900
UTr9OGwD,4000,12/21/2019,8900,UTr9OGwD,36300,more than downpayment,more than downpayment,0,4000
UTr9OGwD,3800,1/7/2020,8900,UTr9OGwD,40100,more than downpayment,more than downpayment,0,3800
UtSZYnFj,10000,7/19/2018,10000,,10000,equal to downpayment,,10000,0
UtSZYnFj,10000,8/9/2018,10000,UtSZYnFj,20000,more than downpayment,equal to downpayment,0,10000
UtSZYnFj,4500,9/25/2018,10000,UtSZYnFj,24500,more than downpayment,more than downpayment,0,4500
UtSZYnFj,4500,10/28/2018,10000,UtSZYnFj,29000,more than downpayment,more than downpayment,0,4500
UtSZYnFj,4500,11/24/2018,10000,UtSZYnFj,33500,more than downpayment,more than downpayment,0,4500
UtSZYnFj,4500,1/7/2019,10000,UtSZYnFj,38000,more than downpayment,more than downpayment,0,4500
UtSZYnFj,4500,2/9/2019,10000,UtSZYnFj,42500,more than downpayment,more than downpayment,0,4500
UtSZYnFj,10500,3/1/2019,10000,UtSZYnFj,53000,more than downpayment,more than downpayment,0,10500
UtSZYnFj,4500,4/27/2019,10000,UtSZYnFj,57500,more than downpayment,more than downpayment,0,4500
UtSZYnFj,4500,6/6/2019,10000,UtSZYnFj,62000,more than downpayment,more than downpayment,0,4500
UtSZYnFj,5000,6/29/2019,10000,UtSZYnFj,67000,more than downpayment,more than downpayment,0,5000
UtSZYnFj,4500,7/25/2019,10000,UtSZYnFj,71500,more than downpayment,more than downpayment,0,4500
UtSZYnFj,2560,9/7/2019,10000,UtSZYnFj,74060,more than downpayment,more than downpayment,0,2560
UTTUUUOL,9900,12/19/2019,9900,,9900,equal to downpayment,,9900,0
UU87J9T6,9900,12/9/2019,9900,,9900,equal to downpayment,,9900,0
uuVJMbZU,10000,9/17/2017,10000,,10000,equal to downpayment,,10000,0
uuVJMbZU,5000,12/7/2017,10000,uuVJMbZU,15000,more than downpayment,equal to downpayment,0,5000
UUXLonrd,250,9/3/2019,9900,,250,less than downpayment,,250,0
UUXLonrd,2200,9/11/2019,9900,UUXLonrd,2450,less than downpayment,less than downpayment,2200,0
UUXLonrd,900,9/26/2019,9900,UUXLonrd,3350,less than downpayment,less than downpayment,900,0
UUXLonrd,650,10/6/2019,9900,UUXLonrd,4000,less than downpayment,less than downpayment,650,0
UUXLonrd,6000,10/7/2019,9900,UUXLonrd,10000,more than downpayment,less than downpayment,5900,100
UUXLonrd,3900,11/21/2019,9900,UUXLonrd,13900,more than downpayment,more than downpayment,0,3900
UUXLonrd,3900,12/21/2019,9900,UUXLonrd,17800,more than downpayment,more than downpayment,0,3900
UUXLonrd,3900,1/22/2020,9900,UUXLonrd,21700,more than downpayment,more than downpayment,0,3900
UUXQGDSM,6300,8/27/2019,8900,,6300,less than downpayment,,6300,0
UUXQGDSM,3700,8/30/2019,8900,UUXQGDSM,10000,more than downpayment,less than downpayment,2600,1100
UUXQGDSM,4000,12/12/2019,8900,UUXQGDSM,14000,more than downpayment,more than downpayment,0,4000
UUXQGDSM,3900,1/14/2020,8900,UUXQGDSM,17900,more than downpayment,more than downpayment,0,3900
uv0mDQqM,10000,6/12/2017,10000,,10000,equal to downpayment,,10000,0
uv0mDQqM,2500,11/25/2017,10000,uv0mDQqM,12500,more than downpayment,equal to downpayment,0,2500
uv0mDQqM,5000,1/24/2018,10000,uv0mDQqM,17500,more than downpayment,more than downpayment,0,5000
uv0mDQqM,2500,3/28/2018,10000,uv0mDQqM,20000,more than downpayment,more than downpayment,0,2500
uv0mDQqM,3500,5/30/2018,10000,uv0mDQqM,23500,more than downpayment,more than downpayment,0,3500
uv0mDQqM,2500,6/30/2018,10000,uv0mDQqM,26000,more than downpayment,more than downpayment,0,2500
uv0mDQqM,2500,8/1/2018,10000,uv0mDQqM,28500,more than downpayment,more than downpayment,0,2500
uv0mDQqM,2500,9/28/2018,10000,uv0mDQqM,31000,more than downpayment,more than downpayment,0,2500
uv0mDQqM,3000,1/28/2019,10000,uv0mDQqM,34000,more than downpayment,more than downpayment,0,3000
uv0mDQqM,3500,3/15/2019,10000,uv0mDQqM,37500,more than downpayment,more than downpayment,0,3500
uv0mDQqM,2500,4/26/2019,10000,uv0mDQqM,40000,more than downpayment,more than downpayment,0,2500
UV3TKU4Q,9900,10/25/2019,9900,,9900,equal to downpayment,,9900,0
UV3TKU4Q,4000,2/9/2020,9900,UV3TKU4Q,13900,more than downpayment,equal to downpayment,0,4000
uv6zLMzB,10000,7/8/2017,10000,,10000,equal to downpayment,,10000,0
uv6zLMzB,3500,9/27/2017,10000,uv6zLMzB,13500,more than downpayment,equal to downpayment,0,3500
uv6zLMzB,3500,10/25/2017,10000,uv6zLMzB,17000,more than downpayment,more than downpayment,0,3500
uv6zLMzB,3500,11/25/2017,10000,uv6zLMzB,20500,more than downpayment,more than downpayment,0,3500
uv6zLMzB,3500,1/24/2018,10000,uv6zLMzB,24000,more than downpayment,more than downpayment,0,3500
uv6zLMzB,3500,2/23/2018,10000,uv6zLMzB,27500,more than downpayment,more than downpayment,0,3500
uv6zLMzB,3500,3/25/2018,10000,uv6zLMzB,31000,more than downpayment,more than downpayment,0,3500
uv6zLMzB,3500,4/25/2018,10000,uv6zLMzB,34500,more than downpayment,more than downpayment,0,3500
uv6zLMzB,3500,5/27/2018,10000,uv6zLMzB,38000,more than downpayment,more than downpayment,0,3500
uv6zLMzB,3500,6/23/2018,10000,uv6zLMzB,41500,more than downpayment,more than downpayment,0,3500
uv6zLMzB,3500,7/27/2018,10000,uv6zLMzB,45000,more than downpayment,more than downpayment,0,3500
uv6zLMzB,3500,8/27/2018,10000,uv6zLMzB,48500,more than downpayment,more than downpayment,0,3500
uv6zLMzB,3500,9/26/2018,10000,uv6zLMzB,52000,more than downpayment,more than downpayment,0,3500
UvDOo5Ov,10000,10/11/2018,10000,,10000,equal to downpayment,,10000,0
UvDOo5Ov,10000,12/2/2018,10000,UvDOo5Ov,20000,more than downpayment,equal to downpayment,0,10000
UvDOo5Ov,5000,12/27/2018,10000,UvDOo5Ov,25000,more than downpayment,more than downpayment,0,5000
UvDOo5Ov,5000,1/28/2019,10000,UvDOo5Ov,30000,more than downpayment,more than downpayment,0,5000
UvDOo5Ov,5000,3/4/2019,10000,UvDOo5Ov,35000,more than downpayment,more than downpayment,0,5000
UvDOo5Ov,5000,3/23/2019,10000,UvDOo5Ov,40000,more than downpayment,more than downpayment,0,5000
UvDOo5Ov,5000,4/29/2019,10000,UvDOo5Ov,45000,more than downpayment,more than downpayment,0,5000
UvDOo5Ov,5000,5/31/2019,10000,UvDOo5Ov,50000,more than downpayment,more than downpayment,0,5000
UvDOo5Ov,8000,6/20/2019,10000,UvDOo5Ov,58000,more than downpayment,more than downpayment,0,8000
UVDX1PBB,9900,12/16/2019,9900,,9900,equal to downpayment,,9900,0
UVDX1PBB,5000,1/16/2020,9900,UVDX1PBB,14900,more than downpayment,equal to downpayment,0,5000
UVXW47I4,8900,2/7/2020,8900,,8900,equal to downpayment,,8900,0
uw5h8n6R,9900,11/7/2018,9900,,9900,equal to downpayment,,9900,0
uw5h8n6R,4500,12/10/2018,9900,uw5h8n6R,14400,more than downpayment,equal to downpayment,0,4500
uw5h8n6R,4500,1/23/2019,9900,uw5h8n6R,18900,more than downpayment,more than downpayment,0,4500
uw5h8n6R,4500,2/15/2019,9900,uw5h8n6R,23400,more than downpayment,more than downpayment,0,4500
uw5h8n6R,4500,3/16/2019,9900,uw5h8n6R,27900,more than downpayment,more than downpayment,0,4500
uw5h8n6R,4500,4/16/2019,9900,uw5h8n6R,32400,more than downpayment,more than downpayment,0,4500
uw5h8n6R,500,8/7/2019,9900,uw5h8n6R,32900,more than downpayment,more than downpayment,0,500
uw5h8n6R,5000,10/3/2019,9900,uw5h8n6R,37900,more than downpayment,more than downpayment,0,5000
uw5h8n6R,5000,11/13/2019,9900,uw5h8n6R,42900,more than downpayment,more than downpayment,0,5000
uw5h8n6R,4500,11/25/2019,9900,uw5h8n6R,47400,more than downpayment,more than downpayment,0,4500
uw5h8n6R,4000,12/17/2019,9900,uw5h8n6R,51400,more than downpayment,more than downpayment,0,4000
uw5h8n6R,2500,1/19/2020,9900,uw5h8n6R,53900,more than downpayment,more than downpayment,0,2500
UWMF48uC,9900,10/11/2019,9900,,9900,equal to downpayment,,9900,0
UWMF48uC,3900,11/23/2019,9900,UWMF48uC,13800,more than downpayment,equal to downpayment,0,3900
UWMF48uC,3900,1/8/2020,9900,UWMF48uC,17700,more than downpayment,more than downpayment,0,3900
UWMF48uC,3900,2/8/2020,9900,UWMF48uC,21600,more than downpayment,more than downpayment,0,3900
UWXP9KAK,38000,11/22/2019,9900,,38000,more than downpayment,,9900,28100
uXBPRdYx,8900,4/8/2019,8900,,8900,equal to downpayment,,8900,0
uXBPRdYx,3900,5/22/2019,8900,uXBPRdYx,12800,more than downpayment,equal to downpayment,0,3900
uXBPRdYx,3900,6/3/2019,8900,uXBPRdYx,16700,more than downpayment,more than downpayment,0,3900
uXBPRdYx,3900,7/12/2019,8900,uXBPRdYx,20600,more than downpayment,more than downpayment,0,3900
uXBPRdYx,3900,8/19/2019,8900,uXBPRdYx,24500,more than downpayment,more than downpayment,0,3900
uXBPRdYx,3900,9/21/2019,8900,uXBPRdYx,28400,more than downpayment,more than downpayment,0,3900
uXBPRdYx,3900,10/29/2019,8900,uXBPRdYx,32300,more than downpayment,more than downpayment,0,3900
uXBPRdYx,3900,11/22/2019,8900,uXBPRdYx,36200,more than downpayment,more than downpayment,0,3900
uXBPRdYx,3900,12/28/2019,8900,uXBPRdYx,40100,more than downpayment,more than downpayment,0,3900
uXBPRdYx,3900,1/23/2020,8900,uXBPRdYx,44000,more than downpayment,more than downpayment,0,3900
UXgnhnG0,9900,7/31/2019,9900,,9900,equal to downpayment,,9900,0
UXgnhnG0,3900,8/30/2019,9900,UXgnhnG0,13800,more than downpayment,equal to downpayment,0,3900
UXgnhnG0,3900,10/9/2019,9900,UXgnhnG0,17700,more than downpayment,more than downpayment,0,3900
UXgnhnG0,3900,10/27/2019,9900,UXgnhnG0,21600,more than downpayment,more than downpayment,0,3900
UXgnhnG0,3900,12/9/2019,9900,UXgnhnG0,25500,more than downpayment,more than downpayment,0,3900
UXgnhnG0,3900,1/10/2020,9900,UXgnhnG0,29400,more than downpayment,more than downpayment,0,3900
UyhbimZN,8900,4/13/2019,8900,,8900,equal to downpayment,,8900,0
UyhbimZN,3900,5/6/2019,8900,UyhbimZN,12800,more than downpayment,equal to downpayment,0,3900
UyhbimZN,3900,6/11/2019,8900,UyhbimZN,16700,more than downpayment,more than downpayment,0,3900
UyhbimZN,3900,7/31/2019,8900,UyhbimZN,20600,more than downpayment,more than downpayment,0,3900
UyhbimZN,3900,9/4/2019,8900,UyhbimZN,24500,more than downpayment,more than downpayment,0,3900
UyhbimZN,3900,10/3/2019,8900,UyhbimZN,28400,more than downpayment,more than downpayment,0,3900
UyhbimZN,3900,10/31/2019,8900,UyhbimZN,32300,more than downpayment,more than downpayment,0,3900
UyhbimZN,3900,12/10/2019,8900,UyhbimZN,36200,more than downpayment,more than downpayment,0,3900
UyhbimZN,3900,12/27/2019,8900,UyhbimZN,40100,more than downpayment,more than downpayment,0,3900
UyhbimZN,3900,2/8/2020,8900,UyhbimZN,44000,more than downpayment,more than downpayment,0,3900
UYjRZ5MQ,9900,8/24/2019,9900,,9900,equal to downpayment,,9900,0
UYjRZ5MQ,4500,11/12/2019,9900,UYjRZ5MQ,14400,more than downpayment,equal to downpayment,0,4500
UYjRZ5MQ,6000,11/16/2019,9900,UYjRZ5MQ,20400,more than downpayment,more than downpayment,0,6000
UYVEHQER,9900,11/18/2019,9900,,9900,equal to downpayment,,9900,0
UYVEHQER,3900,11/19/2019,9900,UYVEHQER,13800,more than downpayment,equal to downpayment,0,3900
UYVEHQER,2500,1/15/2020,9900,UYVEHQER,16300,more than downpayment,more than downpayment,0,2500
UYVEHQER,1400,2/3/2020,9900,UYVEHQER,17700,more than downpayment,more than downpayment,0,1400
UYYE8E8O,9900,2/8/2020,9900,,9900,equal to downpayment,,9900,0
UZLC2VUB,800,11/22/2019,9900,,800,less than downpayment,,800,0
UZLC2VUB,200,11/25/2019,9900,UZLC2VUB,1000,less than downpayment,less than downpayment,200,0
UZVzxOVj,10000,7/24/2017,10000,,10000,equal to downpayment,,10000,0
UZVzxOVj,3500,9/8/2017,10000,UZVzxOVj,13500,more than downpayment,equal to downpayment,0,3500
UZVzxOVj,5000,1/12/2018,10000,UZVzxOVj,18500,more than downpayment,more than downpayment,0,5000
UZVzxOVj,5000,2/24/2018,10000,UZVzxOVj,23500,more than downpayment,more than downpayment,0,5000
UZVzxOVj,4000,3/1/2018,10000,UZVzxOVj,27500,more than downpayment,more than downpayment,0,4000
UZVzxOVj,7000,4/24/2018,10000,UZVzxOVj,34500,more than downpayment,more than downpayment,0,7000
UZVzxOVj,3000,3/29/2019,10000,UZVzxOVj,37500,more than downpayment,more than downpayment,0,3000
UZWAYEKU,9900,12/15/2019,9900,,9900,equal to downpayment,,9900,0
UZWAYEKU,4000,1/24/2020,9900,UZWAYEKU,13900,more than downpayment,equal to downpayment,0,4000
v05wFV5k,8900,4/23/2019,8900,,8900,equal to downpayment,,8900,0
v05wFV5k,3900,6/1/2019,8900,v05wFV5k,12800,more than downpayment,equal to downpayment,0,3900
v05wFV5k,3900,7/1/2019,8900,v05wFV5k,16700,more than downpayment,more than downpayment,0,3900
v05wFV5k,3900,8/1/2019,8900,v05wFV5k,20600,more than downpayment,more than downpayment,0,3900
v05wFV5k,3900,8/28/2019,8900,v05wFV5k,24500,more than downpayment,more than downpayment,0,3900
v05wFV5k,3900,9/30/2019,8900,v05wFV5k,28400,more than downpayment,more than downpayment,0,3900
v05wFV5k,3900,11/3/2019,8900,v05wFV5k,32300,more than downpayment,more than downpayment,0,3900
v05wFV5k,3900,11/25/2019,8900,v05wFV5k,36200,more than downpayment,more than downpayment,0,3900
v05wFV5k,3900,12/23/2019,8900,v05wFV5k,40100,more than downpayment,more than downpayment,0,3900
v05wFV5k,3900,1/29/2020,8900,v05wFV5k,44000,more than downpayment,more than downpayment,0,3900
V0VycQvd,9900,11/28/2018,9900,,9900,equal to downpayment,,9900,0
V0VycQvd,4500,1/2/2019,9900,V0VycQvd,14400,more than downpayment,equal to downpayment,0,4500
V0VycQvd,4300,2/27/2019,9900,V0VycQvd,18700,more than downpayment,more than downpayment,0,4300
V0VycQvd,200,3/5/2019,9900,V0VycQvd,18900,more than downpayment,more than downpayment,0,200
V0VycQvd,4500,4/1/2019,9900,V0VycQvd,23400,more than downpayment,more than downpayment,0,4500
V0VycQvd,2000,4/30/2019,9900,V0VycQvd,25400,more than downpayment,more than downpayment,0,2000
V0VycQvd,400,5/15/2019,9900,V0VycQvd,25800,more than downpayment,more than downpayment,0,400
V0VycQvd,6600,6/11/2019,9900,V0VycQvd,32400,more than downpayment,more than downpayment,0,6600
V0VycQvd,2000,7/3/2019,9900,V0VycQvd,34400,more than downpayment,more than downpayment,0,2000
V0VycQvd,1500,8/9/2019,9900,V0VycQvd,35900,more than downpayment,more than downpayment,0,1500
V0VycQvd,500,10/2/2019,9900,V0VycQvd,36400,more than downpayment,more than downpayment,0,500
V0VycQvd,200,10/3/2019,9900,V0VycQvd,36600,more than downpayment,more than downpayment,0,200
V0VycQvd,1000,12/3/2019,9900,V0VycQvd,37600,more than downpayment,more than downpayment,0,1000
V0VycQvd,1000,1/23/2020,9900,V0VycQvd,38600,more than downpayment,more than downpayment,0,1000
V1HWP3HH,8900,7/9/2019,8900,,8900,equal to downpayment,,8900,0
V1HWP3HH,3900,8/22/2019,8900,V1HWP3HH,12800,more than downpayment,equal to downpayment,0,3900
V1HWP3HH,3900,9/22/2019,8900,V1HWP3HH,16700,more than downpayment,more than downpayment,0,3900
V1HWP3HH,3900,10/21/2019,8900,V1HWP3HH,20600,more than downpayment,more than downpayment,0,3900
V1HWP3HH,3900,11/20/2019,8900,V1HWP3HH,24500,more than downpayment,more than downpayment,0,3900
V1HWP3HH,3900,12/23/2019,8900,V1HWP3HH,28400,more than downpayment,more than downpayment,0,3900
V1HWP3HH,3900,1/24/2020,8900,V1HWP3HH,32300,more than downpayment,more than downpayment,0,3900
V1oHVAma,10000,1/15/2019,10000,,10000,equal to downpayment,,10000,0
V1oHVAma,5000,2/6/2019,10000,V1oHVAma,15000,more than downpayment,equal to downpayment,0,5000
V1oHVAma,5000,3/7/2019,10000,V1oHVAma,20000,more than downpayment,more than downpayment,0,5000
V1oHVAma,5000,4/9/2019,10000,V1oHVAma,25000,more than downpayment,more than downpayment,0,5000
V1oHVAma,5000,5/10/2019,10000,V1oHVAma,30000,more than downpayment,more than downpayment,0,5000
V1oHVAma,5000,6/12/2019,10000,V1oHVAma,35000,more than downpayment,more than downpayment,0,5000
V1oHVAma,5000,7/6/2019,10000,V1oHVAma,40000,more than downpayment,more than downpayment,0,5000
V1oHVAma,5000,8/8/2019,10000,V1oHVAma,45000,more than downpayment,more than downpayment,0,5000
V1oHVAma,4500,9/12/2019,10000,V1oHVAma,49500,more than downpayment,more than downpayment,0,4500
V1oHVAma,4500,10/15/2019,10000,V1oHVAma,54000,more than downpayment,more than downpayment,0,4500
V1oHVAma,5000,12/4/2019,10000,V1oHVAma,59000,more than downpayment,more than downpayment,0,5000
V1oHVAma,1000,12/17/2019,10000,V1oHVAma,60000,more than downpayment,more than downpayment,0,1000
V1oHVAma,4000,1/7/2020,10000,V1oHVAma,64000,more than downpayment,more than downpayment,0,4000
V1U9JJUB,8900,2/4/2020,8900,,8900,equal to downpayment,,8900,0
V25B3DSG,9900,2/7/2020,9900,,9900,equal to downpayment,,9900,0
V2nVLfkK,9900,6/8/2019,9900,,9900,equal to downpayment,,9900,0
V2nVLfkK,3900,7/23/2019,9900,V2nVLfkK,13800,more than downpayment,equal to downpayment,0,3900
V2nVLfkK,3900,8/23/2019,9900,V2nVLfkK,17700,more than downpayment,more than downpayment,0,3900
V2nVLfkK,3900,9/26/2019,9900,V2nVLfkK,21600,more than downpayment,more than downpayment,0,3900
V2nVLfkK,3900,10/25/2019,9900,V2nVLfkK,25500,more than downpayment,more than downpayment,0,3900
V2nVLfkK,3000,11/25/2019,9900,V2nVLfkK,28500,more than downpayment,more than downpayment,0,3000
V2nVLfkK,3000,12/13/2019,9900,V2nVLfkK,31500,more than downpayment,more than downpayment,0,3000
V2nVLfkK,1500,12/24/2019,9900,V2nVLfkK,33000,more than downpayment,more than downpayment,0,1500
V2nVLfkK,4000,1/22/2020,9900,V2nVLfkK,37000,more than downpayment,more than downpayment,0,4000
V2nVLfkK,500,2/7/2020,9900,V2nVLfkK,37500,more than downpayment,more than downpayment,0,500
v3cVTsli,5000,5/27/2019,9900,,5000,less than downpayment,,5000,0
v3cVTsli,4900,6/10/2019,9900,v3cVTsli,9900,equal to downpayment,less than downpayment,4900,0
v3cVTsli,3900,9/4/2019,9900,v3cVTsli,13800,more than downpayment,equal to downpayment,0,3900
v3cVTsli,1000,10/1/2019,9900,v3cVTsli,14800,more than downpayment,more than downpayment,0,1000
v3cVTsli,450,10/6/2019,9900,v3cVTsli,15250,more than downpayment,more than downpayment,0,450
v3cVTsli,500,10/14/2019,9900,v3cVTsli,15750,more than downpayment,more than downpayment,0,500
v3cVTsli,290,10/21/2019,9900,v3cVTsli,16040,more than downpayment,more than downpayment,0,290
v3cVTsli,400,10/26/2019,9900,v3cVTsli,16440,more than downpayment,more than downpayment,0,400
v3cVTsli,2000,11/4/2019,9900,v3cVTsli,18440,more than downpayment,more than downpayment,0,2000
v3cVTsli,600,11/18/2019,9900,v3cVTsli,19040,more than downpayment,more than downpayment,0,600
v3cVTsli,7000,11/19/2019,9900,v3cVTsli,26040,more than downpayment,more than downpayment,0,7000
v3cVTsli,500,1/15/2020,9900,v3cVTsli,26540,more than downpayment,more than downpayment,0,500
v3cVTsli,1200,1/24/2020,9900,v3cVTsli,27740,more than downpayment,more than downpayment,0,1200
v3cVTsli,800,1/25/2020,9900,v3cVTsli,28540,more than downpayment,more than downpayment,0,800
V3ewDftb,9900,7/9/2019,9900,,9900,equal to downpayment,,9900,0
V3ewDftb,3900,8/3/2019,9900,V3ewDftb,13800,more than downpayment,equal to downpayment,0,3900
V3ewDftb,3900,8/31/2019,9900,V3ewDftb,17700,more than downpayment,more than downpayment,0,3900
V3ewDftb,3900,9/30/2019,9900,V3ewDftb,21600,more than downpayment,more than downpayment,0,3900
V3ewDftb,3900,10/29/2019,9900,V3ewDftb,25500,more than downpayment,more than downpayment,0,3900
V3ewDftb,3900,11/28/2019,9900,V3ewDftb,29400,more than downpayment,more than downpayment,0,3900
V3ewDftb,3900,12/26/2019,9900,V3ewDftb,33300,more than downpayment,more than downpayment,0,3900
V3ewDftb,3900,1/31/2020,9900,V3ewDftb,37200,more than downpayment,more than downpayment,0,3900
V46JYWZT,9900,1/15/2020,8900,,9900,more than downpayment,,8900,1000
V49Y5VA7,9900,1/20/2020,9900,,9900,equal to downpayment,,9900,0
V4H85I9G,9900,12/18/2019,9900,,9900,equal to downpayment,,9900,0
V5A41KVU,1600,10/14/2019,4999,,1600,less than downpayment,,1600,0
V5A41KVU,500,11/6/2019,4999,V5A41KVU,2100,less than downpayment,less than downpayment,500,0
V5A41KVU,600,11/11/2019,4999,V5A41KVU,2700,less than downpayment,less than downpayment,600,0
V5A41KVU,500,11/12/2019,4999,V5A41KVU,3200,less than downpayment,less than downpayment,500,0
V5A41KVU,500,11/14/2019,4999,V5A41KVU,3700,less than downpayment,less than downpayment,500,0
V5A41KVU,1000,12/5/2019,4999,V5A41KVU,4700,less than downpayment,less than downpayment,1000,0
V5A41KVU,250,1/17/2020,4999,V5A41KVU,4950,less than downpayment,less than downpayment,250,0
V5JMPM2I,9900,2/4/2020,9900,,9900,equal to downpayment,,9900,0
V6giHGQ3,10000,9/21/2018,10000,,10000,equal to downpayment,,10000,0
V6giHGQ3,8300,10/5/2018,10000,V6giHGQ3,18300,more than downpayment,equal to downpayment,0,8300
V6giHGQ3,8300,10/27/2018,10000,V6giHGQ3,26600,more than downpayment,more than downpayment,0,8300
V6giHGQ3,8300,12/1/2018,10000,V6giHGQ3,34900,more than downpayment,more than downpayment,0,8300
V6giHGQ3,8300,1/4/2019,10000,V6giHGQ3,43200,more than downpayment,more than downpayment,0,8300
V6giHGQ3,8300,2/4/2019,10000,V6giHGQ3,51500,more than downpayment,more than downpayment,0,8300
V6giHGQ3,4150,3/2/2019,10000,V6giHGQ3,55650,more than downpayment,more than downpayment,0,4150
V6giHGQ3,2000,4/5/2019,10000,V6giHGQ3,57650,more than downpayment,more than downpayment,0,2000
V6giHGQ3,2150,5/1/2019,10000,V6giHGQ3,59800,more than downpayment,more than downpayment,0,2150
V6NUJNN8,9900,1/1/2020,9900,,9900,equal to downpayment,,9900,0
V6XC5UY9,9900,11/11/2019,9900,,9900,equal to downpayment,,9900,0
V6XC5UY9,3900,1/4/2020,9900,V6XC5UY9,13800,more than downpayment,equal to downpayment,0,3900
V6XC5UY9,3900,2/4/2020,9900,V6XC5UY9,17700,more than downpayment,more than downpayment,0,3900
V8AiQFkO,5000,4/12/2017,10000,,5000,less than downpayment,,5000,0
V8AiQFkO,2000,5/16/2017,10000,V8AiQFkO,7000,less than downpayment,less than downpayment,2000,0
V8AiQFkO,5000,5/17/2017,10000,V8AiQFkO,12000,more than downpayment,less than downpayment,3000,2000
V8AiQFkO,2000,8/9/2017,10000,V8AiQFkO,14000,more than downpayment,more than downpayment,0,2000
V8AiQFkO,1667,10/2/2017,10000,V8AiQFkO,15667,more than downpayment,more than downpayment,0,1667
V8AiQFkO,2000,12/27/2017,10000,V8AiQFkO,17667,more than downpayment,more than downpayment,0,2000
V8AiQFkO,2000,2/19/2018,10000,V8AiQFkO,19667,more than downpayment,more than downpayment,0,2000
V8AiQFkO,2000,3/19/2018,10000,V8AiQFkO,21667,more than downpayment,more than downpayment,0,2000
V8AiQFkO,2000,4/21/2018,10000,V8AiQFkO,23667,more than downpayment,more than downpayment,0,2000
V8AiQFkO,1333,5/22/2018,10000,V8AiQFkO,25000,more than downpayment,more than downpayment,0,1333
v8CvzxwG,8700,2/4/2019,8900,,8700,less than downpayment,,8700,0
v8CvzxwG,200,2/5/2019,8900,v8CvzxwG,8900,equal to downpayment,less than downpayment,200,0
v8CvzxwG,3900,3/12/2019,8900,v8CvzxwG,12800,more than downpayment,equal to downpayment,0,3900
v8CvzxwG,3400,6/13/2019,8900,v8CvzxwG,16200,more than downpayment,more than downpayment,0,3400
v8vCY9QL,10000,7/13/2018,10000,,10000,equal to downpayment,,10000,0
v8vCY9QL,4500,8/1/2018,10000,v8vCY9QL,14500,more than downpayment,equal to downpayment,0,4500
v8vCY9QL,4500,9/2/2018,10000,v8vCY9QL,19000,more than downpayment,more than downpayment,0,4500
v8vCY9QL,4500,10/2/2018,10000,v8vCY9QL,23500,more than downpayment,more than downpayment,0,4500
v8vCY9QL,4500,11/2/2018,10000,v8vCY9QL,28000,more than downpayment,more than downpayment,0,4500
v8vCY9QL,4500,12/3/2018,10000,v8vCY9QL,32500,more than downpayment,more than downpayment,0,4500
v8vCY9QL,4500,1/1/2019,10000,v8vCY9QL,37000,more than downpayment,more than downpayment,0,4500
v8vCY9QL,4500,2/5/2019,10000,v8vCY9QL,41500,more than downpayment,more than downpayment,0,4500
v8vCY9QL,4500,3/2/2019,10000,v8vCY9QL,46000,more than downpayment,more than downpayment,0,4500
v8vCY9QL,4500,4/2/2019,10000,v8vCY9QL,50500,more than downpayment,more than downpayment,0,4500
v8vCY9QL,4500,4/20/2019,10000,v8vCY9QL,55000,more than downpayment,more than downpayment,0,4500
v8vCY9QL,4500,6/1/2019,10000,v8vCY9QL,59500,more than downpayment,more than downpayment,0,4500
v8vCY9QL,4500,7/2/2019,10000,v8vCY9QL,64000,more than downpayment,more than downpayment,0,4500
V9WSA7AE,9900,11/6/2019,9900,,9900,equal to downpayment,,9900,0
V9WSA7AE,4000,1/7/2020,9900,V9WSA7AE,13900,more than downpayment,equal to downpayment,0,4000
V9WSA7AE,4000,1/30/2020,9900,V9WSA7AE,17900,more than downpayment,more than downpayment,0,4000
V9XGO9QF,8900,1/6/2020,8900,,8900,equal to downpayment,,8900,0
V9ZGT1Y4,9900,10/29/2019,9900,,9900,equal to downpayment,,9900,0
V9ZGT1Y4,30000,12/3/2019,9900,V9ZGT1Y4,39900,more than downpayment,equal to downpayment,0,30000
V9ZGT1Y4,4500,2/4/2020,9900,V9ZGT1Y4,44400,more than downpayment,more than downpayment,0,4500
vafYyhSo,9900,6/27/2019,9900,,9900,equal to downpayment,,9900,0
vafYyhSo,3900,9/28/2019,9900,vafYyhSo,13800,more than downpayment,equal to downpayment,0,3900
vafYyhSo,1900,11/6/2019,9900,vafYyhSo,15700,more than downpayment,more than downpayment,0,1900
vafYyhSo,2000,11/11/2019,9900,vafYyhSo,17700,more than downpayment,more than downpayment,0,2000
vafYyhSo,2000,12/2/2019,9900,vafYyhSo,19700,more than downpayment,more than downpayment,0,2000
vafYyhSo,1900,12/9/2019,9900,vafYyhSo,21600,more than downpayment,more than downpayment,0,1900
vafYyhSo,3900,1/16/2020,9900,vafYyhSo,25500,more than downpayment,more than downpayment,0,3900
vafYyhSo,3999,1/30/2020,9900,vafYyhSo,29499,more than downpayment,more than downpayment,0,3999
VAZS1IWS,8900,1/7/2020,8900,,8900,equal to downpayment,,8900,0
VB61BQ1E,9900,12/10/2019,9900,,9900,equal to downpayment,,9900,0
VdDWa8uR,8900,5/22/2019,8900,,8900,equal to downpayment,,8900,0
Vds0e6v9,10000,7/12/2019,9900,,10000,more than downpayment,,9900,100
Vds0e6v9,3900,9/2/2019,9900,Vds0e6v9,13900,more than downpayment,more than downpayment,0,3900
Vds0e6v9,3900,10/2/2019,9900,Vds0e6v9,17800,more than downpayment,more than downpayment,0,3900
Vds0e6v9,3900,11/15/2019,9900,Vds0e6v9,21700,more than downpayment,more than downpayment,0,3900
Vds0e6v9,3900,11/30/2019,9900,Vds0e6v9,25600,more than downpayment,more than downpayment,0,3900
Vds0e6v9,3900,2/3/2020,9900,Vds0e6v9,29500,more than downpayment,more than downpayment,0,3900
vdSejQcg,9900,7/11/2019,9900,,9900,equal to downpayment,,9900,0
vdSejQcg,3900,8/25/2019,9900,vdSejQcg,13800,more than downpayment,equal to downpayment,0,3900
vdSejQcg,3900,9/26/2019,9900,vdSejQcg,17700,more than downpayment,more than downpayment,0,3900
vdSejQcg,3900,11/5/2019,9900,vdSejQcg,21600,more than downpayment,more than downpayment,0,3900
vdSejQcg,3900,11/27/2019,9900,vdSejQcg,25500,more than downpayment,more than downpayment,0,3900
vdSejQcg,3900,1/4/2020,9900,vdSejQcg,29400,more than downpayment,more than downpayment,0,3900
vdSejQcg,3900,2/3/2020,9900,vdSejQcg,33300,more than downpayment,more than downpayment,0,3900
VE9CDGLM,7900,11/15/2019,7900,,7900,equal to downpayment,,7900,0
VeCvXIur,8900,2/13/2019,8900,,8900,equal to downpayment,,8900,0
VeCvXIur,3900,3/23/2019,8900,VeCvXIur,12800,more than downpayment,equal to downpayment,0,3900
VeCvXIur,3900,4/25/2019,8900,VeCvXIur,16700,more than downpayment,more than downpayment,0,3900
VeCvXIur,3999,5/14/2019,8900,VeCvXIur,20699,more than downpayment,more than downpayment,0,3999
VeCvXIur,2000,6/18/2019,8900,VeCvXIur,22699,more than downpayment,more than downpayment,0,2000
VeCvXIur,1900,6/24/2019,8900,VeCvXIur,24599,more than downpayment,more than downpayment,0,1900
VeCvXIur,3999,7/25/2019,8900,VeCvXIur,28598,more than downpayment,more than downpayment,0,3999
VeCvXIur,3000,8/9/2019,8900,VeCvXIur,31598,more than downpayment,more than downpayment,0,3000
VeCvXIur,900,8/25/2019,8900,VeCvXIur,32498,more than downpayment,more than downpayment,0,900
VeCvXIur,3900,9/23/2019,8900,VeCvXIur,36398,more than downpayment,more than downpayment,0,3900
VeCvXIur,3900,10/18/2019,8900,VeCvXIur,40298,more than downpayment,more than downpayment,0,3900
VeCvXIur,3900,11/25/2019,8900,VeCvXIur,44198,more than downpayment,more than downpayment,0,3900
VeCvXIur,3900,12/24/2019,8900,VeCvXIur,48098,more than downpayment,more than downpayment,0,3900
VeCvXIur,3702,1/29/2020,8900,VeCvXIur,51800,more than downpayment,more than downpayment,0,3702
VEJQXUPK,9990,2/6/2020,9900,,9990,more than downpayment,,9900,90
VENB65LG,9900,11/29/2019,9900,,9900,equal to downpayment,,9900,0
VFMYX9DA,1000,10/31/2019,9900,,1000,less than downpayment,,1000,0
VFMYX9DA,8900,11/12/2019,9900,VFMYX9DA,9900,equal to downpayment,less than downpayment,8900,0
VFMYX9DA,3900,12/24/2019,9900,VFMYX9DA,13800,more than downpayment,equal to downpayment,0,3900
VFMYX9DA,3900,1/27/2020,9900,VFMYX9DA,17700,more than downpayment,more than downpayment,0,3900
VFSVD6F1,9900,11/24/2019,9900,,9900,equal to downpayment,,9900,0
VG8B16DG,5000,12/15/2019,9900,,5000,less than downpayment,,5000,0
VG8B16DG,4900,12/17/2019,9900,VG8B16DG,9900,equal to downpayment,less than downpayment,4900,0
vglfuHVk,8900,12/28/2018,8900,,8900,equal to downpayment,,8900,0
vglfuHVk,3900,2/15/2019,8900,vglfuHVk,12800,more than downpayment,equal to downpayment,0,3900
vGwV0Jdr,9900,7/12/2019,9900,,9900,equal to downpayment,,9900,0
vGwV0Jdr,4000,8/30/2019,9900,vGwV0Jdr,13900,more than downpayment,equal to downpayment,0,4000
vGwV0Jdr,3900,9/30/2019,9900,vGwV0Jdr,17800,more than downpayment,more than downpayment,0,3900
vGwV0Jdr,3900,10/29/2019,9900,vGwV0Jdr,21700,more than downpayment,more than downpayment,0,3900
vGwV0Jdr,3900,11/26/2019,9900,vGwV0Jdr,25600,more than downpayment,more than downpayment,0,3900
vGwV0Jdr,3900,12/25/2019,9900,vGwV0Jdr,29500,more than downpayment,more than downpayment,0,3900
vGwV0Jdr,3900,1/26/2020,9900,vGwV0Jdr,33400,more than downpayment,more than downpayment,0,3900
VgXk1Msr,8900,8/19/2019,8900,,8900,equal to downpayment,,8900,0
VgXk1Msr,3900,10/2/2019,8900,VgXk1Msr,12800,more than downpayment,equal to downpayment,0,3900
VgXk1Msr,3900,11/4/2019,8900,VgXk1Msr,16700,more than downpayment,more than downpayment,0,3900
VgXk1Msr,3900,12/4/2019,8900,VgXk1Msr,20600,more than downpayment,more than downpayment,0,3900
VgXk1Msr,3900,1/5/2020,8900,VgXk1Msr,24500,more than downpayment,more than downpayment,0,3900
VgXk1Msr,3900,2/4/2020,8900,VgXk1Msr,28400,more than downpayment,more than downpayment,0,3900
VH5SH1UZ,9900,1/12/2020,9900,,9900,equal to downpayment,,9900,0
vh6WDWSc,10000,11/12/2018,10000,,10000,equal to downpayment,,10000,0
vh6WDWSc,4500,12/11/2018,10000,vh6WDWSc,14500,more than downpayment,equal to downpayment,0,4500
vh6WDWSc,4500,1/14/2019,10000,vh6WDWSc,19000,more than downpayment,more than downpayment,0,4500
vh6WDWSc,4500,2/14/2019,10000,vh6WDWSc,23500,more than downpayment,more than downpayment,0,4500
vh6WDWSc,4500,3/14/2019,10000,vh6WDWSc,28000,more than downpayment,more than downpayment,0,4500
vh6WDWSc,4500,4/12/2019,10000,vh6WDWSc,32500,more than downpayment,more than downpayment,0,4500
vh6WDWSc,4500,5/14/2019,10000,vh6WDWSc,37000,more than downpayment,more than downpayment,0,4500
vh6WDWSc,4500,6/14/2019,10000,vh6WDWSc,41500,more than downpayment,more than downpayment,0,4500
vh6WDWSc,4500,7/16/2019,10000,vh6WDWSc,46000,more than downpayment,more than downpayment,0,4500
vh6WDWSc,4500,8/15/2019,10000,vh6WDWSc,50500,more than downpayment,more than downpayment,0,4500
vh6WDWSc,4500,10/6/2019,10000,vh6WDWSc,55000,more than downpayment,more than downpayment,0,4500
vh6WDWSc,4500,10/18/2019,10000,vh6WDWSc,59500,more than downpayment,more than downpayment,0,4500
vh6WDWSc,4500,11/21/2019,10000,vh6WDWSc,64000,more than downpayment,more than downpayment,0,4500
VH79NQKJ,9900,1/31/2020,9900,,9900,equal to downpayment,,9900,0
vHeC0m1t,10000,11/27/2017,10000,,10000,equal to downpayment,,10000,0
vHeC0m1t,4000,2/23/2018,10000,vHeC0m1t,14000,more than downpayment,equal to downpayment,0,4000
vHeC0m1t,4000,3/19/2018,10000,vHeC0m1t,18000,more than downpayment,more than downpayment,0,4000
vHeC0m1t,4000,4/18/2018,10000,vHeC0m1t,22000,more than downpayment,more than downpayment,0,4000
vHeC0m1t,4000,5/14/2018,10000,vHeC0m1t,26000,more than downpayment,more than downpayment,0,4000
vHeC0m1t,4000,6/16/2018,10000,vHeC0m1t,30000,more than downpayment,more than downpayment,0,4000
vHeC0m1t,4000,7/18/2018,10000,vHeC0m1t,34000,more than downpayment,more than downpayment,0,4000
vHeC0m1t,4000,9/24/2018,10000,vHeC0m1t,38000,more than downpayment,more than downpayment,0,4000
vHeC0m1t,2000,1/18/2019,10000,vHeC0m1t,40000,more than downpayment,more than downpayment,0,2000
vHeC0m1t,4000,5/15/2019,10000,vHeC0m1t,44000,more than downpayment,more than downpayment,0,4000
vHeC0m1t,2000,6/21/2019,10000,vHeC0m1t,46000,more than downpayment,more than downpayment,0,2000
vHeC0m1t,3000,7/19/2019,10000,vHeC0m1t,49000,more than downpayment,more than downpayment,0,3000
vHeC0m1t,4000,8/15/2019,10000,vHeC0m1t,53000,more than downpayment,more than downpayment,0,4000
vHeC0m1t,5000,10/15/2019,10000,vHeC0m1t,58000,more than downpayment,more than downpayment,0,5000
Vhn91mEf,9900,7/18/2019,9900,,9900,equal to downpayment,,9900,0
Vhn91mEf,3000,10/4/2019,9900,Vhn91mEf,12900,more than downpayment,equal to downpayment,0,3000
Vhn91mEf,3900,10/30/2019,9900,Vhn91mEf,16800,more than downpayment,more than downpayment,0,3900
Vhn91mEf,3900,12/4/2019,9900,Vhn91mEf,20700,more than downpayment,more than downpayment,0,3900
Vhn91mEf,850,12/17/2019,9900,Vhn91mEf,21550,more than downpayment,more than downpayment,0,850
Vhn91mEf,3840,1/4/2020,9900,Vhn91mEf,25390,more than downpayment,more than downpayment,0,3840
Vhn91mEf,250,1/8/2020,9900,Vhn91mEf,25640,more than downpayment,more than downpayment,0,250
Vhn91mEf,4800,2/1/2020,9900,Vhn91mEf,30440,more than downpayment,more than downpayment,0,4800
Vhr1KLpH,9000,3/26/2019,8900,,9000,more than downpayment,,8900,100
Vhr1KLpH,5000,4/11/2019,8900,Vhr1KLpH,14000,more than downpayment,more than downpayment,0,5000
Vhr1KLpH,3000,5/11/2019,8900,Vhr1KLpH,17000,more than downpayment,more than downpayment,0,3000
Vhr1KLpH,3000,6/7/2019,8900,Vhr1KLpH,20000,more than downpayment,more than downpayment,0,3000
Vhr1KLpH,3900,7/8/2019,8900,Vhr1KLpH,23900,more than downpayment,more than downpayment,0,3900
Vhr1KLpH,4000,8/7/2019,8900,Vhr1KLpH,27900,more than downpayment,more than downpayment,0,4000
Vhr1KLpH,3900,9/5/2019,8900,Vhr1KLpH,31800,more than downpayment,more than downpayment,0,3900
Vhr1KLpH,3900,10/3/2019,8900,Vhr1KLpH,35700,more than downpayment,more than downpayment,0,3900
Vhr1KLpH,3900,11/4/2019,8900,Vhr1KLpH,39600,more than downpayment,more than downpayment,0,3900
Vhr1KLpH,3900,12/3/2019,8900,Vhr1KLpH,43500,more than downpayment,more than downpayment,0,3900
Vhr1KLpH,3900,1/4/2020,8900,Vhr1KLpH,47400,more than downpayment,more than downpayment,0,3900
Vhr1KLpH,3900,2/3/2020,8900,Vhr1KLpH,51300,more than downpayment,more than downpayment,0,3900
VI9BB6Z2,9900,11/20/2019,9900,,9900,equal to downpayment,,9900,0
VI9BB6Z2,3000,1/20/2020,9900,VI9BB6Z2,12900,more than downpayment,equal to downpayment,0,3000
VI9BB6Z2,700,1/25/2020,9900,VI9BB6Z2,13600,more than downpayment,more than downpayment,0,700
VI9BB6Z2,200,1/28/2020,9900,VI9BB6Z2,13800,more than downpayment,more than downpayment,0,200
viBPejR5,10000,10/24/2018,10000,,10000,equal to downpayment,,10000,0
viBPejR5,4500,11/28/2018,10000,viBPejR5,14500,more than downpayment,equal to downpayment,0,4500
viBPejR5,4500,12/30/2018,10000,viBPejR5,19000,more than downpayment,more than downpayment,0,4500
viBPejR5,4500,1/30/2019,10000,viBPejR5,23500,more than downpayment,more than downpayment,0,4500
viBPejR5,4500,3/2/2019,10000,viBPejR5,28000,more than downpayment,more than downpayment,0,4500
viBPejR5,4500,3/29/2019,10000,viBPejR5,32500,more than downpayment,more than downpayment,0,4500
viBPejR5,4500,4/28/2019,10000,viBPejR5,37000,more than downpayment,more than downpayment,0,4500
viBPejR5,4500,6/13/2019,10000,viBPejR5,41500,more than downpayment,more than downpayment,0,4500
viBPejR5,4500,6/29/2019,10000,viBPejR5,46000,more than downpayment,more than downpayment,0,4500
viBPejR5,4500,7/30/2019,10000,viBPejR5,50500,more than downpayment,more than downpayment,0,4500
viBPejR5,4500,8/28/2019,10000,viBPejR5,55000,more than downpayment,more than downpayment,0,4500
viBPejR5,4500,10/7/2019,10000,viBPejR5,59500,more than downpayment,more than downpayment,0,4500
viBPejR5,4500,10/30/2019,10000,viBPejR5,64000,more than downpayment,more than downpayment,0,4500
viBPejR5,4500,12/3/2019,10000,viBPejR5,68500,more than downpayment,more than downpayment,0,4500
vigyAmN8,9900,7/15/2019,9900,,9900,equal to downpayment,,9900,0
vigyAmN8,3900,8/8/2019,9900,vigyAmN8,13800,more than downpayment,equal to downpayment,0,3900
vigyAmN8,3900,9/9/2019,9900,vigyAmN8,17700,more than downpayment,more than downpayment,0,3900
vigyAmN8,3900,10/18/2019,9900,vigyAmN8,21600,more than downpayment,more than downpayment,0,3900
vigyAmN8,3900,11/20/2019,9900,vigyAmN8,25500,more than downpayment,more than downpayment,0,3900
vigyAmN8,3900,12/27/2019,9900,vigyAmN8,29400,more than downpayment,more than downpayment,0,3900
vigyAmN8,3900,2/1/2020,9900,vigyAmN8,33300,more than downpayment,more than downpayment,0,3900
viOROBJE,9900,11/9/2018,9900,,9900,equal to downpayment,,9900,0
viOROBJE,2000,1/4/2019,9900,viOROBJE,11900,more than downpayment,equal to downpayment,0,2000
viOROBJE,1000,2/20/2019,9900,viOROBJE,12900,more than downpayment,more than downpayment,0,1000
viOROBJE,1000,2/26/2019,9900,viOROBJE,13900,more than downpayment,more than downpayment,0,1000
viOROBJE,500,3/17/2019,9900,viOROBJE,14400,more than downpayment,more than downpayment,0,500
viOROBJE,2000,3/30/2019,9900,viOROBJE,16400,more than downpayment,more than downpayment,0,2000
viPAjFlQ,9900,8/7/2019,9900,,9900,equal to downpayment,,9900,0
viPAjFlQ,3900,10/15/2019,9900,viPAjFlQ,13800,more than downpayment,equal to downpayment,0,3900
viPAjFlQ,3900,11/19/2019,9900,viPAjFlQ,17700,more than downpayment,more than downpayment,0,3900
viPAjFlQ,3900,12/18/2019,9900,viPAjFlQ,21600,more than downpayment,more than downpayment,0,3900
viPAjFlQ,3900,1/20/2020,9900,viPAjFlQ,25500,more than downpayment,more than downpayment,0,3900
VJ5CDTU8,9900,11/7/2019,9900,,9900,equal to downpayment,,9900,0
VJ5CDTU8,3900,1/9/2020,9900,VJ5CDTU8,13800,more than downpayment,equal to downpayment,0,3900
VJ5CDTU8,2500,2/5/2020,9900,VJ5CDTU8,16300,more than downpayment,more than downpayment,0,2500
VJ8DZDNK,9900,1/1/2020,9900,,9900,equal to downpayment,,9900,0
VjdVvRLw,8900,4/23/2019,8900,,8900,equal to downpayment,,8900,0
VjdVvRLw,3900,5/24/2019,8900,VjdVvRLw,12800,more than downpayment,equal to downpayment,0,3900
VjdVvRLw,3900,6/25/2019,8900,VjdVvRLw,16700,more than downpayment,more than downpayment,0,3900
VjdVvRLw,3900,7/30/2019,8900,VjdVvRLw,20600,more than downpayment,more than downpayment,0,3900
VjdVvRLw,5000,11/3/2019,8900,VjdVvRLw,25600,more than downpayment,more than downpayment,0,5000
vjGDQjmL,8900,8/3/2019,8900,,8900,equal to downpayment,,8900,0
vjGDQjmL,3900,10/4/2019,8900,vjGDQjmL,12800,more than downpayment,equal to downpayment,0,3900
vjGDQjmL,3900,11/5/2019,8900,vjGDQjmL,16700,more than downpayment,more than downpayment,0,3900
vjGDQjmL,3900,12/3/2019,8900,vjGDQjmL,20600,more than downpayment,more than downpayment,0,3900
vjGDQjmL,3900,1/3/2020,8900,vjGDQjmL,24500,more than downpayment,more than downpayment,0,3900
vjGDQjmL,3900,2/4/2020,8900,vjGDQjmL,28400,more than downpayment,more than downpayment,0,3900
VJQY9XGU,9900,1/4/2020,9900,,9900,equal to downpayment,,9900,0
vJwOZ4uB,9900,6/18/2019,9900,,9900,equal to downpayment,,9900,0
vJwOZ4uB,3900,8/14/2019,9900,vJwOZ4uB,13800,more than downpayment,equal to downpayment,0,3900
vJwOZ4uB,3900,9/9/2019,9900,vJwOZ4uB,17700,more than downpayment,more than downpayment,0,3900
vJwOZ4uB,3900,10/15/2019,9900,vJwOZ4uB,21600,more than downpayment,more than downpayment,0,3900
vJwOZ4uB,2500,11/6/2019,9900,vJwOZ4uB,24100,more than downpayment,more than downpayment,0,2500
vJwOZ4uB,1400,11/19/2019,9900,vJwOZ4uB,25500,more than downpayment,more than downpayment,0,1400
vJwOZ4uB,3900,12/5/2019,9900,vJwOZ4uB,29400,more than downpayment,more than downpayment,0,3900
vJwOZ4uB,3900,1/29/2020,9900,vJwOZ4uB,33300,more than downpayment,more than downpayment,0,3900
VLAE4768,9900,9/24/2019,9900,,9900,equal to downpayment,,9900,0
VLAE4768,3900,11/6/2019,9900,VLAE4768,13800,more than downpayment,equal to downpayment,0,3900
VLAE4768,3900,12/4/2019,9900,VLAE4768,17700,more than downpayment,more than downpayment,0,3900
VLAE4768,3900,1/8/2020,9900,VLAE4768,21600,more than downpayment,more than downpayment,0,3900
vlD4lrhN,8900,1/28/2019,8900,,8900,equal to downpayment,,8900,0
vlD4lrhN,3900,3/4/2019,8900,vlD4lrhN,12800,more than downpayment,equal to downpayment,0,3900
vlD4lrhN,3900,3/27/2019,8900,vlD4lrhN,16700,more than downpayment,more than downpayment,0,3900
vlD4lrhN,3900,5/2/2019,8900,vlD4lrhN,20600,more than downpayment,more than downpayment,0,3900
vlD4lrhN,3900,5/27/2019,8900,vlD4lrhN,24500,more than downpayment,more than downpayment,0,3900
vlD4lrhN,3900,7/5/2019,8900,vlD4lrhN,28400,more than downpayment,more than downpayment,0,3900
vlD4lrhN,3900,8/1/2019,8900,vlD4lrhN,32300,more than downpayment,more than downpayment,0,3900
vlD4lrhN,3900,9/4/2019,8900,vlD4lrhN,36200,more than downpayment,more than downpayment,0,3900
vlD4lrhN,3900,10/2/2019,8900,vlD4lrhN,40100,more than downpayment,more than downpayment,0,3900
vlD4lrhN,3900,11/2/2019,8900,vlD4lrhN,44000,more than downpayment,more than downpayment,0,3900
vlD4lrhN,3900,12/2/2019,8900,vlD4lrhN,47900,more than downpayment,more than downpayment,0,3900
vlD4lrhN,3900,12/20/2019,8900,vlD4lrhN,51800,more than downpayment,more than downpayment,0,3900
vlD4lrhN,3900,2/3/2020,8900,vlD4lrhN,55700,more than downpayment,more than downpayment,0,3900
VLD7TZ1W,9900,1/11/2020,9900,,9900,equal to downpayment,,9900,0
vLLDy37U,9900,6/29/2019,8900,,9900,more than downpayment,,8900,1000
vLLDy37U,3900,8/5/2019,8900,vLLDy37U,13800,more than downpayment,more than downpayment,0,3900
vLLDy37U,4900,8/31/2019,8900,vLLDy37U,18700,more than downpayment,more than downpayment,0,4900
vLLDy37U,2900,10/3/2019,8900,vLLDy37U,21600,more than downpayment,more than downpayment,0,2900
vLLDy37U,3900,11/5/2019,8900,vLLDy37U,25500,more than downpayment,more than downpayment,0,3900
vLLDy37U,4000,12/5/2019,8900,vLLDy37U,29500,more than downpayment,more than downpayment,0,4000
vLLDy37U,3900,1/3/2020,8900,vLLDy37U,33400,more than downpayment,more than downpayment,0,3900
vLLDy37U,3900,2/4/2020,8900,vLLDy37U,37300,more than downpayment,more than downpayment,0,3900
vLZoQR6u,8900,4/3/2019,8900,,8900,equal to downpayment,,8900,0
vLZoQR6u,3900,5/6/2019,8900,vLZoQR6u,12800,more than downpayment,equal to downpayment,0,3900
vLZoQR6u,3900,6/8/2019,8900,vLZoQR6u,16700,more than downpayment,more than downpayment,0,3900
vLZoQR6u,3900,7/11/2019,8900,vLZoQR6u,20600,more than downpayment,more than downpayment,0,3900
vLZoQR6u,3900,8/8/2019,8900,vLZoQR6u,24500,more than downpayment,more than downpayment,0,3900
vLZoQR6u,3900,9/7/2019,8900,vLZoQR6u,28400,more than downpayment,more than downpayment,0,3900
vLZoQR6u,3900,10/16/2019,8900,vLZoQR6u,32300,more than downpayment,more than downpayment,0,3900
vLZoQR6u,3900,12/6/2019,8900,vLZoQR6u,36200,more than downpayment,more than downpayment,0,3900
vLZoQR6u,7800,2/7/2020,8900,vLZoQR6u,44000,more than downpayment,more than downpayment,0,7800
VM54WX62,8900,5/10/2019,8900,,8900,equal to downpayment,,8900,0
VM54WX62,3900,6/17/2019,8900,VM54WX62,12800,more than downpayment,equal to downpayment,0,3900
VM54WX62,3900,7/17/2019,8900,VM54WX62,16700,more than downpayment,more than downpayment,0,3900
VM54WX62,3900,8/13/2019,8900,VM54WX62,20600,more than downpayment,more than downpayment,0,3900
VM54WX62,3900,9/18/2019,8900,VM54WX62,24500,more than downpayment,more than downpayment,0,3900
VM54WX62,3900,10/17/2019,8900,VM54WX62,28400,more than downpayment,more than downpayment,0,3900
VM54WX62,3900,12/4/2019,8900,VM54WX62,32300,more than downpayment,more than downpayment,0,3900
VM54WX62,3900,12/17/2019,8900,VM54WX62,36200,more than downpayment,more than downpayment,0,3900
VM54WX62,3900,1/27/2020,8900,VM54WX62,40100,more than downpayment,more than downpayment,0,3900
VM5EZDWR,9900,7/12/2019,9900,,9900,equal to downpayment,,9900,0
VM5EZDWR,3900,9/17/2019,9900,VM5EZDWR,13800,more than downpayment,equal to downpayment,0,3900
VM5EZDWR,3900,10/16/2019,9900,VM5EZDWR,17700,more than downpayment,more than downpayment,0,3900
VM5EZDWR,3900,11/18/2019,9900,VM5EZDWR,21600,more than downpayment,more than downpayment,0,3900
VM5EZDWR,3900,12/23/2019,9900,VM5EZDWR,25500,more than downpayment,more than downpayment,0,3900
VM5EZDWR,3900,1/17/2020,9900,VM5EZDWR,29400,more than downpayment,more than downpayment,0,3900
VMFRYX8K,4000,8/5/2019,9900,,4000,less than downpayment,,4000,0
VMFRYX8K,5000,8/21/2019,9900,VMFRYX8K,9000,less than downpayment,less than downpayment,5000,0
VMFRYX8K,900,8/23/2019,9900,VMFRYX8K,9900,equal to downpayment,less than downpayment,900,0
VMFRYX8K,3900,12/12/2019,9900,VMFRYX8K,13800,more than downpayment,equal to downpayment,0,3900
VMFRYX8K,2000,1/6/2020,9900,VMFRYX8K,15800,more than downpayment,more than downpayment,0,2000
VMFRYX8K,1000,1/13/2020,9900,VMFRYX8K,16800,more than downpayment,more than downpayment,0,1000
VMFRYX8K,1000,1/22/2020,9900,VMFRYX8K,17800,more than downpayment,more than downpayment,0,1000
VMFRYX8K,3500,2/7/2020,9900,VMFRYX8K,21300,more than downpayment,more than downpayment,0,3500
vMgDDa3q,9900,6/10/2019,9900,,9900,equal to downpayment,,9900,0
vMgDDa3q,3900,7/25/2019,9900,vMgDDa3q,13800,more than downpayment,equal to downpayment,0,3900
vMgDDa3q,3900,11/14/2019,9900,vMgDDa3q,17700,more than downpayment,more than downpayment,0,3900
vMgDDa3q,7800,12/12/2019,9900,vMgDDa3q,25500,more than downpayment,more than downpayment,0,7800
vMgDDa3q,3900,2/4/2020,9900,vMgDDa3q,29400,more than downpayment,more than downpayment,0,3900
VMI3EOGS,10000,11/28/2019,9900,,10000,more than downpayment,,9900,100
VMI3EOGS,3900,2/5/2020,9900,VMI3EOGS,13900,more than downpayment,more than downpayment,0,3900
VMj26mcK,8900,5/13/2019,8900,,8900,equal to downpayment,,8900,0
VMj26mcK,3900,6/14/2019,8900,VMj26mcK,12800,more than downpayment,equal to downpayment,0,3900
VMj26mcK,3900,7/4/2019,8900,VMj26mcK,16700,more than downpayment,more than downpayment,0,3900
VMj26mcK,3900,8/22/2019,8900,VMj26mcK,20600,more than downpayment,more than downpayment,0,3900
VMj26mcK,3900,9/5/2019,8900,VMj26mcK,24500,more than downpayment,more than downpayment,0,3900
VMj26mcK,3900,10/7/2019,8900,VMj26mcK,28400,more than downpayment,more than downpayment,0,3900
VMj26mcK,3900,11/3/2019,8900,VMj26mcK,32300,more than downpayment,more than downpayment,0,3900
VMj26mcK,3900,12/10/2019,8900,VMj26mcK,36200,more than downpayment,more than downpayment,0,3900
VMj26mcK,3900,1/6/2020,8900,VMj26mcK,40100,more than downpayment,more than downpayment,0,3900
VMj26mcK,3900,2/6/2020,8900,VMj26mcK,44000,more than downpayment,more than downpayment,0,3900
VMmoI1dk,8900,5/6/2019,8900,,8900,equal to downpayment,,8900,0
VMmoI1dk,4000,6/2/2019,8900,VMmoI1dk,12900,more than downpayment,equal to downpayment,0,4000
VMmoI1dk,4000,6/27/2019,8900,VMmoI1dk,16900,more than downpayment,more than downpayment,0,4000
VMmoI1dk,4000,8/1/2019,8900,VMmoI1dk,20900,more than downpayment,more than downpayment,0,4000
VMmoI1dk,4000,8/28/2019,8900,VMmoI1dk,24900,more than downpayment,more than downpayment,0,4000
VMmoI1dk,4000,9/27/2019,8900,VMmoI1dk,28900,more than downpayment,more than downpayment,0,4000
VMmoI1dk,4000,11/4/2019,8900,VMmoI1dk,32900,more than downpayment,more than downpayment,0,4000
VMmoI1dk,4000,11/28/2019,8900,VMmoI1dk,36900,more than downpayment,more than downpayment,0,4000
VMmoI1dk,4000,12/27/2019,8900,VMmoI1dk,40900,more than downpayment,more than downpayment,0,4000
VMmoI1dk,4000,1/25/2020,8900,VMmoI1dk,44900,more than downpayment,more than downpayment,0,4000
VMWNTJBO,8900,1/21/2020,8900,,8900,equal to downpayment,,8900,0
VOL6CYYR,9900,10/1/2019,9900,,9900,equal to downpayment,,9900,0
VOL6CYYR,3900,12/5/2019,9900,VOL6CYYR,13800,more than downpayment,equal to downpayment,0,3900
VOL6CYYR,3900,1/7/2020,9900,VOL6CYYR,17700,more than downpayment,more than downpayment,0,3900
VOL6CYYR,3900,2/5/2020,9900,VOL6CYYR,21600,more than downpayment,more than downpayment,0,3900
VOM6OSAK,9900,12/2/2019,9900,,9900,equal to downpayment,,9900,0
VOM6OSAK,3900,2/5/2020,9900,VOM6OSAK,13800,more than downpayment,equal to downpayment,0,3900
VONA4LIS,8900,1/21/2020,8900,,8900,equal to downpayment,,8900,0
VotCyyGL,8900,5/13/2019,26250,,8900,less than downpayment,,8900,0
VotCyyGL,20000,5/14/2019,26250,VotCyyGL,28900,more than downpayment,less than downpayment,17350,2650
VotCyyGL,40000,6/15/2019,26250,VotCyyGL,68900,more than downpayment,more than downpayment,0,40000
VotCyyGL,10000,7/25/2019,26250,VotCyyGL,78900,more than downpayment,more than downpayment,0,10000
VotCyyGL,11000,8/9/2019,26250,VotCyyGL,89900,more than downpayment,more than downpayment,0,11000
VotCyyGL,10000,8/23/2019,26250,VotCyyGL,99900,more than downpayment,more than downpayment,0,10000
VotCyyGL,5100,8/30/2019,26250,VotCyyGL,105000,more than downpayment,more than downpayment,0,5100
VPZFET2H,1000,1/24/2020,9900,,1000,less than downpayment,,1000,0
VQD82W1B,8900,11/28/2019,8900,,8900,equal to downpayment,,8900,0
VQD82W1B,3900,2/5/2020,8900,VQD82W1B,12800,more than downpayment,equal to downpayment,0,3900
VQG40hOu,8900,3/1/2019,8900,,8900,equal to downpayment,,8900,0
VQG40hOu,3000,3/18/2019,8900,VQG40hOu,11900,more than downpayment,equal to downpayment,0,3000
VQG40hOu,5000,3/29/2019,8900,VQG40hOu,16900,more than downpayment,more than downpayment,0,5000
VQG40hOu,4000,3/30/2019,8900,VQG40hOu,20900,more than downpayment,more than downpayment,0,4000
VQG40hOu,2000,4/2/2019,8900,VQG40hOu,22900,more than downpayment,more than downpayment,0,2000
VQG40hOu,3000,4/8/2019,8900,VQG40hOu,25900,more than downpayment,more than downpayment,0,3000
VQG40hOu,12000,4/14/2019,8900,VQG40hOu,37900,more than downpayment,more than downpayment,0,12000
VQG40hOu,2400,10/31/2019,8900,VQG40hOu,40300,more than downpayment,more than downpayment,0,2400
VQG40hOu,4900,11/6/2019,8900,VQG40hOu,45200,more than downpayment,more than downpayment,0,4900
VQG40hOu,3900,12/5/2019,8900,VQG40hOu,49100,more than downpayment,more than downpayment,0,3900
VQG40hOu,4500,1/5/2020,8900,VQG40hOu,53600,more than downpayment,more than downpayment,0,4500
VQG40hOu,3900,2/6/2020,8900,VQG40hOu,57500,more than downpayment,more than downpayment,0,3900
VqQlBGxY,26250,8/8/2019,26250,,26250,equal to downpayment,,26250,0
VqQlBGxY,26250,9/17/2019,26250,VqQlBGxY,52500,more than downpayment,equal to downpayment,0,26250
VqQlBGxY,26250,10/7/2019,26250,VqQlBGxY,78750,more than downpayment,more than downpayment,0,26250
VqQlBGxY,26250,11/5/2019,26250,VqQlBGxY,105000,more than downpayment,more than downpayment,0,26250
VR4PK75P,9900,10/4/2019,9900,,9900,equal to downpayment,,9900,0
VR4PK75P,2000,11/27/2019,9900,VR4PK75P,11900,more than downpayment,equal to downpayment,0,2000
VR4PK75P,1900,11/28/2019,9900,VR4PK75P,13800,more than downpayment,more than downpayment,0,1900
VR4PK75P,3900,1/2/2020,9900,VR4PK75P,17700,more than downpayment,more than downpayment,0,3900
VR4PK75P,3900,1/27/2020,9900,VR4PK75P,21600,more than downpayment,more than downpayment,0,3900
VRFMU71I,9900,11/13/2019,9900,,9900,equal to downpayment,,9900,0
vrFUHBnc,10000,7/24/2017,10000,,10000,equal to downpayment,,10000,0
vrFUHBnc,3500,9/20/2017,10000,vrFUHBnc,13500,more than downpayment,equal to downpayment,0,3500
vrFUHBnc,3500,10/9/2017,10000,vrFUHBnc,17000,more than downpayment,more than downpayment,0,3500
vrFUHBnc,3500,11/10/2017,10000,vrFUHBnc,20500,more than downpayment,more than downpayment,0,3500
vrFUHBnc,3500,12/1/2017,10000,vrFUHBnc,24000,more than downpayment,more than downpayment,0,3500
vrFUHBnc,3500,1/8/2018,10000,vrFUHBnc,27500,more than downpayment,more than downpayment,0,3500
vrFUHBnc,3500,3/1/2018,10000,vrFUHBnc,31000,more than downpayment,more than downpayment,0,3500
vrFUHBnc,3500,4/3/2018,10000,vrFUHBnc,34500,more than downpayment,more than downpayment,0,3500
vrFUHBnc,3500,5/3/2018,10000,vrFUHBnc,38000,more than downpayment,more than downpayment,0,3500
vrFUHBnc,3500,6/6/2018,10000,vrFUHBnc,41500,more than downpayment,more than downpayment,0,3500
vrFUHBnc,3500,7/6/2018,10000,vrFUHBnc,45000,more than downpayment,more than downpayment,0,3500
vrFUHBnc,3500,8/3/2018,10000,vrFUHBnc,48500,more than downpayment,more than downpayment,0,3500
vrFUHBnc,3500,8/20/2018,10000,vrFUHBnc,52000,more than downpayment,more than downpayment,0,3500
VSARIQ57,9900,6/3/2019,8900,,9900,more than downpayment,,8900,1000
VSARIQ57,3900,7/20/2019,8900,VSARIQ57,13800,more than downpayment,more than downpayment,0,3900
VSARIQ57,3900,8/24/2019,8900,VSARIQ57,17700,more than downpayment,more than downpayment,0,3900
VSARIQ57,3900,9/25/2019,8900,VSARIQ57,21600,more than downpayment,more than downpayment,0,3900
VSARIQ57,3900,10/26/2019,8900,VSARIQ57,25500,more than downpayment,more than downpayment,0,3900
VSARIQ57,3900,11/21/2019,8900,VSARIQ57,29400,more than downpayment,more than downpayment,0,3900
VSARIQ57,3900,12/26/2019,8900,VSARIQ57,33300,more than downpayment,more than downpayment,0,3900
VSARIQ57,3900,1/27/2020,8900,VSARIQ57,37200,more than downpayment,more than downpayment,0,3900
VSC1gef2,10000,11/26/2018,10000,,10000,equal to downpayment,,10000,0
VSC1gef2,50000,12/11/2018,10000,VSC1gef2,60000,more than downpayment,equal to downpayment,0,50000
VSC1gef2,4500,1/3/2019,10000,VSC1gef2,64500,more than downpayment,more than downpayment,0,4500
VSC1gef2,4500,2/8/2019,10000,VSC1gef2,69000,more than downpayment,more than downpayment,0,4500
VSD8FY2A,9900,9/11/2019,9900,,9900,equal to downpayment,,9900,0
VSD8FY2A,3900,11/6/2019,9900,VSD8FY2A,13800,more than downpayment,equal to downpayment,0,3900
VSD8FY2A,3900,12/5/2019,9900,VSD8FY2A,17700,more than downpayment,more than downpayment,0,3900
VSD8FY2A,3900,1/5/2020,9900,VSD8FY2A,21600,more than downpayment,more than downpayment,0,3900
vsNV8ifZ,8900,5/8/2019,8900,,8900,equal to downpayment,,8900,0
vsNV8ifZ,3900,6/6/2019,8900,vsNV8ifZ,12800,more than downpayment,equal to downpayment,0,3900
vsNV8ifZ,3900,7/12/2019,8900,vsNV8ifZ,16700,more than downpayment,more than downpayment,0,3900
vsNV8ifZ,1000,8/18/2019,8900,vsNV8ifZ,17700,more than downpayment,more than downpayment,0,1000
vsNV8ifZ,950,9/17/2019,8900,vsNV8ifZ,18650,more than downpayment,more than downpayment,0,950
vsNV8ifZ,1500,10/8/2019,8900,vsNV8ifZ,20150,more than downpayment,more than downpayment,0,1500
vsNV8ifZ,500,10/15/2019,8900,vsNV8ifZ,20650,more than downpayment,more than downpayment,0,500
vsNV8ifZ,1000,10/18/2019,8900,vsNV8ifZ,21650,more than downpayment,more than downpayment,0,1000
vsNV8ifZ,1000,10/27/2019,8900,vsNV8ifZ,22650,more than downpayment,more than downpayment,0,1000
vsNV8ifZ,1000,10/29/2019,8900,vsNV8ifZ,23650,more than downpayment,more than downpayment,0,1000
vsNV8ifZ,2000,11/4/2019,8900,vsNV8ifZ,25650,more than downpayment,more than downpayment,0,2000
vsNV8ifZ,3450,12/4/2019,8900,vsNV8ifZ,29100,more than downpayment,more than downpayment,0,3450
vsNV8ifZ,3600,1/6/2020,8900,vsNV8ifZ,32700,more than downpayment,more than downpayment,0,3600
vT7EWVQj,9900,6/7/2019,9900,,9900,equal to downpayment,,9900,0
vT7EWVQj,3900,8/4/2019,9900,vT7EWVQj,13800,more than downpayment,equal to downpayment,0,3900
vT7EWVQj,3900,10/3/2019,9900,vT7EWVQj,17700,more than downpayment,more than downpayment,0,3900
vT7EWVQj,3900,11/14/2019,9900,vT7EWVQj,21600,more than downpayment,more than downpayment,0,3900
vT7EWVQj,3900,12/30/2019,9900,vT7EWVQj,25500,more than downpayment,more than downpayment,0,3900
vT7EWVQj,3900,1/14/2020,9900,vT7EWVQj,29400,more than downpayment,more than downpayment,0,3900
VTRINGIP,9900,11/18/2019,9900,,9900,equal to downpayment,,9900,0
VTRINGIP,3900,2/9/2020,9900,VTRINGIP,13800,more than downpayment,equal to downpayment,0,3900
VU92HFEC,9900,1/16/2020,9900,,9900,equal to downpayment,,9900,0
Vu9bOPZx,10000,8/27/2018,10000,,10000,equal to downpayment,,10000,0
Vu9bOPZx,4500,9/27/2018,10000,Vu9bOPZx,14500,more than downpayment,equal to downpayment,0,4500
Vu9bOPZx,4500,10/23/2018,10000,Vu9bOPZx,19000,more than downpayment,more than downpayment,0,4500
Vu9bOPZx,4500,11/25/2018,10000,Vu9bOPZx,23500,more than downpayment,more than downpayment,0,4500
Vu9bOPZx,4500,12/24/2018,10000,Vu9bOPZx,28000,more than downpayment,more than downpayment,0,4500
Vu9bOPZx,4500,1/30/2019,10000,Vu9bOPZx,32500,more than downpayment,more than downpayment,0,4500
Vu9bOPZx,4500,2/27/2019,10000,Vu9bOPZx,37000,more than downpayment,more than downpayment,0,4500
Vu9bOPZx,4500,3/25/2019,10000,Vu9bOPZx,41500,more than downpayment,more than downpayment,0,4500
Vu9bOPZx,4500,4/25/2019,10000,Vu9bOPZx,46000,more than downpayment,more than downpayment,0,4500
Vu9bOPZx,4500,5/25/2019,10000,Vu9bOPZx,50500,more than downpayment,more than downpayment,0,4500
Vu9bOPZx,4500,7/6/2019,10000,Vu9bOPZx,55000,more than downpayment,more than downpayment,0,4500
Vu9bOPZx,4500,7/26/2019,10000,Vu9bOPZx,59500,more than downpayment,more than downpayment,0,4500
Vu9bOPZx,4500,9/6/2019,10000,Vu9bOPZx,64000,more than downpayment,more than downpayment,0,4500
vuKAef55,3000,6/12/2017,3000,,3000,equal to downpayment,,3000,0
vuKAef55,2000,8/29/2017,3000,vuKAef55,5000,more than downpayment,equal to downpayment,0,2000
vuKAef55,2000,3/9/2018,3000,vuKAef55,7000,more than downpayment,more than downpayment,0,2000
vuKAef55,2000,4/20/2018,3000,vuKAef55,9000,more than downpayment,more than downpayment,0,2000
vuKAef55,2000,5/15/2018,3000,vuKAef55,11000,more than downpayment,more than downpayment,0,2000
vuKAef55,2000,6/15/2018,3000,vuKAef55,13000,more than downpayment,more than downpayment,0,2000
vuKAef55,2000,7/21/2018,3000,vuKAef55,15000,more than downpayment,more than downpayment,0,2000
vuKAef55,2000,9/30/2018,3000,vuKAef55,17000,more than downpayment,more than downpayment,0,2000
vuKAef55,2000,10/21/2018,3000,vuKAef55,19000,more than downpayment,more than downpayment,0,2000
vuKAef55,1000,12/14/2018,3000,vuKAef55,20000,more than downpayment,more than downpayment,0,1000
vuKAef55,5000,12/4/2019,3000,vuKAef55,25000,more than downpayment,more than downpayment,0,5000
VUn3O9Bu,8800,7/3/2019,9900,,8800,less than downpayment,,8800,0
VUn3O9Bu,1100,7/5/2019,9900,VUn3O9Bu,9900,equal to downpayment,less than downpayment,1100,0
VUn3O9Bu,11700,8/26/2019,9900,VUn3O9Bu,21600,more than downpayment,equal to downpayment,0,11700
VUn3O9Bu,11700,11/28/2019,9900,VUn3O9Bu,33300,more than downpayment,more than downpayment,0,11700
vuNYCMMI,10000,12/6/2017,14500,,10000,less than downpayment,,10000,0
vuNYCMMI,4500,2/16/2018,14500,vuNYCMMI,14500,equal to downpayment,less than downpayment,4500,0
vuNYCMMI,6000,3/19/2018,14500,vuNYCMMI,20500,more than downpayment,equal to downpayment,0,6000
vuNYCMMI,6000,4/19/2018,14500,vuNYCMMI,26500,more than downpayment,more than downpayment,0,6000
vuNYCMMI,6000,6/4/2018,14500,vuNYCMMI,32500,more than downpayment,more than downpayment,0,6000
vuNYCMMI,2000,10/15/2018,14500,vuNYCMMI,34500,more than downpayment,more than downpayment,0,2000
VUXQ8VYU,14000,11/13/2019,9900,,14000,more than downpayment,,9900,4100
VV62ZKNT,1594,10/14/2019,1594,,1594,equal to downpayment,,1594,0
VV62ZKNT,3500,11/12/2019,1594,VV62ZKNT,5094,more than downpayment,equal to downpayment,0,3500
VV62ZKNT,3500,1/16/2020,1594,VV62ZKNT,8594,more than downpayment,more than downpayment,0,3500
VVLQHFNF,9900,1/6/2020,9900,,9900,equal to downpayment,,9900,0
VVTKOK7G,9900,1/11/2020,9900,,9900,equal to downpayment,,9900,0
VW7B29EL,9900,10/29/2019,9900,,9900,equal to downpayment,,9900,0
VW7B29EL,3900,11/26/2019,9900,VW7B29EL,13800,more than downpayment,equal to downpayment,0,3900
VW7B29EL,3900,12/30/2019,9900,VW7B29EL,17700,more than downpayment,more than downpayment,0,3900
VW7B29EL,7800,1/21/2020,9900,VW7B29EL,25500,more than downpayment,more than downpayment,0,7800
VWMLWL3J,1000,10/10/2019,8900,,1000,less than downpayment,,1000,0
VX1qDTEd,8900,8/30/2019,8900,,8900,equal to downpayment,,8900,0
VX1qDTEd,3900,12/2/2019,8900,VX1qDTEd,12800,more than downpayment,equal to downpayment,0,3900
VX1qDTEd,3900,1/6/2020,8900,VX1qDTEd,16700,more than downpayment,more than downpayment,0,3900
VXKWNVXJ,9900,12/10/2019,9900,,9900,equal to downpayment,,9900,0
VXTB6RZF,8900,12/4/2019,8900,,8900,equal to downpayment,,8900,0
VXTB6RZF,3900,1/23/2020,8900,VXTB6RZF,12800,more than downpayment,equal to downpayment,0,3900
VY8DFQ7D,10000,12/30/2019,9900,,10000,more than downpayment,,9900,100
vyrSkv05,8900,2/12/2019,8900,,8900,equal to downpayment,,8900,0
vyrSkv05,3900,2/24/2019,8900,vyrSkv05,12800,more than downpayment,equal to downpayment,0,3900
vyrSkv05,3900,3/15/2019,8900,vyrSkv05,16700,more than downpayment,more than downpayment,0,3900
vyrSkv05,3900,4/30/2019,8900,vyrSkv05,20600,more than downpayment,more than downpayment,0,3900
vyrSkv05,7800,5/24/2019,8900,vyrSkv05,28400,more than downpayment,more than downpayment,0,7800
vyrSkv05,7800,6/29/2019,8900,vyrSkv05,36200,more than downpayment,more than downpayment,0,7800
vyrSkv05,7800,7/31/2019,8900,vyrSkv05,44000,more than downpayment,more than downpayment,0,7800
vyrSkv05,3900,8/16/2019,8900,vyrSkv05,47900,more than downpayment,more than downpayment,0,3900
vyrSkv05,3900,10/28/2019,8900,vyrSkv05,51800,more than downpayment,more than downpayment,0,3900
vyrSkv05,3900,12/14/2019,8900,vyrSkv05,55700,more than downpayment,more than downpayment,0,3900
vyrSkv05,3900,1/16/2020,8900,vyrSkv05,59600,more than downpayment,more than downpayment,0,3900
vyrSkv05,3900,1/24/2020,8900,vyrSkv05,63500,more than downpayment,more than downpayment,0,3900
VYYKAFKC,9900,6/10/2019,9900,,9900,equal to downpayment,,9900,0
VYYKAFKC,3900,7/25/2019,9900,VYYKAFKC,13800,more than downpayment,equal to downpayment,0,3900
VYYKAFKC,3900,9/2/2019,9900,VYYKAFKC,17700,more than downpayment,more than downpayment,0,3900
VYYKAFKC,3900,10/28/2019,9900,VYYKAFKC,21600,more than downpayment,more than downpayment,0,3900
VYYKAFKC,5000,1/8/2020,9900,VYYKAFKC,26600,more than downpayment,more than downpayment,0,5000
VZKAWG2B,9900,9/26/2019,9900,,9900,equal to downpayment,,9900,0
VZKAWG2B,6000,1/12/2020,9900,VZKAWG2B,15900,more than downpayment,equal to downpayment,0,6000
VZKAWG2B,1970,1/28/2020,9900,VZKAWG2B,17870,more than downpayment,more than downpayment,0,1970
vZMGhhT0,9900,11/9/2018,9900,,9900,equal to downpayment,,9900,0
vZMGhhT0,4500,1/17/2019,9900,vZMGhhT0,14400,more than downpayment,equal to downpayment,0,4500
vZMGhhT0,4500,1/30/2019,9900,vZMGhhT0,18900,more than downpayment,more than downpayment,0,4500
VZO7X37G,10000,1/5/2020,9900,,10000,more than downpayment,,9900,100
w0r69gp5,8900,12/17/2018,8900,,8900,equal to downpayment,,8900,0
w0r69gp5,3900,2/26/2019,8900,w0r69gp5,12800,more than downpayment,equal to downpayment,0,3900
w0r69gp5,3900,3/25/2019,8900,w0r69gp5,16700,more than downpayment,more than downpayment,0,3900
w0r69gp5,2000,4/8/2019,8900,w0r69gp5,18700,more than downpayment,more than downpayment,0,2000
w0r69gp5,1900,4/25/2019,8900,w0r69gp5,20600,more than downpayment,more than downpayment,0,1900
w0r69gp5,3900,5/25/2019,8900,w0r69gp5,24500,more than downpayment,more than downpayment,0,3900
w0r69gp5,2000,6/4/2019,8900,w0r69gp5,26500,more than downpayment,more than downpayment,0,2000
w0r69gp5,1900,6/10/2019,8900,w0r69gp5,28400,more than downpayment,more than downpayment,0,1900
w0r69gp5,3900,7/26/2019,8900,w0r69gp5,32300,more than downpayment,more than downpayment,0,3900
w0r69gp5,4000,10/7/2019,8900,w0r69gp5,36300,more than downpayment,more than downpayment,0,4000
w0r69gp5,11700,11/26/2019,8900,w0r69gp5,48000,more than downpayment,more than downpayment,0,11700
w0r69gp5,1000,12/28/2019,8900,w0r69gp5,49000,more than downpayment,more than downpayment,0,1000
w0r69gp5,1000,1/23/2020,8900,w0r69gp5,50000,more than downpayment,more than downpayment,0,1000
w0r69gp5,1000,1/30/2020,8900,w0r69gp5,51000,more than downpayment,more than downpayment,0,1000
w0r69gp5,1500,2/9/2020,8900,w0r69gp5,52500,more than downpayment,more than downpayment,0,1500
W1iaUwAh,10000,7/19/2018,10000,,10000,equal to downpayment,,10000,0
W1iaUwAh,4500,8/25/2018,10000,W1iaUwAh,14500,more than downpayment,equal to downpayment,0,4500
W1iaUwAh,4500,9/24/2018,10000,W1iaUwAh,19000,more than downpayment,more than downpayment,0,4500
W1iaUwAh,4500,10/25/2018,10000,W1iaUwAh,23500,more than downpayment,more than downpayment,0,4500
W1iaUwAh,4500,11/25/2018,10000,W1iaUwAh,28000,more than downpayment,more than downpayment,0,4500
W1iaUwAh,4500,12/25/2018,10000,W1iaUwAh,32500,more than downpayment,more than downpayment,0,4500
W1iaUwAh,4500,1/25/2019,10000,W1iaUwAh,37000,more than downpayment,more than downpayment,0,4500
W1iaUwAh,4500,2/25/2019,10000,W1iaUwAh,41500,more than downpayment,more than downpayment,0,4500
W1iaUwAh,4500,3/25/2019,10000,W1iaUwAh,46000,more than downpayment,more than downpayment,0,4500
W1iaUwAh,4500,4/25/2019,10000,W1iaUwAh,50500,more than downpayment,more than downpayment,0,4500
W1iaUwAh,4500,5/25/2019,10000,W1iaUwAh,55000,more than downpayment,more than downpayment,0,4500
W1iaUwAh,4500,6/25/2019,10000,W1iaUwAh,59500,more than downpayment,more than downpayment,0,4500
W1iaUwAh,4500,7/25/2019,10000,W1iaUwAh,64000,more than downpayment,more than downpayment,0,4500
w1x0OWDg,8900,3/7/2019,8900,,8900,equal to downpayment,,8900,0
W2HVTTDY,8900,12/30/2019,9900,,8900,less than downpayment,,8900,0
W2HVTTDY,1000,1/9/2020,9900,W2HVTTDY,9900,equal to downpayment,less than downpayment,1000,0
w2IabUyt,8900,3/25/2019,8900,,8900,equal to downpayment,,8900,0
w2IabUyt,3900,5/6/2019,8900,w2IabUyt,12800,more than downpayment,equal to downpayment,0,3900
w2IabUyt,3900,6/6/2019,8900,w2IabUyt,16700,more than downpayment,more than downpayment,0,3900
w2IabUyt,3900,7/8/2019,8900,w2IabUyt,20600,more than downpayment,more than downpayment,0,3900
w2IabUyt,3900,8/8/2019,8900,w2IabUyt,24500,more than downpayment,more than downpayment,0,3900
w2IabUyt,3900,9/12/2019,8900,w2IabUyt,28400,more than downpayment,more than downpayment,0,3900
w2IabUyt,3900,10/7/2019,8900,w2IabUyt,32300,more than downpayment,more than downpayment,0,3900
w2IabUyt,3900,11/8/2019,8900,w2IabUyt,36200,more than downpayment,more than downpayment,0,3900
w2IabUyt,3900,12/16/2019,8900,w2IabUyt,40100,more than downpayment,more than downpayment,0,3900
w2IabUyt,3900,1/13/2020,8900,w2IabUyt,44000,more than downpayment,more than downpayment,0,3900
w69TlyhR,8900,2/5/2019,8900,,8900,equal to downpayment,,8900,0
w69TlyhR,3900,3/20/2019,8900,w69TlyhR,12800,more than downpayment,equal to downpayment,0,3900
w69TlyhR,3900,5/8/2019,8900,w69TlyhR,16700,more than downpayment,more than downpayment,0,3900
w69TlyhR,7800,7/3/2019,8900,w69TlyhR,24500,more than downpayment,more than downpayment,0,7800
w69TlyhR,3900,8/28/2019,8900,w69TlyhR,28400,more than downpayment,more than downpayment,0,3900
w69TlyhR,2000,9/5/2019,8900,w69TlyhR,30400,more than downpayment,more than downpayment,0,2000
w69TlyhR,4000,10/18/2019,8900,w69TlyhR,34400,more than downpayment,more than downpayment,0,4000
w69TlyhR,5800,12/7/2019,8900,w69TlyhR,40200,more than downpayment,more than downpayment,0,5800
w69TlyhR,700,12/10/2019,8900,w69TlyhR,40900,more than downpayment,more than downpayment,0,700
w69TlyhR,1500,12/17/2019,8900,w69TlyhR,42400,more than downpayment,more than downpayment,0,1500
w69TlyhR,7000,1/22/2020,8900,w69TlyhR,49400,more than downpayment,more than downpayment,0,7000
w69TlyhR,2250,2/3/2020,8900,w69TlyhR,51650,more than downpayment,more than downpayment,0,2250
w69TlyhR,150,2/6/2020,8900,w69TlyhR,51800,more than downpayment,more than downpayment,0,150
W7BKB56H,9900,6/10/2019,8900,,9900,more than downpayment,,8900,1000
W7BKB56H,3900,8/5/2019,8900,W7BKB56H,13800,more than downpayment,more than downpayment,0,3900
W7BKB56H,3900,9/9/2019,8900,W7BKB56H,17700,more than downpayment,more than downpayment,0,3900
W7BKB56H,3900,10/7/2019,8900,W7BKB56H,21600,more than downpayment,more than downpayment,0,3900
W7BKB56H,3900,11/6/2019,8900,W7BKB56H,25500,more than downpayment,more than downpayment,0,3900
W7BKB56H,3900,12/5/2019,8900,W7BKB56H,29400,more than downpayment,more than downpayment,0,3900
W7BKB56H,3900,1/3/2020,8900,W7BKB56H,33300,more than downpayment,more than downpayment,0,3900
W7BKB56H,3900,2/5/2020,8900,W7BKB56H,37200,more than downpayment,more than downpayment,0,3900
w8R87npK,9900,7/11/2019,9900,,9900,equal to downpayment,,9900,0
w8R87npK,3900,9/5/2019,9900,w8R87npK,13800,more than downpayment,equal to downpayment,0,3900
w8R87npK,3900,10/8/2019,9900,w8R87npK,17700,more than downpayment,more than downpayment,0,3900
w8R87npK,2200,11/7/2019,9900,w8R87npK,19900,more than downpayment,more than downpayment,0,2200
w8R87npK,1700,11/11/2019,9900,w8R87npK,21600,more than downpayment,more than downpayment,0,1700
w8R87npK,3900,12/14/2019,9900,w8R87npK,25500,more than downpayment,more than downpayment,0,3900
w8R87npK,2600,1/24/2020,9900,w8R87npK,28100,more than downpayment,more than downpayment,0,2600
w8R87npK,1300,1/28/2020,9900,w8R87npK,29400,more than downpayment,more than downpayment,0,1300
W9BEUEUU,7900,12/31/2019,7900,,7900,equal to downpayment,,7900,0
W9DT1AER,10000,6/29/2019,9900,,10000,more than downpayment,,9900,100
W9DT1AER,2200,9/9/2019,9900,W9DT1AER,12200,more than downpayment,more than downpayment,0,2200
W9DT1AER,4000,10/21/2019,9900,W9DT1AER,16200,more than downpayment,more than downpayment,0,4000
W9DT1AER,5400,10/29/2019,9900,W9DT1AER,21600,more than downpayment,more than downpayment,0,5400
W9DT1AER,1000,11/28/2019,9900,W9DT1AER,22600,more than downpayment,more than downpayment,0,1000
W9DT1AER,1900,12/11/2019,9900,W9DT1AER,24500,more than downpayment,more than downpayment,0,1900
W9FJ23JR,9900,9/21/2019,9900,,9900,equal to downpayment,,9900,0
W9FJ23JR,3900,10/20/2019,9900,W9FJ23JR,13800,more than downpayment,equal to downpayment,0,3900
W9FJ23JR,3900,11/6/2019,9900,W9FJ23JR,17700,more than downpayment,more than downpayment,0,3900
W9FJ23JR,3900,12/5/2019,9900,W9FJ23JR,21600,more than downpayment,more than downpayment,0,3900
W9FJ23JR,11700,1/27/2020,9900,W9FJ23JR,33300,more than downpayment,more than downpayment,0,11700
W9P2XXIE,9900,11/20/2019,9900,,9900,equal to downpayment,,9900,0
W9P2XXIE,1000,1/21/2020,9900,W9P2XXIE,10900,more than downpayment,equal to downpayment,0,1000
W9P2XXIE,400,1/23/2020,9900,W9P2XXIE,11300,more than downpayment,more than downpayment,0,400
W9P2XXIE,1000,1/28/2020,9900,W9P2XXIE,12300,more than downpayment,more than downpayment,0,1000
W9P2XXIE,500,1/29/2020,9900,W9P2XXIE,12800,more than downpayment,more than downpayment,0,500
W9P2XXIE,600,2/3/2020,9900,W9P2XXIE,13400,more than downpayment,more than downpayment,0,600
W9P2XXIE,400,2/4/2020,9900,W9P2XXIE,13800,more than downpayment,more than downpayment,0,400
WA597SYV,7900,12/1/2019,7900,,7900,equal to downpayment,,7900,0
wa7C7lRQ,8900,5/29/2019,8900,,8900,equal to downpayment,,8900,0
wa7C7lRQ,1000,7/25/2019,8900,wa7C7lRQ,9900,more than downpayment,equal to downpayment,0,1000
wa7C7lRQ,500,8/1/2019,8900,wa7C7lRQ,10400,more than downpayment,more than downpayment,0,500
wa7C7lRQ,2400,8/6/2019,8900,wa7C7lRQ,12800,more than downpayment,more than downpayment,0,2400
wa7C7lRQ,300,8/13/2019,8900,wa7C7lRQ,13100,more than downpayment,more than downpayment,0,300
wa7C7lRQ,700,8/23/2019,8900,wa7C7lRQ,13800,more than downpayment,more than downpayment,0,700
wa7C7lRQ,1000,8/30/2019,8900,wa7C7lRQ,14800,more than downpayment,more than downpayment,0,1000
wa7C7lRQ,1900,9/5/2019,8900,wa7C7lRQ,16700,more than downpayment,more than downpayment,0,1900
wa7C7lRQ,2000,10/9/2019,8900,wa7C7lRQ,18700,more than downpayment,more than downpayment,0,2000
wapC8Pwi,10000,7/18/2018,10000,,10000,equal to downpayment,,10000,0
wapC8Pwi,4100,9/27/2018,10000,wapC8Pwi,14100,more than downpayment,equal to downpayment,0,4100
wapC8Pwi,400,10/5/2018,10000,wapC8Pwi,14500,more than downpayment,more than downpayment,0,400
wapC8Pwi,2500,11/12/2018,10000,wapC8Pwi,17000,more than downpayment,more than downpayment,0,2500
WAQ2AXQQ,10000,8/28/2019,8900,,10000,more than downpayment,,8900,1100
WAQ2AXQQ,5000,11/7/2019,8900,WAQ2AXQQ,15000,more than downpayment,more than downpayment,0,5000
WAQ2AXQQ,3900,12/6/2019,8900,WAQ2AXQQ,18900,more than downpayment,more than downpayment,0,3900
WAQ2AXQQ,4000,1/6/2020,8900,WAQ2AXQQ,22900,more than downpayment,more than downpayment,0,4000
WAQ2AXQQ,3900,2/6/2020,8900,WAQ2AXQQ,26800,more than downpayment,more than downpayment,0,3900
waXmSgCZ,10000,1/31/2019,8900,,10000,more than downpayment,,8900,1100
waXmSgCZ,2800,3/15/2019,8900,waXmSgCZ,12800,more than downpayment,more than downpayment,0,2800
waXmSgCZ,3900,4/15/2019,8900,waXmSgCZ,16700,more than downpayment,more than downpayment,0,3900
waXmSgCZ,3900,5/15/2019,8900,waXmSgCZ,20600,more than downpayment,more than downpayment,0,3900
waXmSgCZ,2200,6/15/2019,8900,waXmSgCZ,22800,more than downpayment,more than downpayment,0,2200
waXmSgCZ,1700,6/16/2019,8900,waXmSgCZ,24500,more than downpayment,more than downpayment,0,1700
waXmSgCZ,3900,7/15/2019,8900,waXmSgCZ,28400,more than downpayment,more than downpayment,0,3900
waXmSgCZ,3900,8/15/2019,8900,waXmSgCZ,32300,more than downpayment,more than downpayment,0,3900
waXmSgCZ,3900,9/15/2019,8900,waXmSgCZ,36200,more than downpayment,more than downpayment,0,3900
waXmSgCZ,3900,10/15/2019,8900,waXmSgCZ,40100,more than downpayment,more than downpayment,0,3900
waXmSgCZ,3900,11/14/2019,8900,waXmSgCZ,44000,more than downpayment,more than downpayment,0,3900
waXmSgCZ,3900,12/14/2019,8900,waXmSgCZ,47900,more than downpayment,more than downpayment,0,3900
waXmSgCZ,3900,1/27/2020,8900,waXmSgCZ,51800,more than downpayment,more than downpayment,0,3900
wcTrX8zS,30000,9/15/2017,10000,,30000,more than downpayment,,10000,20000
wcTrX8zS,20000,9/20/2017,10000,wcTrX8zS,50000,more than downpayment,more than downpayment,0,20000
wcTrX8zS,10000,2/8/2018,10000,wcTrX8zS,60000,more than downpayment,more than downpayment,0,10000
wcTrX8zS,10000,3/21/2018,10000,wcTrX8zS,70000,more than downpayment,more than downpayment,0,10000
wcTrX8zS,10000,5/1/2018,10000,wcTrX8zS,80000,more than downpayment,more than downpayment,0,10000
wcTrX8zS,10000,5/31/2018,10000,wcTrX8zS,90000,more than downpayment,more than downpayment,0,10000
WD2FJEEY,8900,7/22/2019,8900,,8900,equal to downpayment,,8900,0
WD2FJEEY,7800,8/10/2019,8900,WD2FJEEY,16700,more than downpayment,equal to downpayment,0,7800
WD2FJEEY,3900,9/4/2019,8900,WD2FJEEY,20600,more than downpayment,more than downpayment,0,3900
WD2FJEEY,3900,10/5/2019,8900,WD2FJEEY,24500,more than downpayment,more than downpayment,0,3900
WD2FJEEY,39000,2/3/2020,8900,WD2FJEEY,63500,more than downpayment,more than downpayment,0,39000
wdErbp1r,8900,7/1/2019,8900,,8900,equal to downpayment,,8900,0
wdErbp1r,4000,8/30/2019,8900,wdErbp1r,12900,more than downpayment,equal to downpayment,0,4000
wdErbp1r,3900,9/28/2019,8900,wdErbp1r,16800,more than downpayment,more than downpayment,0,3900
wdErbp1r,3900,10/30/2019,8900,wdErbp1r,20700,more than downpayment,more than downpayment,0,3900
wDHKVZEm,9900,7/20/2019,9900,,9900,equal to downpayment,,9900,0
wDHKVZEm,3000,9/11/2019,9900,wDHKVZEm,12900,more than downpayment,equal to downpayment,0,3000
wDHKVZEm,900,9/30/2019,9900,wDHKVZEm,13800,more than downpayment,more than downpayment,0,900
wDHKVZEm,2000,11/4/2019,9900,wDHKVZEm,15800,more than downpayment,more than downpayment,0,2000
wDHKVZEm,1000,12/9/2019,9900,wDHKVZEm,16800,more than downpayment,more than downpayment,0,1000
wDHKVZEm,4800,12/16/2019,9900,wDHKVZEm,21600,more than downpayment,more than downpayment,0,4800
wDHKVZEm,3000,1/6/2020,9900,wDHKVZEm,24600,more than downpayment,more than downpayment,0,3000
wDHKVZEm,1600,2/5/2020,9900,wDHKVZEm,26200,more than downpayment,more than downpayment,0,1600
wDHKVZEm,500,2/8/2020,9900,wDHKVZEm,26700,more than downpayment,more than downpayment,0,500
WDKOSXTZ,8900,7/30/2019,9900,,8900,less than downpayment,,8900,0
WDKOSXTZ,1000,8/21/2019,9900,WDKOSXTZ,9900,equal to downpayment,less than downpayment,1000,0
WDKOSXTZ,3900,9/16/2019,9900,WDKOSXTZ,13800,more than downpayment,equal to downpayment,0,3900
WDKOSXTZ,3900,10/9/2019,9900,WDKOSXTZ,17700,more than downpayment,more than downpayment,0,3900
WDKOSXTZ,3900,11/22/2019,9900,WDKOSXTZ,21600,more than downpayment,more than downpayment,0,3900
WDKOSXTZ,3900,12/18/2019,9900,WDKOSXTZ,25500,more than downpayment,more than downpayment,0,3900
WDKOSXTZ,3900,1/25/2020,9900,WDKOSXTZ,29400,more than downpayment,more than downpayment,0,3900
WDRB86P5,7900,10/29/2019,7900,,7900,equal to downpayment,,7900,0
WDRB86P5,3100,12/5/2019,7900,WDRB86P5,11000,more than downpayment,equal to downpayment,0,3100
WDRB86P5,3100,1/18/2020,7900,WDRB86P5,14100,more than downpayment,more than downpayment,0,3100
WDRB86P5,3100,2/5/2020,7900,WDRB86P5,17200,more than downpayment,more than downpayment,0,3100
WEN98TAX,8900,9/30/2019,8900,,8900,equal to downpayment,,8900,0
WEN98TAX,3900,11/3/2019,8900,WEN98TAX,12800,more than downpayment,equal to downpayment,0,3900
WEN98TAX,3900,12/3/2019,8900,WEN98TAX,16700,more than downpayment,more than downpayment,0,3900
WEN98TAX,3900,1/2/2020,8900,WEN98TAX,20600,more than downpayment,more than downpayment,0,3900
WEN98TAX,3900,2/3/2020,8900,WEN98TAX,24500,more than downpayment,more than downpayment,0,3900
WEUObELW,8900,12/5/2018,8900,,8900,equal to downpayment,,8900,0
WEUObELW,4000,1/21/2019,8900,WEUObELW,12900,more than downpayment,equal to downpayment,0,4000
WEUObELW,4000,2/22/2019,8900,WEUObELW,16900,more than downpayment,more than downpayment,0,4000
WEUObELW,4000,3/26/2019,8900,WEUObELW,20900,more than downpayment,more than downpayment,0,4000
WEUObELW,3900,4/29/2019,8900,WEUObELW,24800,more than downpayment,more than downpayment,0,3900
WEUObELW,3900,5/28/2019,8900,WEUObELW,28700,more than downpayment,more than downpayment,0,3900
WEUObELW,3600,7/5/2019,8900,WEUObELW,32300,more than downpayment,more than downpayment,0,3600
WEUObELW,3000,7/26/2019,8900,WEUObELW,35300,more than downpayment,more than downpayment,0,3000
WEUObELW,900,7/28/2019,8900,WEUObELW,36200,more than downpayment,more than downpayment,0,900
WEUObELW,4000,8/23/2019,8900,WEUObELW,40200,more than downpayment,more than downpayment,0,4000
WEUObELW,3900,9/21/2019,8900,WEUObELW,44100,more than downpayment,more than downpayment,0,3900
WEUObELW,3900,10/24/2019,8900,WEUObELW,48000,more than downpayment,more than downpayment,0,3900
WEUObELW,3900,11/24/2019,8900,WEUObELW,51900,more than downpayment,more than downpayment,0,3900
WEUObELW,3800,12/31/2019,8900,WEUObELW,55700,more than downpayment,more than downpayment,0,3800
WEUObELW,3900,1/31/2020,8900,WEUObELW,59600,more than downpayment,more than downpayment,0,3900
Wf0PCMEs,9900,8/19/2019,9900,,9900,equal to downpayment,,9900,0
Wf0PCMEs,3900,10/2/2019,9900,Wf0PCMEs,13800,more than downpayment,equal to downpayment,0,3900
Wf0PCMEs,3900,11/6/2019,9900,Wf0PCMEs,17700,more than downpayment,more than downpayment,0,3900
Wf0PCMEs,3900,12/3/2019,9900,Wf0PCMEs,21600,more than downpayment,more than downpayment,0,3900
Wf0PCMEs,3900,1/2/2020,9900,Wf0PCMEs,25500,more than downpayment,more than downpayment,0,3900
Wf0PCMEs,3900,2/6/2020,9900,Wf0PCMEs,29400,more than downpayment,more than downpayment,0,3900
WFEDMY45,1594,10/14/2019,1594,,1594,equal to downpayment,,1594,0
WFEDMY45,3100,12/16/2019,1594,WFEDMY45,4694,more than downpayment,equal to downpayment,0,3100
WFEDMY45,3100,1/18/2020,1594,WFEDMY45,7794,more than downpayment,more than downpayment,0,3100
WFKF5KP9,9900,2/5/2020,9900,,9900,equal to downpayment,,9900,0
wFVBr4uL,8900,1/9/2019,8900,,8900,equal to downpayment,,8900,0
wFVBr4uL,3900,2/20/2019,8900,wFVBr4uL,12800,more than downpayment,equal to downpayment,0,3900
wFVBr4uL,3900,3/24/2019,8900,wFVBr4uL,16700,more than downpayment,more than downpayment,0,3900
wFVBr4uL,3900,4/25/2019,8900,wFVBr4uL,20600,more than downpayment,more than downpayment,0,3900
wFVBr4uL,3550,5/30/2019,8900,wFVBr4uL,24150,more than downpayment,more than downpayment,0,3550
wFVBr4uL,350,6/6/2019,8900,wFVBr4uL,24500,more than downpayment,more than downpayment,0,350
wFVBr4uL,3000,6/22/2019,8900,wFVBr4uL,27500,more than downpayment,more than downpayment,0,3000
wFVBr4uL,1000,8/10/2019,8900,wFVBr4uL,28500,more than downpayment,more than downpayment,0,1000
wFVBr4uL,4000,9/2/2019,8900,wFVBr4uL,32500,more than downpayment,more than downpayment,0,4000
wFVBr4uL,2000,10/17/2019,8900,wFVBr4uL,34500,more than downpayment,more than downpayment,0,2000
wFVBr4uL,2000,10/22/2019,8900,wFVBr4uL,36500,more than downpayment,more than downpayment,0,2000
wFVBr4uL,7600,10/25/2019,8900,wFVBr4uL,44100,more than downpayment,more than downpayment,0,7600
wFVBr4uL,3900,11/21/2019,8900,wFVBr4uL,48000,more than downpayment,more than downpayment,0,3900
wFVBr4uL,3900,12/14/2019,8900,wFVBr4uL,51900,more than downpayment,more than downpayment,0,3900
wFVBr4uL,3900,1/31/2020,8900,wFVBr4uL,55800,more than downpayment,more than downpayment,0,3900
WFYmYcce,10000,7/25/2019,9900,,10000,more than downpayment,,9900,100
WFYmYcce,3900,9/22/2019,9900,WFYmYcce,13900,more than downpayment,more than downpayment,0,3900
WFYmYcce,3900,10/31/2019,9900,WFYmYcce,17800,more than downpayment,more than downpayment,0,3900
WFYmYcce,2000,12/4/2019,9900,WFYmYcce,19800,more than downpayment,more than downpayment,0,2000
WFYmYcce,1800,12/5/2019,9900,WFYmYcce,21600,more than downpayment,more than downpayment,0,1800
WFYmYcce,800,12/25/2019,9900,WFYmYcce,22400,more than downpayment,more than downpayment,0,800
WFYmYcce,3100,1/5/2020,9900,WFYmYcce,25500,more than downpayment,more than downpayment,0,3100
WFYmYcce,3900,1/20/2020,9900,WFYmYcce,29400,more than downpayment,more than downpayment,0,3900
WGa5VJ5l,2000,7/6/2019,1999,,2000,more than downpayment,,1999,1
WGa5VJ5l,2000,9/24/2019,1999,WGa5VJ5l,4000,more than downpayment,more than downpayment,0,2000
WGa5VJ5l,2000,10/27/2019,1999,WGa5VJ5l,6000,more than downpayment,more than downpayment,0,2000
WGa5VJ5l,2000,11/28/2019,1999,WGa5VJ5l,8000,more than downpayment,more than downpayment,0,2000
WGa5VJ5l,1950,1/10/2020,1999,WGa5VJ5l,9950,more than downpayment,more than downpayment,0,1950
WGa5VJ5l,2045,1/30/2020,1999,WGa5VJ5l,11995,more than downpayment,more than downpayment,0,2045
WGJWE6PZ,1594,10/14/2019,1594,,1594,equal to downpayment,,1594,0
WGJWE6PZ,1100,1/10/2020,1594,WGJWE6PZ,2694,more than downpayment,equal to downpayment,0,1100
WGJWE6PZ,1000,1/13/2020,1594,WGJWE6PZ,3694,more than downpayment,more than downpayment,0,1000
WGJWE6PZ,1000,1/20/2020,1594,WGJWE6PZ,4694,more than downpayment,more than downpayment,0,1000
WGJWE6PZ,1000,1/29/2020,1594,WGJWE6PZ,5694,more than downpayment,more than downpayment,0,1000
WGJWE6PZ,1000,1/30/2020,1594,WGJWE6PZ,6694,more than downpayment,more than downpayment,0,1000
WGJWE6PZ,1100,1/31/2020,1594,WGJWE6PZ,7794,more than downpayment,more than downpayment,0,1100
wGNDDl5z,8900,5/2/2019,8900,,8900,equal to downpayment,,8900,0
wGNDDl5z,3900,6/1/2019,8900,wGNDDl5z,12800,more than downpayment,equal to downpayment,0,3900
wGNDDl5z,3900,7/1/2019,8900,wGNDDl5z,16700,more than downpayment,more than downpayment,0,3900
wGNDDl5z,3900,7/19/2019,8900,wGNDDl5z,20600,more than downpayment,more than downpayment,0,3900
wGNDDl5z,3900,8/4/2019,8900,wGNDDl5z,24500,more than downpayment,more than downpayment,0,3900
wGNDDl5z,3900,9/4/2019,8900,wGNDDl5z,28400,more than downpayment,more than downpayment,0,3900
wGNDDl5z,3900,9/27/2019,8900,wGNDDl5z,32300,more than downpayment,more than downpayment,0,3900
wGNDDl5z,3900,11/3/2019,8900,wGNDDl5z,36200,more than downpayment,more than downpayment,0,3900
wGNDDl5z,3900,11/27/2019,8900,wGNDDl5z,40100,more than downpayment,more than downpayment,0,3900
wGNDDl5z,3900,1/3/2020,8900,wGNDDl5z,44000,more than downpayment,more than downpayment,0,3900
wGNDDl5z,3900,2/4/2020,8900,wGNDDl5z,47900,more than downpayment,more than downpayment,0,3900
WINDeQ48,10000,1/8/2019,10000,,10000,equal to downpayment,,10000,0
WINDeQ48,4500,2/18/2019,10000,WINDeQ48,14500,more than downpayment,equal to downpayment,0,4500
WINDeQ48,4500,3/19/2019,10000,WINDeQ48,19000,more than downpayment,more than downpayment,0,4500
WINDeQ48,3500,5/6/2019,10000,WINDeQ48,22500,more than downpayment,more than downpayment,0,3500
WINDeQ48,3000,5/22/2019,10000,WINDeQ48,25500,more than downpayment,more than downpayment,0,3000
WINDeQ48,1400,6/12/2019,10000,WINDeQ48,26900,more than downpayment,more than downpayment,0,1400
WINDeQ48,1100,6/17/2019,10000,WINDeQ48,28000,more than downpayment,more than downpayment,0,1100
WINDeQ48,2000,7/30/2019,10000,WINDeQ48,30000,more than downpayment,more than downpayment,0,2000
WINDeQ48,1500,8/9/2019,10000,WINDeQ48,31500,more than downpayment,more than downpayment,0,1500
WINDeQ48,1000,8/12/2019,10000,WINDeQ48,32500,more than downpayment,more than downpayment,0,1000
WINDeQ48,3000,8/30/2019,10000,WINDeQ48,35500,more than downpayment,more than downpayment,0,3000
WINDeQ48,5000,9/17/2019,10000,WINDeQ48,40500,more than downpayment,more than downpayment,0,5000
WINDeQ48,3000,10/3/2019,10000,WINDeQ48,43500,more than downpayment,more than downpayment,0,3000
WINDeQ48,1000,10/15/2019,10000,WINDeQ48,44500,more than downpayment,more than downpayment,0,1000
WINDeQ48,1000,11/11/2019,10000,WINDeQ48,45500,more than downpayment,more than downpayment,0,1000
WINDeQ48,1000,12/10/2019,10000,WINDeQ48,46500,more than downpayment,more than downpayment,0,1000
WINDeQ48,1000,12/24/2019,10000,WINDeQ48,47500,more than downpayment,more than downpayment,0,1000
WINDeQ48,2430,1/21/2020,10000,WINDeQ48,49930,more than downpayment,more than downpayment,0,2430
WIVDZJR8,13840,10/29/2019,9900,,13840,more than downpayment,,9900,3940
Wjrp4S3e,9900,1/21/2019,9900,,9900,equal to downpayment,,9900,0
Wjrp4S3e,4000,2/27/2019,9900,Wjrp4S3e,13900,more than downpayment,equal to downpayment,0,4000
Wjrp4S3e,3900,3/29/2019,9900,Wjrp4S3e,17800,more than downpayment,more than downpayment,0,3900
Wjrp4S3e,7800,5/22/2019,9900,Wjrp4S3e,25600,more than downpayment,more than downpayment,0,7800
Wjrp4S3e,3900,6/26/2019,9900,Wjrp4S3e,29500,more than downpayment,more than downpayment,0,3900
Wjrp4S3e,3900,7/26/2019,9900,Wjrp4S3e,33400,more than downpayment,more than downpayment,0,3900
Wjrp4S3e,3900,8/26/2019,9900,Wjrp4S3e,37300,more than downpayment,more than downpayment,0,3900
Wjrp4S3e,3900,9/27/2019,9900,Wjrp4S3e,41200,more than downpayment,more than downpayment,0,3900
Wjrp4S3e,3900,10/24/2019,9900,Wjrp4S3e,45100,more than downpayment,more than downpayment,0,3900
Wjrp4S3e,3900,12/3/2019,9900,Wjrp4S3e,49000,more than downpayment,more than downpayment,0,3900
Wjrp4S3e,4500,1/5/2020,9900,Wjrp4S3e,53500,more than downpayment,more than downpayment,0,4500
Wjrp4S3e,4500,1/30/2020,9900,Wjrp4S3e,58000,more than downpayment,more than downpayment,0,4500
WJZAPNJ4,9900,10/2/2019,9900,,9900,equal to downpayment,,9900,0
WJZAPNJ4,15000,11/15/2019,9900,WJZAPNJ4,24900,more than downpayment,equal to downpayment,0,15000
wKQ7WFsn,8900,5/15/2019,8900,,8900,equal to downpayment,,8900,0
wKQ7WFsn,3900,6/25/2019,8900,wKQ7WFsn,12800,more than downpayment,equal to downpayment,0,3900
wKQ7WFsn,3900,7/29/2019,8900,wKQ7WFsn,16700,more than downpayment,more than downpayment,0,3900
wKQ7WFsn,3900,8/26/2019,8900,wKQ7WFsn,20600,more than downpayment,more than downpayment,0,3900
wKQ7WFsn,3900,9/25/2019,8900,wKQ7WFsn,24500,more than downpayment,more than downpayment,0,3900
wKQ7WFsn,3900,10/28/2019,8900,wKQ7WFsn,28400,more than downpayment,more than downpayment,0,3900
wKQ7WFsn,3900,11/25/2019,8900,wKQ7WFsn,32300,more than downpayment,more than downpayment,0,3900
wKQ7WFsn,3900,12/31/2019,8900,wKQ7WFsn,36200,more than downpayment,more than downpayment,0,3900
WKTDOMSD,9900,1/18/2020,9900,,9900,equal to downpayment,,9900,0
WldLDbj4,8900,8/28/2019,8900,,8900,equal to downpayment,,8900,0
WldLDbj4,3900,11/8/2019,8900,WldLDbj4,12800,more than downpayment,equal to downpayment,0,3900
WldLDbj4,3900,12/31/2019,8900,WldLDbj4,16700,more than downpayment,more than downpayment,0,3900
WldLDbj4,3900,1/23/2020,8900,WldLDbj4,20600,more than downpayment,more than downpayment,0,3900
WLXETHNB,9900,10/29/2019,9900,,9900,equal to downpayment,,9900,0
WLXETHNB,3900,12/28/2019,9900,WLXETHNB,13800,more than downpayment,equal to downpayment,0,3900
WMQUW7IH,9900,11/15/2019,9900,,9900,equal to downpayment,,9900,0
WMQUW7IH,3900,1/28/2020,9900,WMQUW7IH,13800,more than downpayment,equal to downpayment,0,3900
WMUQINAA,3000,4/11/2017,6000,,3000,less than downpayment,,3000,0
WMUQINAA,3000,6/20/2017,6000,WMUQINAA,6000,equal to downpayment,less than downpayment,3000,0
WMUQINAA,2000,4/13/2018,6000,WMUQINAA,8000,more than downpayment,equal to downpayment,0,2000
WMUQINAA,2000,4/30/2018,6000,WMUQINAA,10000,more than downpayment,more than downpayment,0,2000
WMUQINAA,2000,9/3/2018,6000,WMUQINAA,12000,more than downpayment,more than downpayment,0,2000
WMUQINAA,2000,10/3/2018,6000,WMUQINAA,14000,more than downpayment,more than downpayment,0,2000
WMUQINAA,1000,11/2/2018,6000,WMUQINAA,15000,more than downpayment,more than downpayment,0,1000
WMUQINAA,1000,12/6/2018,6000,WMUQINAA,16000,more than downpayment,more than downpayment,0,1000
WMUQINAA,1000,1/8/2019,6000,WMUQINAA,17000,more than downpayment,more than downpayment,0,1000
WMUQINAA,2500,2/4/2019,6000,WMUQINAA,19500,more than downpayment,more than downpayment,0,2500
WMUQINAA,2000,3/4/2019,6000,WMUQINAA,21500,more than downpayment,more than downpayment,0,2000
WMUQINAA,2000,4/2/2019,6000,WMUQINAA,23500,more than downpayment,more than downpayment,0,2000
WMUQINAA,1500,4/29/2019,6000,WMUQINAA,25000,more than downpayment,more than downpayment,0,1500
WMUQINAA,1000,5/15/2019,6000,WMUQINAA,26000,more than downpayment,more than downpayment,0,1000
WoLxzcD0,9900,6/17/2019,9900,,9900,equal to downpayment,,9900,0
WoLxzcD0,1400,11/28/2019,9900,WoLxzcD0,11300,more than downpayment,equal to downpayment,0,1400
WoLxzcD0,1400,11/29/2019,9900,WoLxzcD0,12700,more than downpayment,more than downpayment,0,1400
WoLxzcD0,4000,12/16/2019,9900,WoLxzcD0,16700,more than downpayment,more than downpayment,0,4000
WoLxzcD0,2000,12/24/2019,9900,WoLxzcD0,18700,more than downpayment,more than downpayment,0,2000
WoLxzcD0,2000,1/7/2020,9900,WoLxzcD0,20700,more than downpayment,more than downpayment,0,2000
WoLxzcD0,2000,1/8/2020,9900,WoLxzcD0,22700,more than downpayment,more than downpayment,0,2000
WoLxzcD0,2000,1/9/2020,9900,WoLxzcD0,24700,more than downpayment,more than downpayment,0,2000
WoLxzcD0,2000,1/22/2020,9900,WoLxzcD0,26700,more than downpayment,more than downpayment,0,2000
WoLxzcD0,1000,1/23/2020,9900,WoLxzcD0,27700,more than downpayment,more than downpayment,0,1000
WoLxzcD0,1500,1/28/2020,9900,WoLxzcD0,29200,more than downpayment,more than downpayment,0,1500
WoLxzcD0,200,1/29/2020,9900,WoLxzcD0,29400,more than downpayment,more than downpayment,0,200
WOWVX3CC,9900,10/5/2019,9900,,9900,equal to downpayment,,9900,0
WOWVX3CC,9900,11/22/2019,9900,WOWVX3CC,19800,more than downpayment,equal to downpayment,0,9900
WOWVX3CC,3900,1/24/2020,9900,WOWVX3CC,23700,more than downpayment,more than downpayment,0,3900
WpLRHyZw,8900,5/8/2019,8900,,8900,equal to downpayment,,8900,0
WpLRHyZw,3900,6/17/2019,8900,WpLRHyZw,12800,more than downpayment,equal to downpayment,0,3900
WpLRHyZw,3900,7/19/2019,8900,WpLRHyZw,16700,more than downpayment,more than downpayment,0,3900
WpLRHyZw,3900,8/17/2019,8900,WpLRHyZw,20600,more than downpayment,more than downpayment,0,3900
WpLRHyZw,3900,9/18/2019,8900,WpLRHyZw,24500,more than downpayment,more than downpayment,0,3900
WpLRHyZw,3900,10/26/2019,8900,WpLRHyZw,28400,more than downpayment,more than downpayment,0,3900
WpLRHyZw,4000,11/21/2019,8900,WpLRHyZw,32400,more than downpayment,more than downpayment,0,4000
WpLRHyZw,3900,1/4/2020,8900,WpLRHyZw,36300,more than downpayment,more than downpayment,0,3900
WpLRHyZw,1700,1/17/2020,8900,WpLRHyZw,38000,more than downpayment,more than downpayment,0,1700
WpLRHyZw,2200,1/26/2020,8900,WpLRHyZw,40200,more than downpayment,more than downpayment,0,2200
WPUCBSwO,9000,1/22/2019,8900,,9000,more than downpayment,,8900,100
WPUCBSwO,4000,2/25/2019,8900,WPUCBSwO,13000,more than downpayment,more than downpayment,0,4000
WPUCBSwO,3900,3/26/2019,8900,WPUCBSwO,16900,more than downpayment,more than downpayment,0,3900
WPUCBSwO,3900,4/26/2019,8900,WPUCBSwO,20800,more than downpayment,more than downpayment,0,3900
WPUCBSwO,3900,5/28/2019,8900,WPUCBSwO,24700,more than downpayment,more than downpayment,0,3900
WPUCBSwO,3900,6/25/2019,8900,WPUCBSwO,28600,more than downpayment,more than downpayment,0,3900
WPUCBSwO,3900,7/31/2019,8900,WPUCBSwO,32500,more than downpayment,more than downpayment,0,3900
WPUCBSwO,3900,8/27/2019,8900,WPUCBSwO,36400,more than downpayment,more than downpayment,0,3900
WPUCBSwO,3900,9/30/2019,8900,WPUCBSwO,40300,more than downpayment,more than downpayment,0,3900
WPUCBSwO,3700,10/29/2019,8900,WPUCBSwO,44000,more than downpayment,more than downpayment,0,3700
WPUCBSwO,3900,12/2/2019,8900,WPUCBSwO,47900,more than downpayment,more than downpayment,0,3900
WPUCBSwO,3900,1/3/2020,8900,WPUCBSwO,51800,more than downpayment,more than downpayment,0,3900
WPUCBSwO,3900,1/30/2020,8900,WPUCBSwO,55700,more than downpayment,more than downpayment,0,3900
WPV6VS8I,9900,1/9/2020,9900,,9900,equal to downpayment,,9900,0
wPYCG6Lh,6440,4/11/2017,6440,,6440,equal to downpayment,,6440,0
wPYCG6Lh,3000,5/10/2017,6440,wPYCG6Lh,9440,more than downpayment,equal to downpayment,0,3000
wPYCG6Lh,3000,6/10/2017,6440,wPYCG6Lh,12440,more than downpayment,more than downpayment,0,3000
wPYCG6Lh,3000,7/10/2017,6440,wPYCG6Lh,15440,more than downpayment,more than downpayment,0,3000
wPYCG6Lh,3000,8/10/2017,6440,wPYCG6Lh,18440,more than downpayment,more than downpayment,0,3000
wPYCG6Lh,3000,9/9/2017,6440,wPYCG6Lh,21440,more than downpayment,more than downpayment,0,3000
wPYCG6Lh,1100,6/1/2018,6440,wPYCG6Lh,22540,more than downpayment,more than downpayment,0,1100
wPYCG6Lh,1000,7/3/2018,6440,wPYCG6Lh,23540,more than downpayment,more than downpayment,0,1000
wPYCG6Lh,1100,7/24/2018,6440,wPYCG6Lh,24640,more than downpayment,more than downpayment,0,1100
wPYCG6Lh,1100,10/2/2018,6440,wPYCG6Lh,25740,more than downpayment,more than downpayment,0,1100
wPYCG6Lh,1100,10/12/2018,6440,wPYCG6Lh,26840,more than downpayment,more than downpayment,0,1100
wPYCG6Lh,1000,11/4/2018,6440,wPYCG6Lh,27840,more than downpayment,more than downpayment,0,1000
wPYCG6Lh,1000,11/17/2018,6440,wPYCG6Lh,28840,more than downpayment,more than downpayment,0,1000
wPYCG6Lh,1000,1/16/2019,6440,wPYCG6Lh,29840,more than downpayment,more than downpayment,0,1000
wPYCG6Lh,1000,1/30/2019,6440,wPYCG6Lh,30840,more than downpayment,more than downpayment,0,1000
wPYCG6Lh,1000,2/25/2019,6440,wPYCG6Lh,31840,more than downpayment,more than downpayment,0,1000
wPYCG6Lh,1160,3/25/2019,6440,wPYCG6Lh,33000,more than downpayment,more than downpayment,0,1160
wPYCG6Lh,1000,5/10/2019,6440,wPYCG6Lh,34000,more than downpayment,more than downpayment,0,1000
wPYCG6Lh,1000,5/24/2019,6440,wPYCG6Lh,35000,more than downpayment,more than downpayment,0,1000
WQ5NQU3H,2000,6/28/2019,1999,,2000,more than downpayment,,1999,1
WQ5NQU3H,4000,7/8/2019,1999,WQ5NQU3H,6000,more than downpayment,more than downpayment,0,4000
WQ5NQU3H,4000,7/25/2019,1999,WQ5NQU3H,10000,more than downpayment,more than downpayment,0,4000
WQ5NQU3H,4000,8/12/2019,1999,WQ5NQU3H,14000,more than downpayment,more than downpayment,0,4000
WQ5NQU3H,4000,8/23/2019,1999,WQ5NQU3H,18000,more than downpayment,more than downpayment,0,4000
WQ5NQU3H,4000,10/7/2019,1999,WQ5NQU3H,22000,more than downpayment,more than downpayment,0,4000
WQ5NQU3H,2000,12/4/2019,1999,WQ5NQU3H,24000,more than downpayment,more than downpayment,0,2000
WQ5NQU3H,2000,12/20/2019,1999,WQ5NQU3H,26000,more than downpayment,more than downpayment,0,2000
WQ5NQU3H,2000,1/15/2020,1999,WQ5NQU3H,28000,more than downpayment,more than downpayment,0,2000
wQKfqL11,9900,7/11/2019,9900,,9900,equal to downpayment,,9900,0
wQKfqL11,4000,10/14/2019,9900,wQKfqL11,13900,more than downpayment,equal to downpayment,0,4000
wQKfqL11,3900,11/1/2019,9900,wQKfqL11,17800,more than downpayment,more than downpayment,0,3900
wQKfqL11,3900,11/25/2019,9900,wQKfqL11,21700,more than downpayment,more than downpayment,0,3900
wQKfqL11,4000,1/13/2020,9900,wQKfqL11,25700,more than downpayment,more than downpayment,0,4000
wqKQt9fn,8900,4/4/2019,8900,,8900,equal to downpayment,,8900,0
wqKQt9fn,15600,4/6/2019,8900,wqKQt9fn,24500,more than downpayment,equal to downpayment,0,15600
wqKQt9fn,3900,9/5/2019,8900,wqKQt9fn,28400,more than downpayment,more than downpayment,0,3900
wqKQt9fn,8000,10/30/2019,8900,wqKQt9fn,36400,more than downpayment,more than downpayment,0,8000
wqKQt9fn,3900,11/7/2019,8900,wqKQt9fn,40300,more than downpayment,more than downpayment,0,3900
wqKQt9fn,4000,12/7/2019,8900,wqKQt9fn,44300,more than downpayment,more than downpayment,0,4000
WQN4O51T,9000,12/17/2019,8900,,9000,more than downpayment,,8900,100
WR2ABPN8,8900,8/13/2019,8900,,8900,equal to downpayment,,8900,0
WR2ABPN8,3900,9/13/2019,8900,WR2ABPN8,12800,more than downpayment,equal to downpayment,0,3900
WR2ABPN8,3900,10/15/2019,8900,WR2ABPN8,16700,more than downpayment,more than downpayment,0,3900
WR2ABPN8,3900,11/22/2019,8900,WR2ABPN8,20600,more than downpayment,more than downpayment,0,3900
WR2ABPN8,3900,12/13/2019,8900,WR2ABPN8,24500,more than downpayment,more than downpayment,0,3900
WR2ABPN8,3900,1/15/2020,8900,WR2ABPN8,28400,more than downpayment,more than downpayment,0,3900
WRC4151C,9900,9/24/2019,9900,,9900,equal to downpayment,,9900,0
WRC4151C,3900,11/5/2019,9900,WRC4151C,13800,more than downpayment,equal to downpayment,0,3900
WRC4151C,3900,12/5/2019,9900,WRC4151C,17700,more than downpayment,more than downpayment,0,3900
WRC4151C,3900,1/5/2020,9900,WRC4151C,21600,more than downpayment,more than downpayment,0,3900
WRC4151C,3900,2/5/2020,9900,WRC4151C,25500,more than downpayment,more than downpayment,0,3900
WRkhkDxh,14500,2/15/2019,8900,,14500,more than downpayment,,8900,5600
WRkhkDxh,4000,3/23/2019,8900,WRkhkDxh,18500,more than downpayment,more than downpayment,0,4000
WRkhkDxh,3900,4/26/2019,8900,WRkhkDxh,22400,more than downpayment,more than downpayment,0,3900
WRkhkDxh,3900,5/25/2019,8900,WRkhkDxh,26300,more than downpayment,more than downpayment,0,3900
WRkhkDxh,3900,7/5/2019,8900,WRkhkDxh,30200,more than downpayment,more than downpayment,0,3900
WRkhkDxh,3900,8/8/2019,8900,WRkhkDxh,34100,more than downpayment,more than downpayment,0,3900
WRkhkDxh,3900,10/5/2019,8900,WRkhkDxh,38000,more than downpayment,more than downpayment,0,3900
WRkhkDxh,300,12/18/2019,8900,WRkhkDxh,38300,more than downpayment,more than downpayment,0,300
WRkhkDxh,6000,1/4/2020,8900,WRkhkDxh,44300,more than downpayment,more than downpayment,0,6000
WRkhkDxh,3900,1/22/2020,8900,WRkhkDxh,48200,more than downpayment,more than downpayment,0,3900
WrMUGZxR,8900,5/29/2019,8900,,8900,equal to downpayment,,8900,0
WrMUGZxR,270,7/28/2019,8900,WrMUGZxR,9170,more than downpayment,equal to downpayment,0,270
WrMUGZxR,150,8/2/2019,8900,WrMUGZxR,9320,more than downpayment,more than downpayment,0,150
WrMUGZxR,550,8/4/2019,8900,WrMUGZxR,9870,more than downpayment,more than downpayment,0,550
WrMUGZxR,200,8/5/2019,8900,WrMUGZxR,10070,more than downpayment,more than downpayment,0,200
WrMUGZxR,300,8/6/2019,8900,WrMUGZxR,10370,more than downpayment,more than downpayment,0,300
WrMUGZxR,2430,8/13/2019,8900,WrMUGZxR,12800,more than downpayment,more than downpayment,0,2430
wSpHQ7ts,10000,8/2/2018,10000,,10000,equal to downpayment,,10000,0
wSpHQ7ts,4500,9/1/2018,10000,wSpHQ7ts,14500,more than downpayment,equal to downpayment,0,4500
wSpHQ7ts,4500,9/29/2018,10000,wSpHQ7ts,19000,more than downpayment,more than downpayment,0,4500
wSpHQ7ts,4500,10/30/2018,10000,wSpHQ7ts,23500,more than downpayment,more than downpayment,0,4500
wSpHQ7ts,4500,12/5/2018,10000,wSpHQ7ts,28000,more than downpayment,more than downpayment,0,4500
wSpHQ7ts,4500,1/1/2019,10000,wSpHQ7ts,32500,more than downpayment,more than downpayment,0,4500
wSpHQ7ts,4500,1/30/2019,10000,wSpHQ7ts,37000,more than downpayment,more than downpayment,0,4500
wSpHQ7ts,4500,3/4/2019,10000,wSpHQ7ts,41500,more than downpayment,more than downpayment,0,4500
wSpHQ7ts,4500,4/2/2019,10000,wSpHQ7ts,46000,more than downpayment,more than downpayment,0,4500
wSpHQ7ts,4500,5/5/2019,10000,wSpHQ7ts,50500,more than downpayment,more than downpayment,0,4500
wSpHQ7ts,4500,5/26/2019,10000,wSpHQ7ts,55000,more than downpayment,more than downpayment,0,4500
wSpHQ7ts,4500,7/5/2019,10000,wSpHQ7ts,59500,more than downpayment,more than downpayment,0,4500
wSpHQ7ts,4500,8/5/2019,10000,wSpHQ7ts,64000,more than downpayment,more than downpayment,0,4500
WUAR9EAM,9900,1/15/2020,9900,,9900,equal to downpayment,,9900,0
WVRKPWGJ,9900,11/9/2019,9900,,9900,equal to downpayment,,9900,0
WVRKPWGJ,3900,1/25/2020,9900,WVRKPWGJ,13800,more than downpayment,equal to downpayment,0,3900
WVWQYK96,9900,9/3/2019,9900,,9900,equal to downpayment,,9900,0
WVWQYK96,4000,11/2/2019,9900,WVWQYK96,13900,more than downpayment,equal to downpayment,0,4000
WVWQYK96,3900,12/3/2019,9900,WVWQYK96,17800,more than downpayment,more than downpayment,0,3900
WVWQYK96,3900,1/3/2020,9900,WVWQYK96,21700,more than downpayment,more than downpayment,0,3900
WVWQYK96,3900,2/5/2020,9900,WVWQYK96,25600,more than downpayment,more than downpayment,0,3900
wvzaUKKz,8900,3/20/2019,8900,,8900,equal to downpayment,,8900,0
wvzaUKKz,3900,5/29/2019,8900,wvzaUKKz,12800,more than downpayment,equal to downpayment,0,3900
wvzaUKKz,3900,6/24/2019,8900,wvzaUKKz,16700,more than downpayment,more than downpayment,0,3900
wvzaUKKz,3900,7/29/2019,8900,wvzaUKKz,20600,more than downpayment,more than downpayment,0,3900
wvzaUKKz,3900,8/23/2019,8900,wvzaUKKz,24500,more than downpayment,more than downpayment,0,3900
wvzaUKKz,3900,9/23/2019,8900,wvzaUKKz,28400,more than downpayment,more than downpayment,0,3900
wvzaUKKz,3900,10/25/2019,8900,wvzaUKKz,32300,more than downpayment,more than downpayment,0,3900
wvzaUKKz,3900,11/27/2019,8900,wvzaUKKz,36200,more than downpayment,more than downpayment,0,3900
wvzaUKKz,3900,1/14/2020,8900,wvzaUKKz,40100,more than downpayment,more than downpayment,0,3900
wvzaUKKz,3900,1/27/2020,8900,wvzaUKKz,44000,more than downpayment,more than downpayment,0,3900
WW4PS9PT,9900,11/15/2019,9900,,9900,equal to downpayment,,9900,0
WW4PS9PT,3900,12/26/2019,9900,WW4PS9PT,13800,more than downpayment,equal to downpayment,0,3900
WW4PS9PT,3900,1/29/2020,9900,WW4PS9PT,17700,more than downpayment,more than downpayment,0,3900
WW4PS9PT,3900,2/4/2020,9900,WW4PS9PT,21600,more than downpayment,more than downpayment,0,3900
WWUdXDVq,26250,7/12/2019,26250,,26250,equal to downpayment,,26250,0
WWUdXDVq,26250,9/24/2019,26250,WWUdXDVq,52500,more than downpayment,equal to downpayment,0,26250
WWUdXDVq,26250,10/24/2019,26250,WWUdXDVq,78750,more than downpayment,more than downpayment,0,26250
WWUdXDVq,26250,11/25/2019,26250,WWUdXDVq,105000,more than downpayment,more than downpayment,0,26250
wx67jj8R,9900,8/20/2019,9900,,9900,equal to downpayment,,9900,0
wx67jj8R,3900,10/7/2019,9900,wx67jj8R,13800,more than downpayment,equal to downpayment,0,3900
wx67jj8R,3900,11/6/2019,9900,wx67jj8R,17700,more than downpayment,more than downpayment,0,3900
wx67jj8R,3900,12/5/2019,9900,wx67jj8R,21600,more than downpayment,more than downpayment,0,3900
wx67jj8R,3900,1/6/2020,9900,wx67jj8R,25500,more than downpayment,more than downpayment,0,3900
wx67jj8R,3900,2/5/2020,9900,wx67jj8R,29400,more than downpayment,more than downpayment,0,3900
WYAQQK48,9900,11/22/2019,9900,,9900,equal to downpayment,,9900,0
WYAQQK48,3900,2/4/2020,9900,WYAQQK48,13800,more than downpayment,equal to downpayment,0,3900
WYGyGTtp,9900,11/2/2018,9900,,9900,equal to downpayment,,9900,0
WYGyGTtp,3600,11/12/2018,9900,WYGyGTtp,13500,more than downpayment,equal to downpayment,0,3600
WYGyGTtp,4500,1/16/2019,9900,WYGyGTtp,18000,more than downpayment,more than downpayment,0,4500
WYGyGTtp,900,1/30/2019,9900,WYGyGTtp,18900,more than downpayment,more than downpayment,0,900
WYGyGTtp,4500,2/28/2019,9900,WYGyGTtp,23400,more than downpayment,more than downpayment,0,4500
WYGyGTtp,4500,3/29/2019,9900,WYGyGTtp,27900,more than downpayment,more than downpayment,0,4500
WYGyGTtp,4500,5/17/2019,9900,WYGyGTtp,32400,more than downpayment,more than downpayment,0,4500
WyrEuGO9,9900,8/26/2019,9900,,9900,equal to downpayment,,9900,0
wz9TpQVp,8900,4/18/2019,8900,,8900,equal to downpayment,,8900,0
wz9TpQVp,3900,5/20/2019,8900,wz9TpQVp,12800,more than downpayment,equal to downpayment,0,3900
wz9TpQVp,3900,6/20/2019,8900,wz9TpQVp,16700,more than downpayment,more than downpayment,0,3900
wz9TpQVp,3900,7/20/2019,8900,wz9TpQVp,20600,more than downpayment,more than downpayment,0,3900
wz9TpQVp,3900,8/23/2019,8900,wz9TpQVp,24500,more than downpayment,more than downpayment,0,3900
wz9TpQVp,3900,9/18/2019,8900,wz9TpQVp,28400,more than downpayment,more than downpayment,0,3900
wz9TpQVp,3900,10/17/2019,8900,wz9TpQVp,32300,more than downpayment,more than downpayment,0,3900
wz9TpQVp,3900,11/23/2019,8900,wz9TpQVp,36200,more than downpayment,more than downpayment,0,3900
wz9TpQVp,3900,12/18/2019,8900,wz9TpQVp,40100,more than downpayment,more than downpayment,0,3900
wz9TpQVp,3900,1/18/2020,8900,wz9TpQVp,44000,more than downpayment,more than downpayment,0,3900
X0IWydBR,10000,5/2/2019,8900,,10000,more than downpayment,,8900,1100
X0IWydBR,3900,6/5/2019,8900,X0IWydBR,13900,more than downpayment,more than downpayment,0,3900
X0IWydBR,3900,7/4/2019,8900,X0IWydBR,17800,more than downpayment,more than downpayment,0,3900
X0IWydBR,3900,8/6/2019,8900,X0IWydBR,21700,more than downpayment,more than downpayment,0,3900
X0IWydBR,3900,10/12/2019,8900,X0IWydBR,25600,more than downpayment,more than downpayment,0,3900
X0IWydBR,3900,10/16/2019,8900,X0IWydBR,29500,more than downpayment,more than downpayment,0,3900
X0IWydBR,3900,11/6/2019,8900,X0IWydBR,33400,more than downpayment,more than downpayment,0,3900
X0IWydBR,3900,12/5/2019,8900,X0IWydBR,37300,more than downpayment,more than downpayment,0,3900
X0IWydBR,3900,1/8/2020,8900,X0IWydBR,41200,more than downpayment,more than downpayment,0,3900
X0IWydBR,3900,2/5/2020,8900,X0IWydBR,45100,more than downpayment,more than downpayment,0,3900
x1C5nnyw,10000,9/26/2018,10000,,10000,equal to downpayment,,10000,0
x1C5nnyw,4500,10/25/2018,10000,x1C5nnyw,14500,more than downpayment,equal to downpayment,0,4500
x1C5nnyw,4500,11/25/2018,10000,x1C5nnyw,19000,more than downpayment,more than downpayment,0,4500
x1C5nnyw,4500,1/25/2019,10000,x1C5nnyw,23500,more than downpayment,more than downpayment,0,4500
x1C5nnyw,4500,2/25/2019,10000,x1C5nnyw,28000,more than downpayment,more than downpayment,0,4500
x1C5nnyw,4500,4/1/2019,10000,x1C5nnyw,32500,more than downpayment,more than downpayment,0,4500
x1C5nnyw,4500,5/29/2019,10000,x1C5nnyw,37000,more than downpayment,more than downpayment,0,4500
x1C5nnyw,4500,7/30/2019,10000,x1C5nnyw,41500,more than downpayment,more than downpayment,0,4500
x1C5nnyw,200,2/5/2020,10000,x1C5nnyw,41700,more than downpayment,more than downpayment,0,200
X2amJIkn,8900,12/12/2018,8900,,8900,equal to downpayment,,8900,0
X2amJIkn,3900,1/27/2019,8900,X2amJIkn,12800,more than downpayment,equal to downpayment,0,3900
X2amJIkn,4000,2/23/2019,8900,X2amJIkn,16800,more than downpayment,more than downpayment,0,4000
X2amJIkn,8000,3/28/2019,8900,X2amJIkn,24800,more than downpayment,more than downpayment,0,8000
X2amJIkn,4000,6/7/2019,8900,X2amJIkn,28800,more than downpayment,more than downpayment,0,4000
X2amJIkn,4000,6/26/2019,8900,X2amJIkn,32800,more than downpayment,more than downpayment,0,4000
X2amJIkn,8000,8/18/2019,8900,X2amJIkn,40800,more than downpayment,more than downpayment,0,8000
X2amJIkn,4000,9/28/2019,8900,X2amJIkn,44800,more than downpayment,more than downpayment,0,4000
X2amJIkn,8000,11/7/2019,8900,X2amJIkn,52800,more than downpayment,more than downpayment,0,8000
X2amJIkn,4000,12/27/2019,8900,X2amJIkn,56800,more than downpayment,more than downpayment,0,4000
X4bQMRFr,9900,6/10/2019,8900,,9900,more than downpayment,,8900,1000
X4bQMRFr,3900,7/20/2019,8900,X4bQMRFr,13800,more than downpayment,more than downpayment,0,3900
X4bQMRFr,3900,8/23/2019,8900,X4bQMRFr,17700,more than downpayment,more than downpayment,0,3900
X4bQMRFr,3900,9/18/2019,8900,X4bQMRFr,21600,more than downpayment,more than downpayment,0,3900
X4bQMRFr,3900,10/17/2019,8900,X4bQMRFr,25500,more than downpayment,more than downpayment,0,3900
X4bQMRFr,3900,11/23/2019,8900,X4bQMRFr,29400,more than downpayment,more than downpayment,0,3900
X4bQMRFr,3900,12/20/2019,8900,X4bQMRFr,33300,more than downpayment,more than downpayment,0,3900
X4bQMRFr,3900,1/18/2020,8900,X4bQMRFr,37200,more than downpayment,more than downpayment,0,3900
X4OW713T,9900,1/27/2020,9900,,9900,equal to downpayment,,9900,0
X4ZSOFUU,9999,12/7/2019,9900,,9999,more than downpayment,,9900,99
X4ZSOFUU,3900,1/24/2020,9900,X4ZSOFUU,13899,more than downpayment,more than downpayment,0,3900
X5s7tOSI,10000,9/27/2018,10000,,10000,equal to downpayment,,10000,0
X5s7tOSI,4500,10/3/2018,10000,X5s7tOSI,14500,more than downpayment,equal to downpayment,0,4500
X5s7tOSI,4500,11/4/2018,10000,X5s7tOSI,19000,more than downpayment,more than downpayment,0,4500
X5s7tOSI,4500,12/4/2018,10000,X5s7tOSI,23500,more than downpayment,more than downpayment,0,4500
X5s7tOSI,4500,1/1/2019,10000,X5s7tOSI,28000,more than downpayment,more than downpayment,0,4500
X5s7tOSI,4500,2/5/2019,10000,X5s7tOSI,32500,more than downpayment,more than downpayment,0,4500
X5s7tOSI,4500,3/4/2019,10000,X5s7tOSI,37000,more than downpayment,more than downpayment,0,4500
X5s7tOSI,4500,4/4/2019,10000,X5s7tOSI,41500,more than downpayment,more than downpayment,0,4500
X5s7tOSI,4500,5/1/2019,10000,X5s7tOSI,46000,more than downpayment,more than downpayment,0,4500
X5s7tOSI,4500,6/4/2019,10000,X5s7tOSI,50500,more than downpayment,more than downpayment,0,4500
X5s7tOSI,4500,7/4/2019,10000,X5s7tOSI,55000,more than downpayment,more than downpayment,0,4500
X5s7tOSI,4500,8/5/2019,10000,X5s7tOSI,59500,more than downpayment,more than downpayment,0,4500
X5s7tOSI,4500,9/4/2019,10000,X5s7tOSI,64000,more than downpayment,more than downpayment,0,4500
X66B53KF,2000,11/29/2019,9900,,2000,less than downpayment,,2000,0
X66B53KF,3900,12/6/2019,9900,X66B53KF,5900,less than downpayment,less than downpayment,3900,0
X66B53KF,3000,12/8/2019,9900,X66B53KF,8900,less than downpayment,less than downpayment,3000,0
X66B53KF,1000,12/10/2019,9900,X66B53KF,9900,equal to downpayment,less than downpayment,1000,0
X66B53KF,2800,2/3/2020,9900,X66B53KF,12700,more than downpayment,equal to downpayment,0,2800
X66B53KF,950,2/4/2020,9900,X66B53KF,13650,more than downpayment,more than downpayment,0,950
X66B53KF,200,2/6/2020,9900,X66B53KF,13850,more than downpayment,more than downpayment,0,200
X7LCQE4H,5000,1/10/2020,4999,,5000,more than downpayment,,4999,1
XBCCLWAO,9900,6/29/2019,8900,,9900,more than downpayment,,8900,1000
XBCCLWAO,3900,10/3/2019,8900,XBCCLWAO,13800,more than downpayment,more than downpayment,0,3900
XBCCLWAO,3900,11/1/2019,8900,XBCCLWAO,17700,more than downpayment,more than downpayment,0,3900
XBCCLWAO,3900,12/9/2019,8900,XBCCLWAO,21600,more than downpayment,more than downpayment,0,3900
XBCCLWAO,3900,1/13/2020,8900,XBCCLWAO,25500,more than downpayment,more than downpayment,0,3900
xbDZJHLh,10000,1/29/2018,10000,,10000,equal to downpayment,,10000,0
xbDZJHLh,4500,3/15/2018,10000,xbDZJHLh,14500,more than downpayment,equal to downpayment,0,4500
xbDZJHLh,4500,4/18/2018,10000,xbDZJHLh,19000,more than downpayment,more than downpayment,0,4500
xbDZJHLh,4500,5/22/2018,10000,xbDZJHLh,23500,more than downpayment,more than downpayment,0,4500
xbDZJHLh,4500,7/17/2018,10000,xbDZJHLh,28000,more than downpayment,more than downpayment,0,4500
xbDZJHLh,4500,9/20/2018,10000,xbDZJHLh,32500,more than downpayment,more than downpayment,0,4500
xbDZJHLh,4500,10/16/2018,10000,xbDZJHLh,37000,more than downpayment,more than downpayment,0,4500
xbDZJHLh,4500,2/14/2019,10000,xbDZJHLh,41500,more than downpayment,more than downpayment,0,4500
xbDZJHLh,4500,4/10/2019,10000,xbDZJHLh,46000,more than downpayment,more than downpayment,0,4500
xbDZJHLh,4500,5/24/2019,10000,xbDZJHLh,50500,more than downpayment,more than downpayment,0,4500
xbDZJHLh,1000,1/16/2020,10000,xbDZJHLh,51500,more than downpayment,more than downpayment,0,1000
xbDZJHLh,3000,2/4/2020,10000,xbDZJHLh,54500,more than downpayment,more than downpayment,0,3000
XCiYEhYT,9900,10/31/2018,9900,,9900,equal to downpayment,,9900,0
XCXPLFT3,9900,10/14/2019,9900,,9900,equal to downpayment,,9900,0
XCXPLFT3,3900,12/5/2019,9900,XCXPLFT3,13800,more than downpayment,equal to downpayment,0,3900
XCXPLFT3,3900,1/10/2020,9900,XCXPLFT3,17700,more than downpayment,more than downpayment,0,3900
XCXPLFT3,3900,2/5/2020,9900,XCXPLFT3,21600,more than downpayment,more than downpayment,0,3900
xczp8R48,8950,2/6/2019,8900,,8950,more than downpayment,,8900,50
xczp8R48,3900,3/7/2019,8900,xczp8R48,12850,more than downpayment,more than downpayment,0,3900
xczp8R48,3900,5/5/2019,8900,xczp8R48,16750,more than downpayment,more than downpayment,0,3900
xczp8R48,3900,6/4/2019,8900,xczp8R48,20650,more than downpayment,more than downpayment,0,3900
xczp8R48,3900,7/13/2019,8900,xczp8R48,24550,more than downpayment,more than downpayment,0,3900
xczp8R48,3900,8/13/2019,8900,xczp8R48,28450,more than downpayment,more than downpayment,0,3900
xczp8R48,3900,9/13/2019,8900,xczp8R48,32350,more than downpayment,more than downpayment,0,3900
xczp8R48,3900,10/14/2019,8900,xczp8R48,36250,more than downpayment,more than downpayment,0,3900
xczp8R48,3900,11/12/2019,8900,xczp8R48,40150,more than downpayment,more than downpayment,0,3900
xczp8R48,3900,12/16/2019,8900,xczp8R48,44050,more than downpayment,more than downpayment,0,3900
xczp8R48,3900,1/20/2020,8900,xczp8R48,47950,more than downpayment,more than downpayment,0,3900
XDDI7J7C,23400,9/6/2019,8900,,23400,more than downpayment,,8900,14500
XDDI7J7C,15000,10/9/2019,8900,XDDI7J7C,38400,more than downpayment,more than downpayment,0,15000
XDDI7J7C,7100,10/23/2019,8900,XDDI7J7C,45500,more than downpayment,more than downpayment,0,7100
XDDI7J7C,12000,11/15/2019,8900,XDDI7J7C,57500,more than downpayment,more than downpayment,0,12000
XDDI7J7C,10000,12/6/2019,8900,XDDI7J7C,67500,more than downpayment,more than downpayment,0,10000
XDDI7J7C,8000,12/24/2019,8900,XDDI7J7C,75500,more than downpayment,more than downpayment,0,8000
XDDI7J7C,10000,1/15/2020,8900,XDDI7J7C,85500,more than downpayment,more than downpayment,0,10000
XDDI7J7C,10000,1/29/2020,8900,XDDI7J7C,95500,more than downpayment,more than downpayment,0,10000
xdrDZldf,9900,12/21/2018,9900,,9900,equal to downpayment,,9900,0
XDRT7EX1,8900,1/16/2020,8900,,8900,equal to downpayment,,8900,0
xEiSHWVh,10000,6/26/2017,10000,,10000,equal to downpayment,,10000,0
xEiSHWVh,3500,9/7/2017,10000,xEiSHWVh,13500,more than downpayment,equal to downpayment,0,3500
xEiSHWVh,6000,11/1/2017,10000,xEiSHWVh,19500,more than downpayment,more than downpayment,0,6000
xEiSHWVh,6000,12/13/2017,10000,xEiSHWVh,25500,more than downpayment,more than downpayment,0,6000
xEiSHWVh,20000,3/27/2018,10000,xEiSHWVh,45500,more than downpayment,more than downpayment,0,20000
xEiSHWVh,6500,8/4/2018,10000,xEiSHWVh,52000,more than downpayment,more than downpayment,0,6500
xEN8NlFr,8900,4/11/2019,8900,,8900,equal to downpayment,,8900,0
xEN8NlFr,3900,5/20/2019,8900,xEN8NlFr,12800,more than downpayment,equal to downpayment,0,3900
xEN8NlFr,3900,7/1/2019,8900,xEN8NlFr,16700,more than downpayment,more than downpayment,0,3900
xEN8NlFr,4000,7/29/2019,8900,xEN8NlFr,20700,more than downpayment,more than downpayment,0,4000
xEN8NlFr,3900,8/31/2019,8900,xEN8NlFr,24600,more than downpayment,more than downpayment,0,3900
xEN8NlFr,3800,10/7/2019,8900,xEN8NlFr,28400,more than downpayment,more than downpayment,0,3800
xEN8NlFr,3900,11/2/2019,8900,xEN8NlFr,32300,more than downpayment,more than downpayment,0,3900
xEN8NlFr,1000,12/9/2019,8900,xEN8NlFr,33300,more than downpayment,more than downpayment,0,1000
xEN8NlFr,2900,12/15/2019,8900,xEN8NlFr,36200,more than downpayment,more than downpayment,0,2900
xEN8NlFr,3000,1/9/2020,8900,xEN8NlFr,39200,more than downpayment,more than downpayment,0,3000
xEN8NlFr,900,1/13/2020,8900,xEN8NlFr,40100,more than downpayment,more than downpayment,0,900
xEN8NlFr,3900,2/5/2020,8900,xEN8NlFr,44000,more than downpayment,more than downpayment,0,3900
XEVDDQ3Q,9900,8/6/2019,8900,,9900,more than downpayment,,8900,1000
XEVDDQ3Q,3900,10/14/2019,8900,XEVDDQ3Q,13800,more than downpayment,more than downpayment,0,3900
XEVDDQ3Q,1600,12/5/2019,8900,XEVDDQ3Q,15400,more than downpayment,more than downpayment,0,1600
XEVDDQ3Q,2300,12/10/2019,8900,XEVDDQ3Q,17700,more than downpayment,more than downpayment,0,2300
XEVDDQ3Q,3000,1/14/2020,8900,XEVDDQ3Q,20700,more than downpayment,more than downpayment,0,3000
XEVDDQ3Q,1000,1/24/2020,8900,XEVDDQ3Q,21700,more than downpayment,more than downpayment,0,1000
XEVXWHKP,2000,7/1/2019,1999,,2000,more than downpayment,,1999,1
XEVXWHKP,4000,8/5/2019,1999,XEVXWHKP,6000,more than downpayment,more than downpayment,0,4000
XEVXWHKP,4000,9/6/2019,1999,XEVXWHKP,10000,more than downpayment,more than downpayment,0,4000
XEVXWHKP,2000,10/7/2019,1999,XEVXWHKP,12000,more than downpayment,more than downpayment,0,2000
XEVXWHKP,2000,11/11/2019,1999,XEVXWHKP,14000,more than downpayment,more than downpayment,0,2000
XEVXWHKP,2000,12/11/2019,1999,XEVXWHKP,16000,more than downpayment,more than downpayment,0,2000
XEVXWHKP,2000,1/14/2020,1999,XEVXWHKP,18000,more than downpayment,more than downpayment,0,2000
XF6D6M5Y,9900,1/7/2020,8900,,9900,more than downpayment,,8900,1000
XFaQJHCW,8900,5/6/2019,8900,,8900,equal to downpayment,,8900,0
XFaQJHCW,3900,6/10/2019,8900,XFaQJHCW,12800,more than downpayment,equal to downpayment,0,3900
XFaQJHCW,3900,7/14/2019,8900,XFaQJHCW,16700,more than downpayment,more than downpayment,0,3900
XFaQJHCW,3900,8/10/2019,8900,XFaQJHCW,20600,more than downpayment,more than downpayment,0,3900
XFaQJHCW,3900,9/14/2019,8900,XFaQJHCW,24500,more than downpayment,more than downpayment,0,3900
XFaQJHCW,1000,10/14/2019,8900,XFaQJHCW,25500,more than downpayment,more than downpayment,0,1000
XfC0IxGC,10000,11/29/2017,10000,,10000,equal to downpayment,,10000,0
XfC0IxGC,32000,12/11/2017,10000,XfC0IxGC,42000,more than downpayment,equal to downpayment,0,32000
XfC0IxGC,4800,7/16/2018,10000,XfC0IxGC,46800,more than downpayment,more than downpayment,0,4800
XfC0IxGC,3400,8/18/2018,10000,XfC0IxGC,50200,more than downpayment,more than downpayment,0,3400
XfC0IxGC,2900,9/10/2018,10000,XfC0IxGC,53100,more than downpayment,more than downpayment,0,2900
XfC0IxGC,2200,9/26/2018,10000,XfC0IxGC,55300,more than downpayment,more than downpayment,0,2200
XfC0IxGC,8700,11/8/2018,10000,XfC0IxGC,64000,more than downpayment,more than downpayment,0,8700
XFPVSSSY,8900,1/22/2020,8900,,8900,equal to downpayment,,8900,0
Xg63lwpY,9900,7/11/2019,9900,,9900,equal to downpayment,,9900,0
Xg63lwpY,11700,9/5/2019,9900,Xg63lwpY,21600,more than downpayment,equal to downpayment,0,11700
Xg63lwpY,3900,12/13/2019,9900,Xg63lwpY,25500,more than downpayment,more than downpayment,0,3900
Xg63lwpY,1200,1/14/2020,9900,Xg63lwpY,26700,more than downpayment,more than downpayment,0,1200
xGzUDJDx,10000,7/19/2017,10000,,10000,equal to downpayment,,10000,0
xGzUDJDx,9000,9/12/2017,10000,xGzUDJDx,19000,more than downpayment,equal to downpayment,0,9000
xGzUDJDx,3500,11/15/2017,10000,xGzUDJDx,22500,more than downpayment,more than downpayment,0,3500
xGzUDJDx,5000,1/31/2018,10000,xGzUDJDx,27500,more than downpayment,more than downpayment,0,5000
xGzUDJDx,3500,2/12/2018,10000,xGzUDJDx,31000,more than downpayment,more than downpayment,0,3500
xGzUDJDx,3500,3/14/2018,10000,xGzUDJDx,34500,more than downpayment,more than downpayment,0,3500
xGzUDJDx,3500,4/16/2018,10000,xGzUDJDx,38000,more than downpayment,more than downpayment,0,3500
xGzUDJDx,5000,5/15/2018,10000,xGzUDJDx,43000,more than downpayment,more than downpayment,0,5000
xGzUDJDx,4000,6/15/2018,10000,xGzUDJDx,47000,more than downpayment,more than downpayment,0,4000
xGzUDJDx,5000,7/15/2018,10000,xGzUDJDx,52000,more than downpayment,more than downpayment,0,5000
xh2zjORO,10000,10/15/2018,10000,,10000,equal to downpayment,,10000,0
xh2zjORO,4500,11/22/2018,10000,xh2zjORO,14500,more than downpayment,equal to downpayment,0,4500
xh2zjORO,4500,12/20/2018,10000,xh2zjORO,19000,more than downpayment,more than downpayment,0,4500
xh2zjORO,4500,1/17/2019,10000,xh2zjORO,23500,more than downpayment,more than downpayment,0,4500
xh2zjORO,4500,2/23/2019,10000,xh2zjORO,28000,more than downpayment,more than downpayment,0,4500
xh2zjORO,4500,3/25/2019,10000,xh2zjORO,32500,more than downpayment,more than downpayment,0,4500
xh2zjORO,4500,4/24/2019,10000,xh2zjORO,37000,more than downpayment,more than downpayment,0,4500
xh2zjORO,4500,5/23/2019,10000,xh2zjORO,41500,more than downpayment,more than downpayment,0,4500
xh2zjORO,4500,6/24/2019,10000,xh2zjORO,46000,more than downpayment,more than downpayment,0,4500
xh2zjORO,4500,7/24/2019,10000,xh2zjORO,50500,more than downpayment,more than downpayment,0,4500
xh2zjORO,4500,8/24/2019,10000,xh2zjORO,55000,more than downpayment,more than downpayment,0,4500
xh2zjORO,4500,9/24/2019,10000,xh2zjORO,59500,more than downpayment,more than downpayment,0,4500
xh2zjORO,4500,9/30/2019,10000,xh2zjORO,64000,more than downpayment,more than downpayment,0,4500
xhPGGK5t,8900,2/28/2019,8900,,8900,equal to downpayment,,8900,0
xhPGGK5t,4000,4/6/2019,8900,xhPGGK5t,12900,more than downpayment,equal to downpayment,0,4000
xhPGGK5t,4000,5/6/2019,8900,xhPGGK5t,16900,more than downpayment,more than downpayment,0,4000
xhPGGK5t,4000,6/11/2019,8900,xhPGGK5t,20900,more than downpayment,more than downpayment,0,4000
xhPGGK5t,4000,7/4/2019,8900,xhPGGK5t,24900,more than downpayment,more than downpayment,0,4000
xhPGGK5t,4000,8/6/2019,8900,xhPGGK5t,28900,more than downpayment,more than downpayment,0,4000
xhPGGK5t,4000,9/5/2019,8900,xhPGGK5t,32900,more than downpayment,more than downpayment,0,4000
xhPGGK5t,3900,10/28/2019,8900,xhPGGK5t,36800,more than downpayment,more than downpayment,0,3900
xhPGGK5t,4000,11/11/2019,8900,xhPGGK5t,40800,more than downpayment,more than downpayment,0,4000
xhPGGK5t,4000,12/11/2019,8900,xhPGGK5t,44800,more than downpayment,more than downpayment,0,4000
xhPGGK5t,4000,1/13/2020,8900,xhPGGK5t,48800,more than downpayment,more than downpayment,0,4000
xHpsK6We,9900,9/8/2019,8900,,9900,more than downpayment,,8900,1000
xHpsK6We,3900,10/3/2019,8900,xHpsK6We,13800,more than downpayment,more than downpayment,0,3900
xHpsK6We,3900,11/4/2019,8900,xHpsK6We,17700,more than downpayment,more than downpayment,0,3900
xHpsK6We,3900,12/17/2019,8900,xHpsK6We,21600,more than downpayment,more than downpayment,0,3900
xHpsK6We,3900,1/12/2020,8900,xHpsK6We,25500,more than downpayment,more than downpayment,0,3900
XHQP8AXN,8900,9/24/2019,1999,,8900,more than downpayment,,1999,6901
XHQP8AXN,3900,11/19/2019,1999,XHQP8AXN,12800,more than downpayment,more than downpayment,0,3900
XHQP8AXN,3900,12/17/2019,1999,XHQP8AXN,16700,more than downpayment,more than downpayment,0,3900
XHYW2JSG,2000,10/7/2019,9900,,2000,less than downpayment,,2000,0
XHYW2JSG,7900,10/21/2019,9900,XHYW2JSG,9900,equal to downpayment,less than downpayment,7900,0
XHYW2JSG,3900,12/4/2019,9900,XHYW2JSG,13800,more than downpayment,equal to downpayment,0,3900
XHYW2JSG,3900,12/29/2019,9900,XHYW2JSG,17700,more than downpayment,more than downpayment,0,3900
XHYW2JSG,3900,2/5/2020,9900,XHYW2JSG,21600,more than downpayment,more than downpayment,0,3900
xI1Pt1bQ,40000,2/26/2019,8900,,40000,more than downpayment,,8900,31100
xI1Pt1bQ,50000,3/8/2019,8900,xI1Pt1bQ,90000,more than downpayment,more than downpayment,0,50000
xI1Pt1bQ,20000,6/27/2019,8900,xI1Pt1bQ,110000,more than downpayment,more than downpayment,0,20000
xI1Pt1bQ,15900,7/3/2019,8900,xI1Pt1bQ,125900,more than downpayment,more than downpayment,0,15900
XIbCVuh1,26000,6/29/2019,26250,,26000,less than downpayment,,26000,0
XIbCVuh1,250,7/9/2019,26250,XIbCVuh1,26250,equal to downpayment,less than downpayment,250,0
XIbCVuh1,27250,8/7/2019,26250,XIbCVuh1,53500,more than downpayment,equal to downpayment,0,27250
XIbCVuh1,15000,9/24/2019,26250,XIbCVuh1,68500,more than downpayment,more than downpayment,0,15000
XIbCVuh1,36250,11/15/2019,26250,XIbCVuh1,104750,more than downpayment,more than downpayment,0,36250
XIbCVuh1,1250,12/2/2019,26250,XIbCVuh1,106000,more than downpayment,more than downpayment,0,1250
XiSquyGO,10000,12/21/2018,8900,,10000,more than downpayment,,8900,1100
XiSquyGO,5000,1/18/2019,8900,XiSquyGO,15000,more than downpayment,more than downpayment,0,5000
XiSquyGO,5000,2/24/2019,8900,XiSquyGO,20000,more than downpayment,more than downpayment,0,5000
XiSquyGO,5000,3/25/2019,8900,XiSquyGO,25000,more than downpayment,more than downpayment,0,5000
XiSquyGO,5000,4/25/2019,8900,XiSquyGO,30000,more than downpayment,more than downpayment,0,5000
XiSquyGO,5000,5/31/2019,8900,XiSquyGO,35000,more than downpayment,more than downpayment,0,5000
XiSquyGO,5000,6/29/2019,8900,XiSquyGO,40000,more than downpayment,more than downpayment,0,5000
XiSquyGO,5000,7/27/2019,8900,XiSquyGO,45000,more than downpayment,more than downpayment,0,5000
XiSquyGO,10000,9/30/2019,8900,XiSquyGO,55000,more than downpayment,more than downpayment,0,10000
XiSquyGO,10000,12/16/2019,8900,XiSquyGO,65000,more than downpayment,more than downpayment,0,10000
XJ6HE65W,9900,6/15/2019,9900,,9900,equal to downpayment,,9900,0
XJ6HE65W,3900,7/24/2019,9900,XJ6HE65W,13800,more than downpayment,equal to downpayment,0,3900
XJ6HE65W,3900,8/26/2019,9900,XJ6HE65W,17700,more than downpayment,more than downpayment,0,3900
XJ6HE65W,3900,9/24/2019,9900,XJ6HE65W,21600,more than downpayment,more than downpayment,0,3900
XJ6HE65W,3900,12/11/2019,9900,XJ6HE65W,25500,more than downpayment,more than downpayment,0,3900
XJ6HE65W,3900,12/31/2019,9900,XJ6HE65W,29400,more than downpayment,more than downpayment,0,3900
XJ6HE65W,3900,1/15/2020,9900,XJ6HE65W,33300,more than downpayment,more than downpayment,0,3900
XJ6HE65W,3900,1/28/2020,9900,XJ6HE65W,37200,more than downpayment,more than downpayment,0,3900
XJBLHM5V,9900,11/26/2019,9900,,9900,equal to downpayment,,9900,0
XK5SH48B,8900,1/9/2020,8900,,8900,equal to downpayment,,8900,0
Xkd09NNH,8900,5/6/2019,8900,,8900,equal to downpayment,,8900,0
Xkd09NNH,3900,7/4/2019,8900,Xkd09NNH,12800,more than downpayment,equal to downpayment,0,3900
Xkd09NNH,3900,8/5/2019,8900,Xkd09NNH,16700,more than downpayment,more than downpayment,0,3900
Xkd09NNH,3900,9/5/2019,8900,Xkd09NNH,20600,more than downpayment,more than downpayment,0,3900
Xkd09NNH,3900,10/5/2019,8900,Xkd09NNH,24500,more than downpayment,more than downpayment,0,3900
Xkd09NNH,3900,11/12/2019,8900,Xkd09NNH,28400,more than downpayment,more than downpayment,0,3900
Xkd09NNH,3900,12/4/2019,8900,Xkd09NNH,32300,more than downpayment,more than downpayment,0,3900
Xkd09NNH,3900,1/4/2020,8900,Xkd09NNH,36200,more than downpayment,more than downpayment,0,3900
Xkd09NNH,3900,2/3/2020,8900,Xkd09NNH,40100,more than downpayment,more than downpayment,0,3900
Xkxmt7og,10000,12/19/2018,10000,,10000,equal to downpayment,,10000,0
Xkxmt7og,4500,1/25/2019,10000,Xkxmt7og,14500,more than downpayment,equal to downpayment,0,4500
Xkxmt7og,4500,2/25/2019,10000,Xkxmt7og,19000,more than downpayment,more than downpayment,0,4500
Xkxmt7og,4500,3/25/2019,10000,Xkxmt7og,23500,more than downpayment,more than downpayment,0,4500
Xkxmt7og,4500,4/28/2019,10000,Xkxmt7og,28000,more than downpayment,more than downpayment,0,4500
Xkxmt7og,4500,5/25/2019,10000,Xkxmt7og,32500,more than downpayment,more than downpayment,0,4500
Xkxmt7og,4500,6/25/2019,10000,Xkxmt7og,37000,more than downpayment,more than downpayment,0,4500
Xkxmt7og,4500,7/26/2019,10000,Xkxmt7og,41500,more than downpayment,more than downpayment,0,4500
Xkxmt7og,4500,8/25/2019,10000,Xkxmt7og,46000,more than downpayment,more than downpayment,0,4500
Xkxmt7og,4500,9/25/2019,10000,Xkxmt7og,50500,more than downpayment,more than downpayment,0,4500
Xkxmt7og,4500,10/25/2019,10000,Xkxmt7og,55000,more than downpayment,more than downpayment,0,4500
Xkxmt7og,4500,11/25/2019,10000,Xkxmt7og,59500,more than downpayment,more than downpayment,0,4500
Xkxmt7og,4500,12/20/2019,10000,Xkxmt7og,64000,more than downpayment,more than downpayment,0,4500
xlJNWFkQ,8900,1/18/2019,8900,,8900,equal to downpayment,,8900,0
xlJNWFkQ,3900,3/4/2019,8900,xlJNWFkQ,12800,more than downpayment,equal to downpayment,0,3900
xlJNWFkQ,3900,4/8/2019,8900,xlJNWFkQ,16700,more than downpayment,more than downpayment,0,3900
xlJNWFkQ,3900,5/22/2019,8900,xlJNWFkQ,20600,more than downpayment,more than downpayment,0,3900
xlJNWFkQ,5000,10/8/2019,8900,xlJNWFkQ,25600,more than downpayment,more than downpayment,0,5000
xlJNWFkQ,4000,10/29/2019,8900,xlJNWFkQ,29600,more than downpayment,more than downpayment,0,4000
xlJNWFkQ,5000,12/19/2019,8900,xlJNWFkQ,34600,more than downpayment,more than downpayment,0,5000
xMaoS1q3,8900,4/1/2019,8900,,8900,equal to downpayment,,8900,0
xMjHyHUv,8900,7/24/2019,8900,,8900,equal to downpayment,,8900,0
xMjHyHUv,3900,9/25/2019,8900,xMjHyHUv,12800,more than downpayment,equal to downpayment,0,3900
xMjHyHUv,3900,10/24/2019,8900,xMjHyHUv,16700,more than downpayment,more than downpayment,0,3900
xMjHyHUv,3900,11/25/2019,8900,xMjHyHUv,20600,more than downpayment,more than downpayment,0,3900
xMjHyHUv,3900,12/25/2019,8900,xMjHyHUv,24500,more than downpayment,more than downpayment,0,3900
xMjHyHUv,3900,1/25/2020,8900,xMjHyHUv,28400,more than downpayment,more than downpayment,0,3900
Xnukvrhm,10000,4/7/2019,10000,,10000,equal to downpayment,,10000,0
XPGTUMDO,1605,10/14/2019,9900,,1605,less than downpayment,,1605,0
XPGTUMDO,2450,11/2/2019,9900,XPGTUMDO,4055,less than downpayment,less than downpayment,2450,0
XPGTUMDO,4000,11/4/2019,9900,XPGTUMDO,8055,less than downpayment,less than downpayment,4000,0
XPGTUMDO,1860,11/13/2019,9900,XPGTUMDO,9915,more than downpayment,less than downpayment,1845,15
XPGTUMDO,2000,1/17/2020,9900,XPGTUMDO,11915,more than downpayment,more than downpayment,0,2000
XPGTUMDO,1900,1/23/2020,9900,XPGTUMDO,13815,more than downpayment,more than downpayment,0,1900
XPLOGDO1,9900,11/26/2019,9900,,9900,equal to downpayment,,9900,0
XPPZALSS,9900,1/29/2020,9900,,9900,equal to downpayment,,9900,0
XqcNMYo3,8900,4/15/2019,8900,,8900,equal to downpayment,,8900,0
XqcNMYo3,3900,5/14/2019,8900,XqcNMYo3,12800,more than downpayment,equal to downpayment,0,3900
XqcNMYo3,3900,6/7/2019,8900,XqcNMYo3,16700,more than downpayment,more than downpayment,0,3900
XqcNMYo3,3900,7/9/2019,8900,XqcNMYo3,20600,more than downpayment,more than downpayment,0,3900
XqcNMYo3,3950,8/14/2019,8900,XqcNMYo3,24550,more than downpayment,more than downpayment,0,3950
XqcNMYo3,3900,9/24/2019,8900,XqcNMYo3,28450,more than downpayment,more than downpayment,0,3900
XqcNMYo3,3900,10/24/2019,8900,XqcNMYo3,32350,more than downpayment,more than downpayment,0,3900
XqcNMYo3,3900,11/23/2019,8900,XqcNMYo3,36250,more than downpayment,more than downpayment,0,3900
XqcNMYo3,3900,12/26/2019,8900,XqcNMYo3,40150,more than downpayment,more than downpayment,0,3900
XqcNMYo3,3900,1/5/2020,8900,XqcNMYo3,44050,more than downpayment,more than downpayment,0,3900
XqcNMYo3,3900,2/4/2020,8900,XqcNMYo3,47950,more than downpayment,more than downpayment,0,3900
XQLOGkXz,10000,7/8/2017,10000,,10000,equal to downpayment,,10000,0
XQLOGkXz,10,9/9/2017,10000,XQLOGkXz,10010,more than downpayment,equal to downpayment,0,10
XQLOGkXz,3500,9/14/2017,10000,XQLOGkXz,13510,more than downpayment,more than downpayment,0,3500
XQLOGkXz,3500,10/18/2017,10000,XQLOGkXz,17010,more than downpayment,more than downpayment,0,3500
XQLOGkXz,27990,11/20/2017,10000,XQLOGkXz,45000,more than downpayment,more than downpayment,0,27990
XRXzTEWo,8900,5/22/2019,8900,,8900,equal to downpayment,,8900,0
XRXzTEWo,1000,6/26/2019,8900,XRXzTEWo,9900,more than downpayment,equal to downpayment,0,1000
XRXzTEWo,3900,7/19/2019,8900,XRXzTEWo,13800,more than downpayment,more than downpayment,0,3900
XRXzTEWo,3900,8/26/2019,8900,XRXzTEWo,17700,more than downpayment,more than downpayment,0,3900
XRXzTEWo,3900,9/20/2019,8900,XRXzTEWo,21600,more than downpayment,more than downpayment,0,3900
XRXzTEWo,3900,10/25/2019,8900,XRXzTEWo,25500,more than downpayment,more than downpayment,0,3900
XRXzTEWo,3900,11/25/2019,8900,XRXzTEWo,29400,more than downpayment,more than downpayment,0,3900
XRXzTEWo,3900,12/17/2019,8900,XRXzTEWo,33300,more than downpayment,more than downpayment,0,3900
XRXzTEWo,3900,1/17/2020,8900,XRXzTEWo,37200,more than downpayment,more than downpayment,0,3900
XS15G2E2,9900,10/10/2019,9900,,9900,equal to downpayment,,9900,0
XS15G2E2,2900,12/29/2019,9900,XS15G2E2,12800,more than downpayment,equal to downpayment,0,2900
XS15G2E2,1000,12/30/2019,9900,XS15G2E2,13800,more than downpayment,more than downpayment,0,1000
XS15G2E2,4900,1/25/2020,9900,XS15G2E2,18700,more than downpayment,more than downpayment,0,4900
XsBTXoqN,9900,7/16/2019,9900,,9900,equal to downpayment,,9900,0
XsBTXoqN,3900,8/22/2019,9900,XsBTXoqN,13800,more than downpayment,equal to downpayment,0,3900
XsBTXoqN,3900,9/22/2019,9900,XsBTXoqN,17700,more than downpayment,more than downpayment,0,3900
XsBTXoqN,3900,10/23/2019,9900,XsBTXoqN,21600,more than downpayment,more than downpayment,0,3900
XsBTXoqN,3900,11/27/2019,9900,XsBTXoqN,25500,more than downpayment,more than downpayment,0,3900
XsBTXoqN,3900,1/1/2020,9900,XsBTXoqN,29400,more than downpayment,more than downpayment,0,3900
xSMh6Ivr,15000,10/15/2018,10000,,15000,more than downpayment,,10000,5000
xSMh6Ivr,4500,11/29/2018,10000,xSMh6Ivr,19500,more than downpayment,more than downpayment,0,4500
xSMh6Ivr,4500,1/2/2019,10000,xSMh6Ivr,24000,more than downpayment,more than downpayment,0,4500
xSMh6Ivr,4500,2/25/2019,10000,xSMh6Ivr,28500,more than downpayment,more than downpayment,0,4500
xSMh6Ivr,4500,4/24/2019,10000,xSMh6Ivr,33000,more than downpayment,more than downpayment,0,4500
xSMh6Ivr,4500,5/28/2019,10000,xSMh6Ivr,37500,more than downpayment,more than downpayment,0,4500
xSMh6Ivr,4000,7/3/2019,10000,xSMh6Ivr,41500,more than downpayment,more than downpayment,0,4000
xSMh6Ivr,4500,8/21/2019,10000,xSMh6Ivr,46000,more than downpayment,more than downpayment,0,4500
xSMh6Ivr,4000,9/19/2019,10000,xSMh6Ivr,50000,more than downpayment,more than downpayment,0,4000
xSMh6Ivr,2000,10/26/2019,10000,xSMh6Ivr,52000,more than downpayment,more than downpayment,0,2000
xSMh6Ivr,2500,11/25/2019,10000,xSMh6Ivr,54500,more than downpayment,more than downpayment,0,2500
xSMh6Ivr,2000,12/6/2019,10000,xSMh6Ivr,56500,more than downpayment,more than downpayment,0,2000
xSYH6hAY,10000,10/29/2018,10000,,10000,equal to downpayment,,10000,0
xSYH6hAY,4500,12/5/2018,10000,xSYH6hAY,14500,more than downpayment,equal to downpayment,0,4500
xSYH6hAY,4500,1/4/2019,10000,xSYH6hAY,19000,more than downpayment,more than downpayment,0,4500
xSYH6hAY,4500,1/31/2019,10000,xSYH6hAY,23500,more than downpayment,more than downpayment,0,4500
xSYH6hAY,4500,3/5/2019,10000,xSYH6hAY,28000,more than downpayment,more than downpayment,0,4500
xSYH6hAY,4500,4/4/2019,10000,xSYH6hAY,32500,more than downpayment,more than downpayment,0,4500
xSYH6hAY,4500,5/3/2019,10000,xSYH6hAY,37000,more than downpayment,more than downpayment,0,4500
xSYH6hAY,4500,6/4/2019,10000,xSYH6hAY,41500,more than downpayment,more than downpayment,0,4500
xSYH6hAY,4500,7/4/2019,10000,xSYH6hAY,46000,more than downpayment,more than downpayment,0,4500
xSYH6hAY,4500,8/4/2019,10000,xSYH6hAY,50500,more than downpayment,more than downpayment,0,4500
xSYH6hAY,4500,9/5/2019,10000,xSYH6hAY,55000,more than downpayment,more than downpayment,0,4500
xSYH6hAY,4000,10/3/2019,10000,xSYH6hAY,59000,more than downpayment,more than downpayment,0,4000
xSYH6hAY,500,10/16/2019,10000,xSYH6hAY,59500,more than downpayment,more than downpayment,0,500
xSYH6hAY,4500,11/28/2019,10000,xSYH6hAY,64000,more than downpayment,more than downpayment,0,4500
xSzfLLhF,8900,4/1/2019,8900,,8900,equal to downpayment,,8900,0
xSzfLLhF,3900,5/10/2019,8900,xSzfLLhF,12800,more than downpayment,equal to downpayment,0,3900
xSzfLLhF,3900,6/13/2019,8900,xSzfLLhF,16700,more than downpayment,more than downpayment,0,3900
xSzfLLhF,3900,7/10/2019,8900,xSzfLLhF,20600,more than downpayment,more than downpayment,0,3900
xSzfLLhF,3900,8/7/2019,8900,xSzfLLhF,24500,more than downpayment,more than downpayment,0,3900
xSzfLLhF,3900,9/26/2019,8900,xSzfLLhF,28400,more than downpayment,more than downpayment,0,3900
xSzfLLhF,1000,10/15/2019,8900,xSzfLLhF,29400,more than downpayment,more than downpayment,0,1000
xSzfLLhF,900,11/1/2019,8900,xSzfLLhF,30300,more than downpayment,more than downpayment,0,900
xSzfLLhF,900,11/14/2019,8900,xSzfLLhF,31200,more than downpayment,more than downpayment,0,900
xSzfLLhF,2000,12/5/2019,8900,xSzfLLhF,33200,more than downpayment,more than downpayment,0,2000
xSzfLLhF,2000,12/16/2019,8900,xSzfLLhF,35200,more than downpayment,more than downpayment,0,2000
xSzfLLhF,600,1/30/2020,8900,xSzfLLhF,35800,more than downpayment,more than downpayment,0,600
xSzfLLhF,2000,2/5/2020,8900,xSzfLLhF,37800,more than downpayment,more than downpayment,0,2000
xTFn6Wm2,8900,3/13/2019,8900,,8900,equal to downpayment,,8900,0
xTFn6Wm2,39000,3/25/2019,8900,xTFn6Wm2,47900,more than downpayment,equal to downpayment,0,39000
xTFn6Wm2,38000,2/3/2020,8900,xTFn6Wm2,85900,more than downpayment,more than downpayment,0,38000
XUQ8CYUQ,34000,11/5/2019,9900,,34000,more than downpayment,,9900,24100
xv8D15RN,9900,12/13/2019,9900,,9900,equal to downpayment,,9900,0
xv8D15RN,3900,2/9/2020,9900,xv8D15RN,13800,more than downpayment,equal to downpayment,0,3900
XVD2VSXW,9900,12/26/2019,9900,,9900,equal to downpayment,,9900,0
XVDMJFLK,9900,9/14/2019,9900,,9900,equal to downpayment,,9900,0
XVDMJFLK,3900,11/4/2019,9900,XVDMJFLK,13800,more than downpayment,equal to downpayment,0,3900
XVDMJFLK,3900,12/4/2019,9900,XVDMJFLK,17700,more than downpayment,more than downpayment,0,3900
XVDMJFLK,3900,1/5/2020,9900,XVDMJFLK,21600,more than downpayment,more than downpayment,0,3900
XVDMJFLK,3900,2/5/2020,9900,XVDMJFLK,25500,more than downpayment,more than downpayment,0,3900
XVOLCQDE,9900,7/11/2019,9900,,9900,equal to downpayment,,9900,0
XVOLCQDE,3900,10/1/2019,9900,XVOLCQDE,13800,more than downpayment,equal to downpayment,0,3900
XVOLCQDE,4000,10/29/2019,9900,XVOLCQDE,17800,more than downpayment,more than downpayment,0,4000
XVOLCQDE,3800,11/29/2019,9900,XVOLCQDE,21600,more than downpayment,more than downpayment,0,3800
XVOLCQDE,4000,12/31/2019,9900,XVOLCQDE,25600,more than downpayment,more than downpayment,0,4000
XVOLCQDE,3800,1/30/2020,9900,XVOLCQDE,29400,more than downpayment,more than downpayment,0,3800
XVOLCQDE,100,2/1/2020,9900,XVOLCQDE,29500,more than downpayment,more than downpayment,0,100
XVZVFORH,9999,12/3/2019,9900,,9999,more than downpayment,,9900,99
XVZVFORH,3900,2/5/2020,9900,XVZVFORH,13899,more than downpayment,more than downpayment,0,3900
XW42NTYK,8900,9/9/2019,8900,,8900,equal to downpayment,,8900,0
XW42NTYK,4000,10/23/2019,8900,XW42NTYK,12900,more than downpayment,equal to downpayment,0,4000
XW42NTYK,4000,11/23/2019,8900,XW42NTYK,16900,more than downpayment,more than downpayment,0,4000
XW42NTYK,4000,12/26/2019,8900,XW42NTYK,20900,more than downpayment,more than downpayment,0,4000
XW42NTYK,4000,1/25/2020,8900,XW42NTYK,24900,more than downpayment,more than downpayment,0,4000
XWX5I9HQ,8900,11/25/2019,8900,,8900,equal to downpayment,,8900,0
XX8HQECK,9900,10/3/2019,9900,,9900,equal to downpayment,,9900,0
XYXqjmVH,3900,10/25/2017,8900,,3900,less than downpayment,,3900,0
XYXqjmVH,8900,5/17/2019,8900,XYXqjmVH,12800,more than downpayment,less than downpayment,5000,3900
XYXqjmVH,3900,6/21/2019,8900,XYXqjmVH,16700,more than downpayment,more than downpayment,0,3900
XYXqjmVH,3900,7/25/2019,8900,XYXqjmVH,20600,more than downpayment,more than downpayment,0,3900
XYXqjmVH,3900,8/28/2019,8900,XYXqjmVH,24500,more than downpayment,more than downpayment,0,3900
XYXqjmVH,3900,9/25/2019,8900,XYXqjmVH,28400,more than downpayment,more than downpayment,0,3900
XYXqjmVH,3900,11/21/2019,8900,XYXqjmVH,32300,more than downpayment,more than downpayment,0,3900
XYXqjmVH,3900,12/27/2019,8900,XYXqjmVH,36200,more than downpayment,more than downpayment,0,3900
XYXqjmVH,3900,1/25/2020,8900,XYXqjmVH,40100,more than downpayment,more than downpayment,0,3900
y0IBaSMd,8900,4/23/2019,8900,,8900,equal to downpayment,,8900,0
y0IBaSMd,3000,8/2/2019,8900,y0IBaSMd,11900,more than downpayment,equal to downpayment,0,3000
y0IBaSMd,4000,8/30/2019,8900,y0IBaSMd,15900,more than downpayment,more than downpayment,0,4000
Y11NQ5U3,9900,2/6/2020,9900,,9900,equal to downpayment,,9900,0
Y1hzNXk8,9900,8/5/2019,9900,,9900,equal to downpayment,,9900,0
Y1hzNXk8,3900,10/4/2019,9900,Y1hzNXk8,13800,more than downpayment,equal to downpayment,0,3900
Y1hzNXk8,2000,11/18/2019,9900,Y1hzNXk8,15800,more than downpayment,more than downpayment,0,2000
Y1hzNXk8,1900,11/19/2019,9900,Y1hzNXk8,17700,more than downpayment,more than downpayment,0,1900
Y1hzNXk8,3900,12/9/2019,9900,Y1hzNXk8,21600,more than downpayment,more than downpayment,0,3900
Y1hzNXk8,2000,1/9/2020,9900,Y1hzNXk8,23600,more than downpayment,more than downpayment,0,2000
Y1hzNXk8,3000,1/20/2020,9900,Y1hzNXk8,26600,more than downpayment,more than downpayment,0,3000
Y1hzNXk8,3000,2/9/2020,9900,Y1hzNXk8,29600,more than downpayment,more than downpayment,0,3000
Y1XEGBHC,9900,9/26/2019,9900,,9900,equal to downpayment,,9900,0
Y1XEGBHC,3900,11/21/2019,9900,Y1XEGBHC,13800,more than downpayment,equal to downpayment,0,3900
Y1XEGBHC,2600,12/13/2019,9900,Y1XEGBHC,16400,more than downpayment,more than downpayment,0,2600
Y1XEGBHC,1300,12/19/2019,9900,Y1XEGBHC,17700,more than downpayment,more than downpayment,0,1300
Y1XEGBHC,8000,1/8/2020,9900,Y1XEGBHC,25700,more than downpayment,more than downpayment,0,8000
Y2MMJLAJ,3000,10/8/2019,9900,,3000,less than downpayment,,3000,0
Y2MMJLAJ,3000,10/9/2019,9900,Y2MMJLAJ,6000,less than downpayment,less than downpayment,3000,0
Y2MMJLAJ,4000,10/19/2019,9900,Y2MMJLAJ,10000,more than downpayment,less than downpayment,3900,100
Y2MMJLAJ,8000,12/21/2019,9900,Y2MMJLAJ,18000,more than downpayment,more than downpayment,0,8000
Y2OFQP9O,8900,10/1/2019,8900,,8900,equal to downpayment,,8900,0
Y2OFQP9O,3900,11/6/2019,8900,Y2OFQP9O,12800,more than downpayment,equal to downpayment,0,3900
Y2OFQP9O,3900,12/17/2019,8900,Y2OFQP9O,16700,more than downpayment,more than downpayment,0,3900
Y2OFQP9O,3900,1/11/2020,8900,Y2OFQP9O,20600,more than downpayment,more than downpayment,0,3900
Y34ZANT1,9900,8/26/2019,40000,,9900,less than downpayment,,9900,0
Y34ZANT1,3900,10/7/2019,40000,Y34ZANT1,13800,less than downpayment,less than downpayment,3900,0
Y34ZANT1,26200,10/17/2019,40000,Y34ZANT1,40000,equal to downpayment,less than downpayment,26200,0
Y34ZANT1,30000,10/18/2019,40000,Y34ZANT1,70000,more than downpayment,equal to downpayment,0,30000
Y34ZANT1,30000,10/23/2019,40000,Y34ZANT1,100000,more than downpayment,more than downpayment,0,30000
Y34ZANT1,15000,11/4/2019,40000,Y34ZANT1,115000,more than downpayment,more than downpayment,0,15000
Y34ZANT1,15000,11/6/2019,40000,Y34ZANT1,130000,more than downpayment,more than downpayment,0,15000
Y3SNFU95,9900,12/17/2019,9900,,9900,equal to downpayment,,9900,0
Y4AN2SRH,9900,12/26/2019,9900,,9900,equal to downpayment,,9900,0
Y7L2P3PZ,9900,1/20/2020,9900,,9900,equal to downpayment,,9900,0
y9Bj3sno,9900,6/14/2019,9900,,9900,equal to downpayment,,9900,0
y9Bj3sno,3900,7/29/2019,9900,y9Bj3sno,13800,more than downpayment,equal to downpayment,0,3900
y9Bj3sno,3900,9/23/2019,9900,y9Bj3sno,17700,more than downpayment,more than downpayment,0,3900
y9Bj3sno,3900,11/2/2019,9900,y9Bj3sno,21600,more than downpayment,more than downpayment,0,3900
y9Bj3sno,3900,11/16/2019,9900,y9Bj3sno,25500,more than downpayment,more than downpayment,0,3900
y9Bj3sno,3900,1/10/2020,9900,y9Bj3sno,29400,more than downpayment,more than downpayment,0,3900
y9Bj3sno,3900,1/30/2020,9900,y9Bj3sno,33300,more than downpayment,more than downpayment,0,3900
Y9UB1td3,10000,2/4/2019,10000,,10000,equal to downpayment,,10000,0
y9va8cbp,8900,1/15/2019,8900,,8900,equal to downpayment,,8900,0
y9va8cbp,3900,2/4/2019,8900,y9va8cbp,12800,more than downpayment,equal to downpayment,0,3900
y9va8cbp,3900,3/21/2019,8900,y9va8cbp,16700,more than downpayment,more than downpayment,0,3900
y9va8cbp,3900,4/24/2019,8900,y9va8cbp,20600,more than downpayment,more than downpayment,0,3900
y9va8cbp,3900,5/23/2019,8900,y9va8cbp,24500,more than downpayment,more than downpayment,0,3900
y9va8cbp,2000,7/17/2019,8900,y9va8cbp,26500,more than downpayment,more than downpayment,0,2000
y9va8cbp,1900,8/1/2019,8900,y9va8cbp,28400,more than downpayment,more than downpayment,0,1900
y9va8cbp,3900,8/30/2019,8900,y9va8cbp,32300,more than downpayment,more than downpayment,0,3900
y9va8cbp,3900,10/11/2019,8900,y9va8cbp,36200,more than downpayment,more than downpayment,0,3900
y9va8cbp,3900,11/7/2019,8900,y9va8cbp,40100,more than downpayment,more than downpayment,0,3900
y9va8cbp,3900,12/16/2019,8900,y9va8cbp,44000,more than downpayment,more than downpayment,0,3900
y9va8cbp,3900,1/4/2020,8900,y9va8cbp,47900,more than downpayment,more than downpayment,0,3900
y9va8cbp,3900,2/5/2020,8900,y9va8cbp,51800,more than downpayment,more than downpayment,0,3900
Yb7YJT2d,10000,1/24/2019,10000,,10000,equal to downpayment,,10000,0
Yb7YJT2d,4500,2/21/2019,10000,Yb7YJT2d,14500,more than downpayment,equal to downpayment,0,4500
Yb7YJT2d,5500,3/22/2019,10000,Yb7YJT2d,20000,more than downpayment,more than downpayment,0,5500
Yb7YJT2d,5000,4/22/2019,10000,Yb7YJT2d,25000,more than downpayment,more than downpayment,0,5000
Yb7YJT2d,5000,5/22/2019,10000,Yb7YJT2d,30000,more than downpayment,more than downpayment,0,5000
Yb7YJT2d,5000,6/19/2019,10000,Yb7YJT2d,35000,more than downpayment,more than downpayment,0,5000
Yb7YJT2d,23000,7/22/2019,10000,Yb7YJT2d,58000,more than downpayment,more than downpayment,0,23000
yBCFoG5H,50000,8/16/2018,8900,,50000,more than downpayment,,8900,41100
yBCFoG5H,8900,2/13/2019,8900,yBCFoG5H,58900,more than downpayment,more than downpayment,0,8900
yBCFoG5H,5000,3/11/2019,8900,yBCFoG5H,63900,more than downpayment,more than downpayment,0,5000
yBCFoG5H,5000,4/9/2019,8900,yBCFoG5H,68900,more than downpayment,more than downpayment,0,5000
yBCFoG5H,4000,5/22/2019,8900,yBCFoG5H,72900,more than downpayment,more than downpayment,0,4000
yBCFoG5H,4000,6/25/2019,8900,yBCFoG5H,76900,more than downpayment,more than downpayment,0,4000
yBCFoG5H,4000,7/26/2019,8900,yBCFoG5H,80900,more than downpayment,more than downpayment,0,4000
yBCFoG5H,4000,8/24/2019,8900,yBCFoG5H,84900,more than downpayment,more than downpayment,0,4000
yBCFoG5H,4000,9/24/2019,8900,yBCFoG5H,88900,more than downpayment,more than downpayment,0,4000
yBCFoG5H,4000,10/23/2019,8900,yBCFoG5H,92900,more than downpayment,more than downpayment,0,4000
yBCFoG5H,5000,11/26/2019,8900,yBCFoG5H,97900,more than downpayment,more than downpayment,0,5000
yBCFoG5H,6000,1/24/2020,8900,yBCFoG5H,103900,more than downpayment,more than downpayment,0,6000
YBJFBWR8,10000,7/9/2017,10000,,10000,equal to downpayment,,10000,0
YBJFBWR8,3500,1/15/2018,10000,YBJFBWR8,13500,more than downpayment,equal to downpayment,0,3500
YBJFBWR8,10000,2/24/2018,10000,YBJFBWR8,23500,more than downpayment,more than downpayment,0,10000
YBJFBWR8,7000,2/26/2018,10000,YBJFBWR8,30500,more than downpayment,more than downpayment,0,7000
YBJFBWR8,7000,6/13/2018,10000,YBJFBWR8,37500,more than downpayment,more than downpayment,0,7000
YBJFBWR8,5000,8/4/2018,10000,YBJFBWR8,42500,more than downpayment,more than downpayment,0,5000
YBJFBWR8,2500,9/30/2018,10000,YBJFBWR8,45000,more than downpayment,more than downpayment,0,2500
yBrnz4vg,10000,6/10/2017,10000,,10000,equal to downpayment,,10000,0
yBrnz4vg,3500,7/19/2017,10000,yBrnz4vg,13500,more than downpayment,equal to downpayment,0,3500
yBrnz4vg,3500,10/28/2017,10000,yBrnz4vg,17000,more than downpayment,more than downpayment,0,3500
yBrnz4vg,3500,12/28/2017,10000,yBrnz4vg,20500,more than downpayment,more than downpayment,0,3500
yBrnz4vg,3500,1/13/2018,10000,yBrnz4vg,24000,more than downpayment,more than downpayment,0,3500
yBrnz4vg,7000,2/10/2018,10000,yBrnz4vg,31000,more than downpayment,more than downpayment,0,7000
yBrnz4vg,3500,2/23/2018,10000,yBrnz4vg,34500,more than downpayment,more than downpayment,0,3500
yBrnz4vg,3500,4/28/2018,10000,yBrnz4vg,38000,more than downpayment,more than downpayment,0,3500
yBrnz4vg,3000,6/14/2018,10000,yBrnz4vg,41000,more than downpayment,more than downpayment,0,3000
yBrnz4vg,2000,9/18/2018,10000,yBrnz4vg,43000,more than downpayment,more than downpayment,0,2000
yBrnz4vg,4000,10/31/2018,10000,yBrnz4vg,47000,more than downpayment,more than downpayment,0,4000
yC2zNkGz,24500,6/6/2019,8900,,24500,more than downpayment,,8900,15600
yC2zNkGz,7300,7/22/2019,8900,yC2zNkGz,31800,more than downpayment,more than downpayment,0,7300
yC2zNkGz,7300,8/21/2019,8900,yC2zNkGz,39100,more than downpayment,more than downpayment,0,7300
yC2zNkGz,7300,9/17/2019,8900,yC2zNkGz,46400,more than downpayment,more than downpayment,0,7300
yC2zNkGz,7300,10/13/2019,8900,yC2zNkGz,53700,more than downpayment,more than downpayment,0,7300
yC2zNkGz,7300,11/17/2019,8900,yC2zNkGz,61000,more than downpayment,more than downpayment,0,7300
yC2zNkGz,7300,12/20/2019,8900,yC2zNkGz,68300,more than downpayment,more than downpayment,0,7300
yC2zNkGz,7300,1/20/2020,8900,yC2zNkGz,75600,more than downpayment,more than downpayment,0,7300
YC4OTLIQ,8900,8/7/2019,8900,,8900,equal to downpayment,,8900,0
YC4OTLIQ,3900,9/30/2019,8900,YC4OTLIQ,12800,more than downpayment,equal to downpayment,0,3900
YC4OTLIQ,3900,11/11/2019,8900,YC4OTLIQ,16700,more than downpayment,more than downpayment,0,3900
YC4OTLIQ,3900,12/5/2019,8900,YC4OTLIQ,20600,more than downpayment,more than downpayment,0,3900
YC4OTLIQ,3900,12/18/2019,8900,YC4OTLIQ,24500,more than downpayment,more than downpayment,0,3900
YC4OTLIQ,3900,1/15/2020,8900,YC4OTLIQ,28400,more than downpayment,more than downpayment,0,3900
YCCIREQW,9900,2/9/2020,9900,,9900,equal to downpayment,,9900,0
YCka8luv,8900,12/22/2018,8900,,8900,equal to downpayment,,8900,0
YCka8luv,3900,2/25/2019,8900,YCka8luv,12800,more than downpayment,equal to downpayment,0,3900
YCka8luv,3900,3/25/2019,8900,YCka8luv,16700,more than downpayment,more than downpayment,0,3900
YCka8luv,3900,4/26/2019,8900,YCka8luv,20600,more than downpayment,more than downpayment,0,3900
YCka8luv,3900,5/27/2019,8900,YCka8luv,24500,more than downpayment,more than downpayment,0,3900
YCka8luv,3900,6/25/2019,8900,YCka8luv,28400,more than downpayment,more than downpayment,0,3900
YCka8luv,3900,7/26/2019,8900,YCka8luv,32300,more than downpayment,more than downpayment,0,3900
YCka8luv,3900,8/26/2019,8900,YCka8luv,36200,more than downpayment,more than downpayment,0,3900
YCka8luv,3900,10/2/2019,8900,YCka8luv,40100,more than downpayment,more than downpayment,0,3900
YCka8luv,3900,11/8/2019,8900,YCka8luv,44000,more than downpayment,more than downpayment,0,3900
YCka8luv,1400,12/18/2019,8900,YCka8luv,45400,more than downpayment,more than downpayment,0,1400
YCka8luv,2500,12/31/2019,8900,YCka8luv,47900,more than downpayment,more than downpayment,0,2500
YCka8luv,1500,1/17/2020,8900,YCka8luv,49400,more than downpayment,more than downpayment,0,1500
YCka8luv,2400,1/20/2020,8900,YCka8luv,51800,more than downpayment,more than downpayment,0,2400
YcpfrTvR,9900,7/3/2019,9900,,9900,equal to downpayment,,9900,0
YcpfrTvR,11700,8/13/2019,9900,YcpfrTvR,21600,more than downpayment,equal to downpayment,0,11700
YcpfrTvR,3900,11/19/2019,9900,YcpfrTvR,25500,more than downpayment,more than downpayment,0,3900
YcpfrTvR,3900,1/22/2020,9900,YcpfrTvR,29400,more than downpayment,more than downpayment,0,3900
YdywySVP,9900,6/10/2019,8900,,9900,more than downpayment,,8900,1000
YdywySVP,3900,7/24/2019,8900,YdywySVP,13800,more than downpayment,more than downpayment,0,3900
YdywySVP,3900,8/23/2019,8900,YdywySVP,17700,more than downpayment,more than downpayment,0,3900
YdywySVP,3900,9/24/2019,8900,YdywySVP,21600,more than downpayment,more than downpayment,0,3900
YdywySVP,3900,11/1/2019,8900,YdywySVP,25500,more than downpayment,more than downpayment,0,3900
YdywySVP,3900,11/29/2019,8900,YdywySVP,29400,more than downpayment,more than downpayment,0,3900
YdywySVP,3900,12/26/2019,8900,YdywySVP,33300,more than downpayment,more than downpayment,0,3900
YdywySVP,2900,1/31/2020,8900,YdywySVP,36200,more than downpayment,more than downpayment,0,2900
YEY0Few0,8900,5/24/2019,8900,,8900,equal to downpayment,,8900,0
YEY0Few0,3900,7/2/2019,8900,YEY0Few0,12800,more than downpayment,equal to downpayment,0,3900
YEY0Few0,3200,8/14/2019,8900,YEY0Few0,16000,more than downpayment,more than downpayment,0,3200
YEY0Few0,8500,9/5/2019,8900,YEY0Few0,24500,more than downpayment,more than downpayment,0,8500
YEY0Few0,1500,10/15/2019,8900,YEY0Few0,26000,more than downpayment,more than downpayment,0,1500
YEY0Few0,2400,10/24/2019,8900,YEY0Few0,28400,more than downpayment,more than downpayment,0,2400
YEY0Few0,2900,11/14/2019,8900,YEY0Few0,31300,more than downpayment,more than downpayment,0,2900
YEY0Few0,1000,12/1/2019,8900,YEY0Few0,32300,more than downpayment,more than downpayment,0,1000
YEY0Few0,3900,12/16/2019,8900,YEY0Few0,36200,more than downpayment,more than downpayment,0,3900
YEY0Few0,3900,2/4/2020,8900,YEY0Few0,40100,more than downpayment,more than downpayment,0,3900
YF3OUVWT,10000,12/6/2019,8900,,10000,more than downpayment,,8900,1100
YF3OUVWT,30000,2/6/2020,8900,YF3OUVWT,40000,more than downpayment,more than downpayment,0,30000
YFhccPr4,8900,5/1/2019,8900,,8900,equal to downpayment,,8900,0
YFhccPr4,3900,6/21/2019,8900,YFhccPr4,12800,more than downpayment,equal to downpayment,0,3900
YFhccPr4,3900,7/29/2019,8900,YFhccPr4,16700,more than downpayment,more than downpayment,0,3900
YFhccPr4,3900,8/26/2019,8900,YFhccPr4,20600,more than downpayment,more than downpayment,0,3900
YFhccPr4,3900,10/14/2019,8900,YFhccPr4,24500,more than downpayment,more than downpayment,0,3900
YFhccPr4,3900,11/5/2019,8900,YFhccPr4,28400,more than downpayment,more than downpayment,0,3900
YFhccPr4,3900,11/25/2019,8900,YFhccPr4,32300,more than downpayment,more than downpayment,0,3900
YFhccPr4,3900,12/27/2019,8900,YFhccPr4,36200,more than downpayment,more than downpayment,0,3900
YFhccPr4,3900,1/27/2020,8900,YFhccPr4,40100,more than downpayment,more than downpayment,0,3900
YFP5Q4GR,8900,1/10/2020,8900,,8900,equal to downpayment,,8900,0
yFpTQyuq,26250,7/16/2019,26250,,26250,equal to downpayment,,26250,0
yFpTQyuq,26250,9/2/2019,26250,yFpTQyuq,52500,more than downpayment,equal to downpayment,0,26250
yFpTQyuq,26250,10/5/2019,26250,yFpTQyuq,78750,more than downpayment,more than downpayment,0,26250
yFpTQyuq,20250,11/29/2019,26250,yFpTQyuq,99000,more than downpayment,more than downpayment,0,20250
yFpTQyuq,6000,12/17/2019,26250,yFpTQyuq,105000,more than downpayment,more than downpayment,0,6000
YGOLg3FN,8900,5/7/2019,8900,,8900,equal to downpayment,,8900,0
YGOLg3FN,3900,6/13/2019,8900,YGOLg3FN,12800,more than downpayment,equal to downpayment,0,3900
YGOLg3FN,4000,8/8/2019,8900,YGOLg3FN,16800,more than downpayment,more than downpayment,0,4000
YGOLg3FN,3900,8/22/2019,8900,YGOLg3FN,20700,more than downpayment,more than downpayment,0,3900
YGOLg3FN,3900,9/24/2019,8900,YGOLg3FN,24600,more than downpayment,more than downpayment,0,3900
YGOLg3FN,7800,11/9/2019,8900,YGOLg3FN,32400,more than downpayment,more than downpayment,0,7800
YGOLg3FN,3900,1/7/2020,8900,YGOLg3FN,36300,more than downpayment,more than downpayment,0,3900
YGOLg3FN,7800,1/30/2020,8900,YGOLg3FN,44100,more than downpayment,more than downpayment,0,7800
yGXhGkhP,8900,7/15/2019,8900,,8900,equal to downpayment,,8900,0
yGXhGkhP,3900,9/18/2019,8900,yGXhGkhP,12800,more than downpayment,equal to downpayment,0,3900
yGXhGkhP,3900,10/29/2019,8900,yGXhGkhP,16700,more than downpayment,more than downpayment,0,3900
yGXhGkhP,1000,12/16/2019,8900,yGXhGkhP,17700,more than downpayment,more than downpayment,0,1000
yGXhGkhP,1000,12/19/2019,8900,yGXhGkhP,18700,more than downpayment,more than downpayment,0,1000
YHFXKPAQ,9900,1/20/2020,9900,,9900,equal to downpayment,,9900,0
YHlIvGaH,10000,11/30/2018,10000,,10000,equal to downpayment,,10000,0
YHlIvGaH,4500,1/9/2019,10000,YHlIvGaH,14500,more than downpayment,equal to downpayment,0,4500
YHlIvGaH,4500,2/6/2019,10000,YHlIvGaH,19000,more than downpayment,more than downpayment,0,4500
YHlIvGaH,4500,3/6/2019,10000,YHlIvGaH,23500,more than downpayment,more than downpayment,0,4500
YHlIvGaH,4500,4/6/2019,10000,YHlIvGaH,28000,more than downpayment,more than downpayment,0,4500
YHlIvGaH,4500,5/6/2019,10000,YHlIvGaH,32500,more than downpayment,more than downpayment,0,4500
YHlIvGaH,4500,6/6/2019,10000,YHlIvGaH,37000,more than downpayment,more than downpayment,0,4500
YHlIvGaH,4500,7/9/2019,10000,YHlIvGaH,41500,more than downpayment,more than downpayment,0,4500
YHlIvGaH,9000,9/12/2019,10000,YHlIvGaH,50500,more than downpayment,more than downpayment,0,9000
YHlIvGaH,4500,1/16/2020,10000,YHlIvGaH,55000,more than downpayment,more than downpayment,0,4500
YHPWYD2g,12800,5/31/2019,8900,,12800,more than downpayment,,8900,3900
YHPWYD2g,3900,9/10/2019,8900,YHPWYD2g,16700,more than downpayment,more than downpayment,0,3900
YHPWYD2g,3900,10/8/2019,8900,YHPWYD2g,20600,more than downpayment,more than downpayment,0,3900
YHPWYD2g,3900,11/8/2019,8900,YHPWYD2g,24500,more than downpayment,more than downpayment,0,3900
YHPWYD2g,3900,12/9/2019,8900,YHPWYD2g,28400,more than downpayment,more than downpayment,0,3900
YHPWYD2g,3900,1/6/2020,8900,YHPWYD2g,32300,more than downpayment,more than downpayment,0,3900
YHPWYD2g,3900,2/5/2020,8900,YHPWYD2g,36200,more than downpayment,more than downpayment,0,3900
YHRACSYR,9900,1/27/2020,9900,,9900,equal to downpayment,,9900,0
YI1OAXBO,4000,5/7/2019,8900,,4000,less than downpayment,,4000,0
YI1OAXBO,4999,5/27/2019,8900,YI1OAXBO,8999,more than downpayment,less than downpayment,4900,99
YI1OAXBO,3900,7/9/2019,8900,YI1OAXBO,12899,more than downpayment,more than downpayment,0,3900
YI1OAXBO,6000,8/23/2019,8900,YI1OAXBO,18899,more than downpayment,more than downpayment,0,6000
YI1OAXBO,6000,9/6/2019,8900,YI1OAXBO,24899,more than downpayment,more than downpayment,0,6000
YI1OAXBO,6000,10/28/2019,8900,YI1OAXBO,30899,more than downpayment,more than downpayment,0,6000
YI1OAXBO,6000,1/9/2020,8900,YI1OAXBO,36899,more than downpayment,more than downpayment,0,6000
YI1OAXBO,8000,2/4/2020,8900,YI1OAXBO,44899,more than downpayment,more than downpayment,0,8000
YI7JLOIF,26250,7/5/2019,8900,,26250,more than downpayment,,8900,17350
YI7JLOIF,1000,7/11/2019,8900,YI7JLOIF,27250,more than downpayment,more than downpayment,0,1000
YI7JLOIF,26250,8/26/2019,8900,YI7JLOIF,53500,more than downpayment,more than downpayment,0,26250
YI7JLOIF,10250,10/26/2019,8900,YI7JLOIF,63750,more than downpayment,more than downpayment,0,10250
YI7JLOIF,10000,10/29/2019,8900,YI7JLOIF,73750,more than downpayment,more than downpayment,0,10000
YI7JLOIF,6000,11/19/2019,8900,YI7JLOIF,79750,more than downpayment,more than downpayment,0,6000
YI7JLOIF,21250,12/2/2019,8900,YI7JLOIF,101000,more than downpayment,more than downpayment,0,21250
YI7JLOIF,2500,1/16/2020,8900,YI7JLOIF,103500,more than downpayment,more than downpayment,0,2500
YI7JLOIF,2500,1/21/2020,8900,YI7JLOIF,106000,more than downpayment,more than downpayment,0,2500
YiHIvKpd,9900,1/2/2019,9900,,9900,equal to downpayment,,9900,0
YiHIvKpd,4500,2/11/2019,9900,YiHIvKpd,14400,more than downpayment,equal to downpayment,0,4500
YiHIvKpd,4500,3/10/2019,9900,YiHIvKpd,18900,more than downpayment,more than downpayment,0,4500
YiHIvKpd,4500,4/12/2019,9900,YiHIvKpd,23400,more than downpayment,more than downpayment,0,4500
YiHIvKpd,4500,5/15/2019,9900,YiHIvKpd,27900,more than downpayment,more than downpayment,0,4500
YiHIvKpd,4500,6/14/2019,9900,YiHIvKpd,32400,more than downpayment,more than downpayment,0,4500
YiHIvKpd,4500,7/10/2019,9900,YiHIvKpd,36900,more than downpayment,more than downpayment,0,4500
YiHIvKpd,4500,8/12/2019,9900,YiHIvKpd,41400,more than downpayment,more than downpayment,0,4500
YiHIvKpd,1850,10/8/2019,9900,YiHIvKpd,43250,more than downpayment,more than downpayment,0,1850
YiHIvKpd,2300,10/25/2019,9900,YiHIvKpd,45550,more than downpayment,more than downpayment,0,2300
YiHIvKpd,138,10/27/2019,9900,YiHIvKpd,45688,more than downpayment,more than downpayment,0,138
YiHIvKpd,163,10/28/2019,9900,YiHIvKpd,45851,more than downpayment,more than downpayment,0,163
YiHIvKpd,11000,11/20/2019,9900,YiHIvKpd,56851,more than downpayment,more than downpayment,0,11000
YiHIvKpd,680,11/30/2019,9900,YiHIvKpd,57531,more than downpayment,more than downpayment,0,680
YiHIvKpd,970,1/3/2020,9900,YiHIvKpd,58501,more than downpayment,more than downpayment,0,970
YiHIvKpd,4030,1/5/2020,9900,YiHIvKpd,62531,more than downpayment,more than downpayment,0,4030
YiHIvKpd,1950,1/27/2020,9900,YiHIvKpd,64481,more than downpayment,more than downpayment,0,1950
Yjc3TLLE,9900,6/8/2019,8900,,9900,more than downpayment,,8900,1000
Yjc3TLLE,5000,7/25/2019,8900,Yjc3TLLE,14900,more than downpayment,more than downpayment,0,5000
Yjc3TLLE,3900,8/30/2019,8900,Yjc3TLLE,18800,more than downpayment,more than downpayment,0,3900
Yjc3TLLE,3900,9/28/2019,8900,Yjc3TLLE,22700,more than downpayment,more than downpayment,0,3900
Yjc3TLLE,5000,10/30/2019,8900,Yjc3TLLE,27700,more than downpayment,more than downpayment,0,5000
Yjc3TLLE,5000,12/1/2019,8900,Yjc3TLLE,32700,more than downpayment,more than downpayment,0,5000
Yjc3TLLE,4000,1/29/2020,8900,Yjc3TLLE,36700,more than downpayment,more than downpayment,0,4000
YJpZf7wg,9900,6/28/2019,9900,,9900,equal to downpayment,,9900,0
YJpZf7wg,10000,12/18/2019,9900,YJpZf7wg,19900,more than downpayment,equal to downpayment,0,10000
YJpZf7wg,5000,1/19/2020,9900,YJpZf7wg,24900,more than downpayment,more than downpayment,0,5000
YK9YDST6,9900,11/28/2019,9900,,9900,equal to downpayment,,9900,0
YK9YDST6,3900,1/4/2020,9900,YK9YDST6,13800,more than downpayment,equal to downpayment,0,3900
YK9YDST6,3900,2/4/2020,9900,YK9YDST6,17700,more than downpayment,more than downpayment,0,3900
YL7HG7MR,5000,12/17/2019,4999,,5000,more than downpayment,,4999,1
YLiTUaXp,10000,12/10/2018,10000,,10000,equal to downpayment,,10000,0
YLiTUaXp,10000,1/25/2019,10000,YLiTUaXp,20000,more than downpayment,equal to downpayment,0,10000
YLiTUaXp,5000,2/24/2019,10000,YLiTUaXp,25000,more than downpayment,more than downpayment,0,5000
YLiTUaXp,5000,3/24/2019,10000,YLiTUaXp,30000,more than downpayment,more than downpayment,0,5000
YLiTUaXp,5000,4/21/2019,10000,YLiTUaXp,35000,more than downpayment,more than downpayment,0,5000
YLiTUaXp,5000,5/21/2019,10000,YLiTUaXp,40000,more than downpayment,more than downpayment,0,5000
YLiTUaXp,5000,6/20/2019,10000,YLiTUaXp,45000,more than downpayment,more than downpayment,0,5000
YLiTUaXp,5000,7/23/2019,10000,YLiTUaXp,50000,more than downpayment,more than downpayment,0,5000
YLiTUaXp,5000,8/24/2019,10000,YLiTUaXp,55000,more than downpayment,more than downpayment,0,5000
YLiTUaXp,4000,9/25/2019,10000,YLiTUaXp,59000,more than downpayment,more than downpayment,0,4000
YLiTUaXp,500,12/31/2019,10000,YLiTUaXp,59500,more than downpayment,more than downpayment,0,500
YLiTUaXp,2000,1/30/2020,10000,YLiTUaXp,61500,more than downpayment,more than downpayment,0,2000
YLJ2I6W8,8900,9/2/2019,8900,,8900,equal to downpayment,,8900,0
YLJ2I6W8,3900,10/24/2019,8900,YLJ2I6W8,12800,more than downpayment,equal to downpayment,0,3900
YLJ2I6W8,3900,11/14/2019,8900,YLJ2I6W8,16700,more than downpayment,more than downpayment,0,3900
YLJ2I6W8,3900,12/3/2019,8900,YLJ2I6W8,20600,more than downpayment,more than downpayment,0,3900
YLJ2I6W8,3900,1/14/2020,8900,YLJ2I6W8,24500,more than downpayment,more than downpayment,0,3900
YLJ2I6W8,3900,2/5/2020,8900,YLJ2I6W8,28400,more than downpayment,more than downpayment,0,3900
YLOMME9V,9900,11/13/2019,40000,,9900,less than downpayment,,9900,0
YLOMME9V,3900,11/22/2019,40000,YLOMME9V,13800,less than downpayment,less than downpayment,3900,0
YLOMME9V,3900,12/4/2019,40000,YLOMME9V,17700,less than downpayment,less than downpayment,3900,0
YLOMME9V,71700,12/31/2019,40000,YLOMME9V,89400,more than downpayment,less than downpayment,22300,49400
YLOMME9V,10600,1/2/2020,40000,YLOMME9V,100000,more than downpayment,more than downpayment,0,10600
YLOMME9V,30000,1/6/2020,40000,YLOMME9V,130000,more than downpayment,more than downpayment,0,30000
YM699TMH,9900,11/3/2019,9900,,9900,equal to downpayment,,9900,0
YM699TMH,3900,12/24/2019,9900,YM699TMH,13800,more than downpayment,equal to downpayment,0,3900
YM699TMH,3900,1/22/2020,9900,YM699TMH,17700,more than downpayment,more than downpayment,0,3900
YMEO5A9A,9900,7/12/2019,8900,,9900,more than downpayment,,8900,1000
YMEO5A9A,4100,8/3/2019,8900,YMEO5A9A,14000,more than downpayment,more than downpayment,0,4100
YMEO5A9A,600,8/4/2019,8900,YMEO5A9A,14600,more than downpayment,more than downpayment,0,600
YMEO5A9A,600,8/5/2019,8900,YMEO5A9A,15200,more than downpayment,more than downpayment,0,600
YMEO5A9A,600,8/6/2019,8900,YMEO5A9A,15800,more than downpayment,more than downpayment,0,600
YMEO5A9A,200,8/12/2019,8900,YMEO5A9A,16000,more than downpayment,more than downpayment,0,200
YMEO5A9A,170,8/13/2019,8900,YMEO5A9A,16170,more than downpayment,more than downpayment,0,170
YMEO5A9A,1530,8/28/2019,8900,YMEO5A9A,17700,more than downpayment,more than downpayment,0,1530
YMEO5A9A,3900,9/6/2019,8900,YMEO5A9A,21600,more than downpayment,more than downpayment,0,3900
YMEO5A9A,3900,10/6/2019,8900,YMEO5A9A,25500,more than downpayment,more than downpayment,0,3900
YMEO5A9A,250,10/10/2019,8900,YMEO5A9A,25750,more than downpayment,more than downpayment,0,250
YMEO5A9A,1500,11/4/2019,8900,YMEO5A9A,27250,more than downpayment,more than downpayment,0,1500
YMEO5A9A,3900,11/18/2019,8900,YMEO5A9A,31150,more than downpayment,more than downpayment,0,3900
YMEO5A9A,1000,12/26/2019,8900,YMEO5A9A,32150,more than downpayment,more than downpayment,0,1000
YMEO5A9A,3900,1/29/2020,8900,YMEO5A9A,36050,more than downpayment,more than downpayment,0,3900
ymvvQmUz,10000,8/10/2017,10000,,10000,equal to downpayment,,10000,0
ymvvQmUz,3500,10/1/2017,10000,ymvvQmUz,13500,more than downpayment,equal to downpayment,0,3500
ymvvQmUz,3500,11/3/2017,10000,ymvvQmUz,17000,more than downpayment,more than downpayment,0,3500
ymvvQmUz,3500,12/2/2017,10000,ymvvQmUz,20500,more than downpayment,more than downpayment,0,3500
ymvvQmUz,5000,1/2/2018,10000,ymvvQmUz,25500,more than downpayment,more than downpayment,0,5000
ymvvQmUz,3500,3/2/2018,10000,ymvvQmUz,29000,more than downpayment,more than downpayment,0,3500
ymvvQmUz,3500,4/1/2018,10000,ymvvQmUz,32500,more than downpayment,more than downpayment,0,3500
ymvvQmUz,3500,5/1/2018,10000,ymvvQmUz,36000,more than downpayment,more than downpayment,0,3500
ymvvQmUz,3500,6/1/2018,10000,ymvvQmUz,39500,more than downpayment,more than downpayment,0,3500
ymvvQmUz,2000,7/9/2018,10000,ymvvQmUz,41500,more than downpayment,more than downpayment,0,2000
ymvvQmUz,3500,8/20/2018,10000,ymvvQmUz,45000,more than downpayment,more than downpayment,0,3500
yn7s3Jzf,10000,7/24/2017,10000,,10000,equal to downpayment,,10000,0
yn7s3Jzf,3500,8/17/2017,10000,yn7s3Jzf,13500,more than downpayment,equal to downpayment,0,3500
yn7s3Jzf,7000,1/15/2018,10000,yn7s3Jzf,20500,more than downpayment,more than downpayment,0,7000
yn7s3Jzf,25500,1/30/2018,10000,yn7s3Jzf,46000,more than downpayment,more than downpayment,0,25500
yn7s3Jzf,6000,1/31/2018,10000,yn7s3Jzf,52000,more than downpayment,more than downpayment,0,6000
YNABmFV5,8900,2/4/2019,8900,,8900,equal to downpayment,,8900,0
YNABmFV5,3900,3/6/2019,8900,YNABmFV5,12800,more than downpayment,equal to downpayment,0,3900
YNABmFV5,4000,4/7/2019,8900,YNABmFV5,16800,more than downpayment,more than downpayment,0,4000
YNABmFV5,3800,5/7/2019,8900,YNABmFV5,20600,more than downpayment,more than downpayment,0,3800
YNABmFV5,3900,6/15/2019,8900,YNABmFV5,24500,more than downpayment,more than downpayment,0,3900
YNABmFV5,3900,7/8/2019,8900,YNABmFV5,28400,more than downpayment,more than downpayment,0,3900
YNABmFV5,3900,8/8/2019,8900,YNABmFV5,32300,more than downpayment,more than downpayment,0,3900
YNABmFV5,3900,9/16/2019,8900,YNABmFV5,36200,more than downpayment,more than downpayment,0,3900
YNABmFV5,4000,10/8/2019,8900,YNABmFV5,40200,more than downpayment,more than downpayment,0,4000
YNABmFV5,3900,11/23/2019,8900,YNABmFV5,44100,more than downpayment,more than downpayment,0,3900
YNABmFV5,3900,12/20/2019,8900,YNABmFV5,48000,more than downpayment,more than downpayment,0,3900
YNABmFV5,3900,1/24/2020,8900,YNABmFV5,51900,more than downpayment,more than downpayment,0,3900
YNMCGQQY,9900,10/29/2019,40000,,9900,less than downpayment,,9900,0
YNMCGQQY,112100,12/17/2019,40000,YNMCGQQY,122000,more than downpayment,less than downpayment,30100,82000
YNMCGQQY,8000,12/20/2019,40000,YNMCGQQY,130000,more than downpayment,more than downpayment,0,8000
YNSNHqDA,20000,11/23/2018,9900,,20000,more than downpayment,,9900,10100
YO7GQBF9,9900,12/27/2019,9900,,9900,equal to downpayment,,9900,0
YO7GQBF9,3900,2/6/2020,9900,YO7GQBF9,13800,more than downpayment,equal to downpayment,0,3900
yoeYdBqk,8900,5/7/2019,8900,,8900,equal to downpayment,,8900,0
yoeYdBqk,3900,5/31/2019,8900,yoeYdBqk,12800,more than downpayment,equal to downpayment,0,3900
yoeYdBqk,3900,7/2/2019,8900,yoeYdBqk,16700,more than downpayment,more than downpayment,0,3900
yoeYdBqk,3900,7/31/2019,8900,yoeYdBqk,20600,more than downpayment,more than downpayment,0,3900
yoeYdBqk,3900,9/7/2019,8900,yoeYdBqk,24500,more than downpayment,more than downpayment,0,3900
yoeYdBqk,3900,10/3/2019,8900,yoeYdBqk,28400,more than downpayment,more than downpayment,0,3900
yoeYdBqk,3900,11/6/2019,8900,yoeYdBqk,32300,more than downpayment,more than downpayment,0,3900
yoeYdBqk,3900,11/29/2019,8900,yoeYdBqk,36200,more than downpayment,more than downpayment,0,3900
yoeYdBqk,3900,1/3/2020,8900,yoeYdBqk,40100,more than downpayment,more than downpayment,0,3900
yoeYdBqk,3900,2/3/2020,8900,yoeYdBqk,44000,more than downpayment,more than downpayment,0,3900
YOKL6EBU,9900,11/22/2019,9900,,9900,equal to downpayment,,9900,0
YOxgbJTf,9900,8/7/2019,9900,,9900,equal to downpayment,,9900,0
YOxgbJTf,3900,9/23/2019,9900,YOxgbJTf,13800,more than downpayment,equal to downpayment,0,3900
YOxgbJTf,3900,10/30/2019,9900,YOxgbJTf,17700,more than downpayment,more than downpayment,0,3900
YOxgbJTf,3900,11/26/2019,9900,YOxgbJTf,21600,more than downpayment,more than downpayment,0,3900
YOxgbJTf,3900,12/31/2019,9900,YOxgbJTf,25500,more than downpayment,more than downpayment,0,3900
YOxgbJTf,3900,1/20/2020,9900,YOxgbJTf,29400,more than downpayment,more than downpayment,0,3900
YQdwg0R3,9900,6/28/2019,9900,,9900,equal to downpayment,,9900,0
YQdwg0R3,10000,7/31/2019,9900,YQdwg0R3,19900,more than downpayment,equal to downpayment,0,10000
YQdwg0R3,5000,10/2/2019,9900,YQdwg0R3,24900,more than downpayment,more than downpayment,0,5000
YQdwg0R3,10000,11/27/2019,9900,YQdwg0R3,34900,more than downpayment,more than downpayment,0,10000
yQk6dDso,10000,7/9/2019,8900,,10000,more than downpayment,,8900,1100
yQk6dDso,3900,8/24/2019,8900,yQk6dDso,13900,more than downpayment,more than downpayment,0,3900
yQk6dDso,3900,9/25/2019,8900,yQk6dDso,17800,more than downpayment,more than downpayment,0,3900
yQk6dDso,3900,10/28/2019,8900,yQk6dDso,21700,more than downpayment,more than downpayment,0,3900
yQk6dDso,3900,11/25/2019,8900,yQk6dDso,25600,more than downpayment,more than downpayment,0,3900
yQk6dDso,3900,12/27/2019,8900,yQk6dDso,29500,more than downpayment,more than downpayment,0,3900
yQk6dDso,3900,1/31/2020,8900,yQk6dDso,33400,more than downpayment,more than downpayment,0,3900
YQV94AVE,10000,7/1/2019,10000,,10000,equal to downpayment,,10000,0
YQV94AVE,4500,8/5/2019,10000,YQV94AVE,14500,more than downpayment,equal to downpayment,0,4500
YQV94AVE,4500,9/5/2019,10000,YQV94AVE,19000,more than downpayment,more than downpayment,0,4500
YQV94AVE,4500,10/6/2019,10000,YQV94AVE,23500,more than downpayment,more than downpayment,0,4500
YQV94AVE,4500,12/7/2019,10000,YQV94AVE,28000,more than downpayment,more than downpayment,0,4500
YQV94AVE,4500,1/7/2020,10000,YQV94AVE,32500,more than downpayment,more than downpayment,0,4500
YQV94AVE,4900,2/9/2020,10000,YQV94AVE,37400,more than downpayment,more than downpayment,0,4900
yQxALpkX,8900,5/17/2019,8900,,8900,equal to downpayment,,8900,0
yQxALpkX,5000,6/4/2019,8900,yQxALpkX,13900,more than downpayment,equal to downpayment,0,5000
yQxALpkX,5000,7/4/2019,8900,yQxALpkX,18900,more than downpayment,more than downpayment,0,5000
yQxALpkX,5000,8/3/2019,8900,yQxALpkX,23900,more than downpayment,more than downpayment,0,5000
yQxALpkX,3900,9/5/2019,8900,yQxALpkX,27800,more than downpayment,more than downpayment,0,3900
yQxALpkX,3900,10/3/2019,8900,yQxALpkX,31700,more than downpayment,more than downpayment,0,3900
yQxALpkX,3900,11/5/2019,8900,yQxALpkX,35600,more than downpayment,more than downpayment,0,3900
yQxALpkX,3900,12/4/2019,8900,yQxALpkX,39500,more than downpayment,more than downpayment,0,3900
yQxALpkX,3900,1/6/2020,8900,yQxALpkX,43400,more than downpayment,more than downpayment,0,3900
yQxALpkX,3900,2/5/2020,8900,yQxALpkX,47300,more than downpayment,more than downpayment,0,3900
yrDqa8HT,8900,5/20/2019,8900,,8900,equal to downpayment,,8900,0
yrDqa8HT,3900,7/5/2019,8900,yrDqa8HT,12800,more than downpayment,equal to downpayment,0,3900
yrDqa8HT,3900,8/7/2019,8900,yrDqa8HT,16700,more than downpayment,more than downpayment,0,3900
yrDqa8HT,3900,9/9/2019,8900,yrDqa8HT,20600,more than downpayment,more than downpayment,0,3900
yrDqa8HT,3900,10/8/2019,8900,yrDqa8HT,24500,more than downpayment,more than downpayment,0,3900
yrDqa8HT,3900,11/7/2019,8900,yrDqa8HT,28400,more than downpayment,more than downpayment,0,3900
yrDqa8HT,3900,12/6/2019,8900,yrDqa8HT,32300,more than downpayment,more than downpayment,0,3900
yrDqa8HT,3900,1/7/2020,8900,yrDqa8HT,36200,more than downpayment,more than downpayment,0,3900
yrDqa8HT,3900,1/30/2020,8900,yrDqa8HT,40100,more than downpayment,more than downpayment,0,3900
yRs1uEHy,9900,7/9/2019,8900,,9900,more than downpayment,,8900,1000
yRs1uEHy,3900,8/25/2019,8900,yRs1uEHy,13800,more than downpayment,more than downpayment,0,3900
yRs1uEHy,3900,9/17/2019,8900,yRs1uEHy,17700,more than downpayment,more than downpayment,0,3900
yRs1uEHy,2000,1/22/2020,8900,yRs1uEHy,19700,more than downpayment,more than downpayment,0,2000
YrYLo18r,8900,5/9/2019,8900,,8900,equal to downpayment,,8900,0
YrYLo18r,3900,6/27/2019,8900,YrYLo18r,12800,more than downpayment,equal to downpayment,0,3900
YrYLo18r,3900,7/31/2019,8900,YrYLo18r,16700,more than downpayment,more than downpayment,0,3900
YrYLo18r,3900,10/11/2019,8900,YrYLo18r,20600,more than downpayment,more than downpayment,0,3900
YrYLo18r,15600,12/25/2019,8900,YrYLo18r,36200,more than downpayment,more than downpayment,0,15600
YrYLo18r,3900,12/26/2019,8900,YrYLo18r,40100,more than downpayment,more than downpayment,0,3900
YslCLgO3,8900,2/5/2019,8900,,8900,equal to downpayment,,8900,0
YslCLgO3,3900,4/1/2019,8900,YslCLgO3,12800,more than downpayment,equal to downpayment,0,3900
YslCLgO3,3900,5/7/2019,8900,YslCLgO3,16700,more than downpayment,more than downpayment,0,3900
YslCLgO3,3900,5/28/2019,8900,YslCLgO3,20600,more than downpayment,more than downpayment,0,3900
YslCLgO3,3900,8/30/2019,8900,YslCLgO3,24500,more than downpayment,more than downpayment,0,3900
YslCLgO3,7800,10/17/2019,8900,YslCLgO3,32300,more than downpayment,more than downpayment,0,7800
YslCLgO3,3900,11/14/2019,8900,YslCLgO3,36200,more than downpayment,more than downpayment,0,3900
ytSUdJhF,9900,7/30/2019,9900,,9900,equal to downpayment,,9900,0
ytSUdJhF,3900,9/4/2019,9900,ytSUdJhF,13800,more than downpayment,equal to downpayment,0,3900
ytSUdJhF,3900,10/4/2019,9900,ytSUdJhF,17700,more than downpayment,more than downpayment,0,3900
ytSUdJhF,3900,11/1/2019,9900,ytSUdJhF,21600,more than downpayment,more than downpayment,0,3900
ytSUdJhF,3900,12/4/2019,9900,ytSUdJhF,25500,more than downpayment,more than downpayment,0,3900
ytSUdJhF,3900,1/5/2020,9900,ytSUdJhF,29400,more than downpayment,more than downpayment,0,3900
YujSQYNt,8900,4/18/2019,8900,,8900,equal to downpayment,,8900,0
YujSQYNt,3900,5/28/2019,8900,YujSQYNt,12800,more than downpayment,equal to downpayment,0,3900
YujSQYNt,3900,6/24/2019,8900,YujSQYNt,16700,more than downpayment,more than downpayment,0,3900
YujSQYNt,3900,8/9/2019,8900,YujSQYNt,20600,more than downpayment,more than downpayment,0,3900
YujSQYNt,7800,10/16/2019,8900,YujSQYNt,28400,more than downpayment,more than downpayment,0,7800
YujSQYNt,7800,11/28/2019,8900,YujSQYNt,36200,more than downpayment,more than downpayment,0,7800
YujSQYNt,7800,1/17/2020,8900,YujSQYNt,44000,more than downpayment,more than downpayment,0,7800
YujSQYNt,3900,2/7/2020,8900,YujSQYNt,47900,more than downpayment,more than downpayment,0,3900
yULCaa73,8900,1/9/2019,8900,,8900,equal to downpayment,,8900,0
yULCaa73,3900,2/22/2019,8900,yULCaa73,12800,more than downpayment,equal to downpayment,0,3900
yULCaa73,3900,3/19/2019,8900,yULCaa73,16700,more than downpayment,more than downpayment,0,3900
yULCaa73,3900,4/15/2019,8900,yULCaa73,20600,more than downpayment,more than downpayment,0,3900
yULCaa73,3900,5/20/2019,8900,yULCaa73,24500,more than downpayment,more than downpayment,0,3900
yULCaa73,3900,6/13/2019,8900,yULCaa73,28400,more than downpayment,more than downpayment,0,3900
yULCaa73,3900,7/10/2019,8900,yULCaa73,32300,more than downpayment,more than downpayment,0,3900
yULCaa73,3900,8/11/2019,8900,yULCaa73,36200,more than downpayment,more than downpayment,0,3900
yULCaa73,3900,9/6/2019,8900,yULCaa73,40100,more than downpayment,more than downpayment,0,3900
yULCaa73,3900,10/13/2019,8900,yULCaa73,44000,more than downpayment,more than downpayment,0,3900
yULCaa73,3900,11/10/2019,8900,yULCaa73,47900,more than downpayment,more than downpayment,0,3900
yULCaa73,3900,12/10/2019,8900,yULCaa73,51800,more than downpayment,more than downpayment,0,3900
yULCaa73,3900,1/9/2020,8900,yULCaa73,55700,more than downpayment,more than downpayment,0,3900
yULCaa73,3900,2/7/2020,8900,yULCaa73,59600,more than downpayment,more than downpayment,0,3900
Yv0yK6RO,8900,5/16/2019,8900,,8900,equal to downpayment,,8900,0
Yv0yK6RO,3900,6/24/2019,8900,Yv0yK6RO,12800,more than downpayment,equal to downpayment,0,3900
Yv0yK6RO,3900,7/25/2019,8900,Yv0yK6RO,16700,more than downpayment,more than downpayment,0,3900
Yv0yK6RO,3900,8/24/2019,8900,Yv0yK6RO,20600,more than downpayment,more than downpayment,0,3900
Yv0yK6RO,3900,9/24/2019,8900,Yv0yK6RO,24500,more than downpayment,more than downpayment,0,3900
Yv0yK6RO,3900,10/25/2019,8900,Yv0yK6RO,28400,more than downpayment,more than downpayment,0,3900
Yv0yK6RO,3900,11/25/2019,8900,Yv0yK6RO,32300,more than downpayment,more than downpayment,0,3900
Yv0yK6RO,3900,12/26/2019,8900,Yv0yK6RO,36200,more than downpayment,more than downpayment,0,3900
Yv0yK6RO,3900,1/28/2020,8900,Yv0yK6RO,40100,more than downpayment,more than downpayment,0,3900
YVE74LB1,9900,9/29/2019,9900,,9900,equal to downpayment,,9900,0
YVE74LB1,3900,11/14/2019,9900,YVE74LB1,13800,more than downpayment,equal to downpayment,0,3900
YVE74LB1,3900,12/15/2019,9900,YVE74LB1,17700,more than downpayment,more than downpayment,0,3900
YVE74LB1,3900,1/15/2020,9900,YVE74LB1,21600,more than downpayment,more than downpayment,0,3900
YVJ7PQRQ,9900,1/6/2020,9900,,9900,equal to downpayment,,9900,0
YVM2QJD2,10000,11/30/2019,9900,,10000,more than downpayment,,9900,100
yw0MjOFp,26250,7/22/2019,26250,,26250,equal to downpayment,,26250,0
yw0MjOFp,26250,9/7/2019,26250,yw0MjOFp,52500,more than downpayment,equal to downpayment,0,26250
yw0MjOFp,26250,10/3/2019,26250,yw0MjOFp,78750,more than downpayment,more than downpayment,0,26250
yw0MjOFp,26250,11/5/2019,26250,yw0MjOFp,105000,more than downpayment,more than downpayment,0,26250
YW9YxEPr,8900,2/23/2019,8900,,8900,equal to downpayment,,8900,0
YW9YxEPr,3900,3/26/2019,8900,YW9YxEPr,12800,more than downpayment,equal to downpayment,0,3900
YW9YxEPr,3900,4/24/2019,8900,YW9YxEPr,16700,more than downpayment,more than downpayment,0,3900
YX47U2BO,9900,10/31/2019,9900,,9900,equal to downpayment,,9900,0
YX47U2BO,7800,11/12/2019,9900,YX47U2BO,17700,more than downpayment,equal to downpayment,0,7800
YX47U2BO,3900,1/30/2020,9900,YX47U2BO,21600,more than downpayment,more than downpayment,0,3900
YXT4EAO7,9900,9/18/2019,9900,,9900,equal to downpayment,,9900,0
YXT4EAO7,4000,11/15/2019,9900,YXT4EAO7,13900,more than downpayment,equal to downpayment,0,4000
YXT4EAO7,4000,12/17/2019,9900,YXT4EAO7,17900,more than downpayment,more than downpayment,0,4000
YXT4EAO7,3900,1/15/2020,9900,YXT4EAO7,21800,more than downpayment,more than downpayment,0,3900
Yy22hOcn,10000,11/14/2018,10000,,10000,equal to downpayment,,10000,0
Yy22hOcn,4500,1/7/2019,10000,Yy22hOcn,14500,more than downpayment,equal to downpayment,0,4500
Yy22hOcn,4500,2/5/2019,10000,Yy22hOcn,19000,more than downpayment,more than downpayment,0,4500
Yy22hOcn,4000,3/7/2019,10000,Yy22hOcn,23000,more than downpayment,more than downpayment,0,4000
Yy22hOcn,500,3/11/2019,10000,Yy22hOcn,23500,more than downpayment,more than downpayment,0,500
Yy22hOcn,4500,4/8/2019,10000,Yy22hOcn,28000,more than downpayment,more than downpayment,0,4500
Yy22hOcn,4500,5/8/2019,10000,Yy22hOcn,32500,more than downpayment,more than downpayment,0,4500
Yy22hOcn,4500,6/11/2019,10000,Yy22hOcn,37000,more than downpayment,more than downpayment,0,4500
Yy22hOcn,4500,7/11/2019,10000,Yy22hOcn,41500,more than downpayment,more than downpayment,0,4500
Yy22hOcn,4000,8/9/2019,10000,Yy22hOcn,45500,more than downpayment,more than downpayment,0,4000
Yy22hOcn,500,8/14/2019,10000,Yy22hOcn,46000,more than downpayment,more than downpayment,0,500
Yy22hOcn,4500,9/20/2019,10000,Yy22hOcn,50500,more than downpayment,more than downpayment,0,4500
Yy22hOcn,1500,10/19/2019,10000,Yy22hOcn,52000,more than downpayment,more than downpayment,0,1500
Yy22hOcn,1500,10/29/2019,10000,Yy22hOcn,53500,more than downpayment,more than downpayment,0,1500
Yy22hOcn,1500,11/5/2019,10000,Yy22hOcn,55000,more than downpayment,more than downpayment,0,1500
Yy22hOcn,1500,11/18/2019,10000,Yy22hOcn,56500,more than downpayment,more than downpayment,0,1500
Yy22hOcn,1000,12/1/2019,10000,Yy22hOcn,57500,more than downpayment,more than downpayment,0,1000
Yy22hOcn,2000,12/5/2019,10000,Yy22hOcn,59500,more than downpayment,more than downpayment,0,2000
Yy22hOcn,2000,1/10/2020,10000,Yy22hOcn,61500,more than downpayment,more than downpayment,0,2000
Yy22hOcn,2500,1/28/2020,10000,Yy22hOcn,64000,more than downpayment,more than downpayment,0,2500
yyxX7tlB,10000,12/25/2018,10000,,10000,equal to downpayment,,10000,0
yyxX7tlB,4500,2/7/2019,10000,yyxX7tlB,14500,more than downpayment,equal to downpayment,0,4500
yyxX7tlB,4500,3/22/2019,10000,yyxX7tlB,19000,more than downpayment,more than downpayment,0,4500
yyxX7tlB,4500,4/30/2019,10000,yyxX7tlB,23500,more than downpayment,more than downpayment,0,4500
yyxX7tlB,9000,6/14/2019,10000,yyxX7tlB,32500,more than downpayment,more than downpayment,0,9000
yyxX7tlB,4500,8/7/2019,10000,yyxX7tlB,37000,more than downpayment,more than downpayment,0,4500
yyxX7tlB,2500,8/30/2019,10000,yyxX7tlB,39500,more than downpayment,more than downpayment,0,2500
yyxX7tlB,3000,10/4/2019,10000,yyxX7tlB,42500,more than downpayment,more than downpayment,0,3000
yyxX7tlB,4500,10/13/2019,10000,yyxX7tlB,47000,more than downpayment,more than downpayment,0,4500
yyxX7tlB,3500,11/2/2019,10000,yyxX7tlB,50500,more than downpayment,more than downpayment,0,3500
yyxX7tlB,1000,11/8/2019,10000,yyxX7tlB,51500,more than downpayment,more than downpayment,0,1000
yyxX7tlB,4500,12/2/2019,10000,yyxX7tlB,56000,more than downpayment,more than downpayment,0,4500
yyxX7tlB,3500,12/31/2019,10000,yyxX7tlB,59500,more than downpayment,more than downpayment,0,3500
yz2hQquO,9900,8/8/2019,9900,,9900,equal to downpayment,,9900,0
yz2hQquO,3900,11/8/2019,9900,yz2hQquO,13800,more than downpayment,equal to downpayment,0,3900
yz2hQquO,3900,12/20/2019,9900,yz2hQquO,17700,more than downpayment,more than downpayment,0,3900
yz2hQquO,3900,2/3/2020,9900,yz2hQquO,21600,more than downpayment,more than downpayment,0,3900
YZMTVLSM,9900,12/30/2019,9900,,9900,equal to downpayment,,9900,0
Z1GM96JV,9900,1/5/2020,9900,,9900,equal to downpayment,,9900,0
z4dCBk23,8900,3/19/2019,8900,,8900,equal to downpayment,,8900,0
z4dCBk23,3900,4/26/2019,8900,z4dCBk23,12800,more than downpayment,equal to downpayment,0,3900
z4dCBk23,3900,5/25/2019,8900,z4dCBk23,16700,more than downpayment,more than downpayment,0,3900
z4dCBk23,3900,6/26/2019,8900,z4dCBk23,20600,more than downpayment,more than downpayment,0,3900
z4dCBk23,3900,7/24/2019,8900,z4dCBk23,24500,more than downpayment,more than downpayment,0,3900
z4dCBk23,3900,8/23/2019,8900,z4dCBk23,28400,more than downpayment,more than downpayment,0,3900
z4dCBk23,3900,9/27/2019,8900,z4dCBk23,32300,more than downpayment,more than downpayment,0,3900
z4dCBk23,3900,10/28/2019,8900,z4dCBk23,36200,more than downpayment,more than downpayment,0,3900
z4dCBk23,4900,11/14/2019,8900,z4dCBk23,41100,more than downpayment,more than downpayment,0,4900
z4dCBk23,3900,11/30/2019,8900,z4dCBk23,45000,more than downpayment,more than downpayment,0,3900
z4dCBk23,3900,12/22/2019,8900,z4dCBk23,48900,more than downpayment,more than downpayment,0,3900
z4dCBk23,3900,2/1/2020,8900,z4dCBk23,52800,more than downpayment,more than downpayment,0,3900
Z4KIGTRU,10000,7/19/2019,9900,,10000,more than downpayment,,9900,100
Z4KIGTRU,3900,9/10/2019,9900,Z4KIGTRU,13900,more than downpayment,more than downpayment,0,3900
Z4KIGTRU,3900,10/30/2019,9900,Z4KIGTRU,17800,more than downpayment,more than downpayment,0,3900
Z4KIGTRU,3900,12/3/2019,9900,Z4KIGTRU,21700,more than downpayment,more than downpayment,0,3900
Z4KIGTRU,3900,1/9/2020,9900,Z4KIGTRU,25600,more than downpayment,more than downpayment,0,3900
Z4pNLhPF,2000,6/27/2019,1999,,2000,more than downpayment,,1999,1
Z4pNLhPF,2000,8/4/2019,1999,Z4pNLhPF,4000,more than downpayment,more than downpayment,0,2000
Z4pNLhPF,2000,9/1/2019,1999,Z4pNLhPF,6000,more than downpayment,more than downpayment,0,2000
Z4pNLhPF,2000,10/5/2019,1999,Z4pNLhPF,8000,more than downpayment,more than downpayment,0,2000
Z4pNLhPF,2000,11/9/2019,1999,Z4pNLhPF,10000,more than downpayment,more than downpayment,0,2000
Z4pNLhPF,2000,12/10/2019,1999,Z4pNLhPF,12000,more than downpayment,more than downpayment,0,2000
Z4pNLhPF,2000,1/9/2020,1999,Z4pNLhPF,14000,more than downpayment,more than downpayment,0,2000
Z4pNLhPF,2000,2/8/2020,1999,Z4pNLhPF,16000,more than downpayment,more than downpayment,0,2000
Z4QuqQPY,10000,1/9/2018,10000,,10000,equal to downpayment,,10000,0
Z4QuqQPY,5000,3/4/2018,10000,Z4QuqQPY,15000,more than downpayment,equal to downpayment,0,5000
Z4QuqQPY,5000,4/5/2018,10000,Z4QuqQPY,20000,more than downpayment,more than downpayment,0,5000
Z4QuqQPY,5000,4/14/2018,10000,Z4QuqQPY,25000,more than downpayment,more than downpayment,0,5000
Z4QuqQPY,5000,5/14/2018,10000,Z4QuqQPY,30000,more than downpayment,more than downpayment,0,5000
Z4QuqQPY,5000,6/10/2018,10000,Z4QuqQPY,35000,more than downpayment,more than downpayment,0,5000
Z4QuqQPY,5000,7/15/2018,10000,Z4QuqQPY,40000,more than downpayment,more than downpayment,0,5000
Z4QuqQPY,5000,8/15/2018,10000,Z4QuqQPY,45000,more than downpayment,more than downpayment,0,5000
Z4QuqQPY,5000,8/20/2018,10000,Z4QuqQPY,50000,more than downpayment,more than downpayment,0,5000
Z4QuqQPY,10000,9/14/2018,10000,Z4QuqQPY,60000,more than downpayment,more than downpayment,0,10000
Z4QuqQPY,4000,10/14/2018,10000,Z4QuqQPY,64000,more than downpayment,more than downpayment,0,4000
Z51YTRgV,8900,4/9/2019,8900,,8900,equal to downpayment,,8900,0
Z51YTRgV,4000,5/25/2019,8900,Z51YTRgV,12900,more than downpayment,equal to downpayment,0,4000
Z51YTRgV,3900,6/21/2019,8900,Z51YTRgV,16800,more than downpayment,more than downpayment,0,3900
Z51YTRgV,3900,7/26/2019,8900,Z51YTRgV,20700,more than downpayment,more than downpayment,0,3900
Z51YTRgV,3900,8/31/2019,8900,Z51YTRgV,24600,more than downpayment,more than downpayment,0,3900
Z51YTRgV,3900,10/1/2019,8900,Z51YTRgV,28500,more than downpayment,more than downpayment,0,3900
Z51YTRgV,3900,10/23/2019,8900,Z51YTRgV,32400,more than downpayment,more than downpayment,0,3900
Z51YTRgV,2500,11/25/2019,8900,Z51YTRgV,34900,more than downpayment,more than downpayment,0,2500
Z51YTRgV,1400,11/26/2019,8900,Z51YTRgV,36300,more than downpayment,more than downpayment,0,1400
Z51YTRgV,6100,1/16/2020,8900,Z51YTRgV,42400,more than downpayment,more than downpayment,0,6100
Z51YTRgV,5000,1/28/2020,8900,Z51YTRgV,47400,more than downpayment,more than downpayment,0,5000
Z5MYP366,8900,5/29/2019,8900,,8900,equal to downpayment,,8900,0
Z5MYP366,3900,7/15/2019,8900,Z5MYP366,12800,more than downpayment,equal to downpayment,0,3900
Z5MYP366,3900,8/15/2019,8900,Z5MYP366,16700,more than downpayment,more than downpayment,0,3900
Z5MYP366,3900,9/12/2019,8900,Z5MYP366,20600,more than downpayment,more than downpayment,0,3900
Z5MYP366,3900,10/14/2019,8900,Z5MYP366,24500,more than downpayment,more than downpayment,0,3900
Z5MYP366,2040,10/30/2019,8900,Z5MYP366,26540,more than downpayment,more than downpayment,0,2040
Z5MYP366,3900,11/13/2019,8900,Z5MYP366,30440,more than downpayment,more than downpayment,0,3900
Z5MYP366,3900,12/15/2019,8900,Z5MYP366,34340,more than downpayment,more than downpayment,0,3900
Z5MYP366,3900,1/11/2020,8900,Z5MYP366,38240,more than downpayment,more than downpayment,0,3900
Z5NrCd5Y,18000,5/2/2019,8900,,18000,more than downpayment,,8900,9100
Z5NrCd5Y,4000,7/8/2019,8900,Z5NrCd5Y,22000,more than downpayment,more than downpayment,0,4000
Z5NrCd5Y,4000,8/5/2019,8900,Z5NrCd5Y,26000,more than downpayment,more than downpayment,0,4000
Z5NrCd5Y,4000,10/10/2019,8900,Z5NrCd5Y,30000,more than downpayment,more than downpayment,0,4000
Z5NrCd5Y,4000,12/5/2019,8900,Z5NrCd5Y,34000,more than downpayment,more than downpayment,0,4000
Z5NrCd5Y,2200,1/20/2020,8900,Z5NrCd5Y,36200,more than downpayment,more than downpayment,0,2200
Z5NrCd5Y,3900,1/28/2020,8900,Z5NrCd5Y,40100,more than downpayment,more than downpayment,0,3900
Z5RlOXmI,9900,8/8/2019,9900,,9900,equal to downpayment,,9900,0
Z5RlOXmI,4000,8/29/2019,9900,Z5RlOXmI,13900,more than downpayment,equal to downpayment,0,4000
Z5RlOXmI,4000,9/23/2019,9900,Z5RlOXmI,17900,more than downpayment,more than downpayment,0,4000
Z5RlOXmI,4000,10/17/2019,9900,Z5RlOXmI,21900,more than downpayment,more than downpayment,0,4000
Z5RlOXmI,4000,11/29/2019,9900,Z5RlOXmI,25900,more than downpayment,more than downpayment,0,4000
Z5RlOXmI,4000,1/11/2020,9900,Z5RlOXmI,29900,more than downpayment,more than downpayment,0,4000
Z5RlOXmI,3000,2/3/2020,9900,Z5RlOXmI,32900,more than downpayment,more than downpayment,0,3000
Z64HC7NB,9900,1/4/2020,9900,,9900,equal to downpayment,,9900,0
Z6K383W6,9900,11/30/2019,9900,,9900,equal to downpayment,,9900,0
Z6Q9EXP1,9900,1/18/2020,9900,,9900,equal to downpayment,,9900,0
Z8HONVDW,9900,10/17/2019,9900,,9900,equal to downpayment,,9900,0
Z8HONVDW,3900,12/11/2019,9900,Z8HONVDW,13800,more than downpayment,equal to downpayment,0,3900
Z9H2XZJC,1600,10/14/2019,1594,,1600,more than downpayment,,1594,6
z9hKhoeR,8900,11/29/2018,8900,,8900,equal to downpayment,,8900,0
z9hKhoeR,4000,1/3/2019,8900,z9hKhoeR,12900,more than downpayment,equal to downpayment,0,4000
z9hKhoeR,4000,2/6/2019,8900,z9hKhoeR,16900,more than downpayment,more than downpayment,0,4000
z9hKhoeR,4000,3/4/2019,8900,z9hKhoeR,20900,more than downpayment,more than downpayment,0,4000
z9hKhoeR,4000,4/1/2019,8900,z9hKhoeR,24900,more than downpayment,more than downpayment,0,4000
z9hKhoeR,4000,5/6/2019,8900,z9hKhoeR,28900,more than downpayment,more than downpayment,0,4000
z9hKhoeR,4000,6/6/2019,8900,z9hKhoeR,32900,more than downpayment,more than downpayment,0,4000
z9hKhoeR,3900,7/5/2019,8900,z9hKhoeR,36800,more than downpayment,more than downpayment,0,3900
z9hKhoeR,3900,8/6/2019,8900,z9hKhoeR,40700,more than downpayment,more than downpayment,0,3900
z9hKhoeR,3900,9/6/2019,8900,z9hKhoeR,44600,more than downpayment,more than downpayment,0,3900
z9hKhoeR,3900,10/4/2019,8900,z9hKhoeR,48500,more than downpayment,more than downpayment,0,3900
z9hKhoeR,3900,11/5/2019,8900,z9hKhoeR,52400,more than downpayment,more than downpayment,0,3900
z9hKhoeR,50,12/4/2019,8900,z9hKhoeR,52450,more than downpayment,more than downpayment,0,50
z9hKhoeR,3900,12/5/2019,8900,z9hKhoeR,56350,more than downpayment,more than downpayment,0,3900
z9hKhoeR,3900,1/16/2020,8900,z9hKhoeR,60250,more than downpayment,more than downpayment,0,3900
z9hKhoeR,3000,2/7/2020,8900,z9hKhoeR,63250,more than downpayment,more than downpayment,0,3000
ZADOPGH2,10000,10/4/2019,9900,,10000,more than downpayment,,9900,100
ZADOPGH2,4000,12/4/2019,9900,ZADOPGH2,14000,more than downpayment,more than downpayment,0,4000
ZADOPGH2,4000,1/3/2020,9900,ZADOPGH2,18000,more than downpayment,more than downpayment,0,4000
ZADOPGH2,4000,2/5/2020,9900,ZADOPGH2,22000,more than downpayment,more than downpayment,0,4000
ZB7X5D9Q,4999,1/3/2020,8900,,4999,less than downpayment,,4999,0
ZB7X5D9Q,4000,1/17/2020,8900,ZB7X5D9Q,8999,more than downpayment,less than downpayment,3901,99
ZBK1I6OD,9900,1/27/2020,9900,,9900,equal to downpayment,,9900,0
ZboYJED1,8900,10/10/2019,8900,,8900,equal to downpayment,,8900,0
ZboYJED1,3900,12/4/2019,8900,ZboYJED1,12800,more than downpayment,equal to downpayment,0,3900
ZboYJED1,3900,1/3/2020,8900,ZboYJED1,16700,more than downpayment,more than downpayment,0,3900
ZboYJED1,3900,2/5/2020,8900,ZboYJED1,20600,more than downpayment,more than downpayment,0,3900
ZBU0Ng45,10000,8/11/2017,10000,,10000,equal to downpayment,,10000,0
ZBU0Ng45,3500,10/2/2017,10000,ZBU0Ng45,13500,more than downpayment,equal to downpayment,0,3500
ZBU0Ng45,3500,11/1/2017,10000,ZBU0Ng45,17000,more than downpayment,more than downpayment,0,3500
ZBU0Ng45,3500,12/1/2017,10000,ZBU0Ng45,20500,more than downpayment,more than downpayment,0,3500
ZBU0Ng45,3500,1/2/2018,10000,ZBU0Ng45,24000,more than downpayment,more than downpayment,0,3500
ZBU0Ng45,3500,2/1/2018,10000,ZBU0Ng45,27500,more than downpayment,more than downpayment,0,3500
ZBU0Ng45,3500,3/4/2018,10000,ZBU0Ng45,31000,more than downpayment,more than downpayment,0,3500
ZBU0Ng45,3500,4/1/2018,10000,ZBU0Ng45,34500,more than downpayment,more than downpayment,0,3500
ZBU0Ng45,3500,5/1/2018,10000,ZBU0Ng45,38000,more than downpayment,more than downpayment,0,3500
ZBU0Ng45,3500,6/1/2018,10000,ZBU0Ng45,41500,more than downpayment,more than downpayment,0,3500
ZBU0Ng45,3500,7/2/2018,10000,ZBU0Ng45,45000,more than downpayment,more than downpayment,0,3500
ZBU0Ng45,3500,8/1/2018,10000,ZBU0Ng45,48500,more than downpayment,more than downpayment,0,3500
ZBU0Ng45,3500,9/2/2018,10000,ZBU0Ng45,52000,more than downpayment,more than downpayment,0,3500
ZC3DYE9R,8900,11/18/2019,8900,,8900,equal to downpayment,,8900,0
ZC3DYE9R,11700,1/24/2020,8900,ZC3DYE9R,20600,more than downpayment,equal to downpayment,0,11700
ZCOBG4RA,9900,11/29/2019,9900,,9900,equal to downpayment,,9900,0
ZCUQXFO3,9900,6/10/2019,8900,,9900,more than downpayment,,8900,1000
ZCUQXFO3,3900,7/9/2019,8900,ZCUQXFO3,13800,more than downpayment,more than downpayment,0,3900
ZCUQXFO3,3900,8/14/2019,8900,ZCUQXFO3,17700,more than downpayment,more than downpayment,0,3900
ZCUQXFO3,3900,9/13/2019,8900,ZCUQXFO3,21600,more than downpayment,more than downpayment,0,3900
ZCUQXFO3,3900,10/17/2019,8900,ZCUQXFO3,25500,more than downpayment,more than downpayment,0,3900
ZCUQXFO3,3900,11/19/2019,8900,ZCUQXFO3,29400,more than downpayment,more than downpayment,0,3900
ZCUQXFO3,3900,12/23/2019,8900,ZCUQXFO3,33300,more than downpayment,more than downpayment,0,3900
ZCUQXFO3,3900,1/28/2020,8900,ZCUQXFO3,37200,more than downpayment,more than downpayment,0,3900
ZCZLZ7A3,9900,1/28/2020,9900,,9900,equal to downpayment,,9900,0
zd0Nvqw3,9900,7/10/2019,9900,,9900,equal to downpayment,,9900,0
zDEHa3aj,10000,7/13/2018,10000,,10000,equal to downpayment,,10000,0
zDEHa3aj,4500,8/27/2018,10000,zDEHa3aj,14500,more than downpayment,equal to downpayment,0,4500
zDEHa3aj,4500,9/28/2018,10000,zDEHa3aj,19000,more than downpayment,more than downpayment,0,4500
zDEHa3aj,4500,10/24/2018,10000,zDEHa3aj,23500,more than downpayment,more than downpayment,0,4500
zDEHa3aj,4500,11/28/2018,10000,zDEHa3aj,28000,more than downpayment,more than downpayment,0,4500
zDEHa3aj,4500,1/3/2019,10000,zDEHa3aj,32500,more than downpayment,more than downpayment,0,4500
zDEHa3aj,9000,1/21/2019,10000,zDEHa3aj,41500,more than downpayment,more than downpayment,0,9000
zDEHa3aj,4500,3/26/2019,10000,zDEHa3aj,46000,more than downpayment,more than downpayment,0,4500
zDEHa3aj,4500,4/29/2019,10000,zDEHa3aj,50500,more than downpayment,more than downpayment,0,4500
zDEHa3aj,4500,5/30/2019,10000,zDEHa3aj,55000,more than downpayment,more than downpayment,0,4500
zDEHa3aj,4500,6/28/2019,10000,zDEHa3aj,59500,more than downpayment,more than downpayment,0,4500
zDEHa3aj,4500,7/29/2019,10000,zDEHa3aj,64000,more than downpayment,more than downpayment,0,4500
ZDWSYH42,9900,11/13/2019,9900,,9900,equal to downpayment,,9900,0
ZDWSYH42,3900,12/26/2019,9900,ZDWSYH42,13800,more than downpayment,equal to downpayment,0,3900
ZDZ5IYAG,8900,7/31/2019,8900,,8900,equal to downpayment,,8900,0
ZDZ5IYAG,3900,11/12/2019,8900,ZDZ5IYAG,12800,more than downpayment,equal to downpayment,0,3900
ZDZ5IYAG,7800,12/16/2019,8900,ZDZ5IYAG,20600,more than downpayment,more than downpayment,0,7800
ZDZ5IYAG,3900,1/7/2020,8900,ZDZ5IYAG,24500,more than downpayment,more than downpayment,0,3900
ZDZIOZ7O,9900,1/25/2020,9900,,9900,equal to downpayment,,9900,0
zEu2QXnF,8900,10/2/2019,8900,,8900,equal to downpayment,,8900,0
zEu2QXnF,4000,11/15/2019,8900,zEu2QXnF,12900,more than downpayment,equal to downpayment,0,4000
zEu2QXnF,3900,12/16/2019,8900,zEu2QXnF,16800,more than downpayment,more than downpayment,0,3900
zEu2QXnF,3900,1/24/2020,8900,zEu2QXnF,20700,more than downpayment,more than downpayment,0,3900
ZfOxKfyB,10000,9/12/2018,10000,,10000,equal to downpayment,,10000,0
ZfOxKfyB,4500,10/15/2018,10000,ZfOxKfyB,14500,more than downpayment,equal to downpayment,0,4500
ZfOxKfyB,4200,11/14/2018,10000,ZfOxKfyB,18700,more than downpayment,more than downpayment,0,4200
ZfOxKfyB,4800,12/12/2018,10000,ZfOxKfyB,23500,more than downpayment,more than downpayment,0,4800
ZfOxKfyB,4500,1/14/2019,10000,ZfOxKfyB,28000,more than downpayment,more than downpayment,0,4500
ZfOxKfyB,4500,2/11/2019,10000,ZfOxKfyB,32500,more than downpayment,more than downpayment,0,4500
ZfOxKfyB,4500,3/26/2019,10000,ZfOxKfyB,37000,more than downpayment,more than downpayment,0,4500
ZfOxKfyB,4500,5/14/2019,10000,ZfOxKfyB,41500,more than downpayment,more than downpayment,0,4500
zIZjlDec,18000,3/27/2019,8900,,18000,more than downpayment,,8900,9100
zIZjlDec,6600,6/6/2019,8900,zIZjlDec,24600,more than downpayment,more than downpayment,0,6600
zIZjlDec,3900,9/5/2019,8900,zIZjlDec,28500,more than downpayment,more than downpayment,0,3900
zIZjlDec,3900,10/2/2019,8900,zIZjlDec,32400,more than downpayment,more than downpayment,0,3900
zIZjlDec,3900,11/6/2019,8900,zIZjlDec,36300,more than downpayment,more than downpayment,0,3900
zIZjlDec,3900,12/3/2019,8900,zIZjlDec,40200,more than downpayment,more than downpayment,0,3900
zIZjlDec,3900,12/21/2019,8900,zIZjlDec,44100,more than downpayment,more than downpayment,0,3900
zIZjlDec,3900,1/29/2020,8900,zIZjlDec,48000,more than downpayment,more than downpayment,0,3900
zJNvUhKw,11250,8/30/2017,10000,,11250,more than downpayment,,10000,1250
zJNvUhKw,1150,2/19/2018,10000,zJNvUhKw,12400,more than downpayment,more than downpayment,0,1150
zJNvUhKw,700,5/2/2018,10000,zJNvUhKw,13100,more than downpayment,more than downpayment,0,700
zJNvUhKw,950,7/2/2018,10000,zJNvUhKw,14050,more than downpayment,more than downpayment,0,950
zJNvUhKw,500,8/1/2018,10000,zJNvUhKw,14550,more than downpayment,more than downpayment,0,500
zJNvUhKw,500,9/12/2018,10000,zJNvUhKw,15050,more than downpayment,more than downpayment,0,500
zJNvUhKw,900,11/14/2018,10000,zJNvUhKw,15950,more than downpayment,more than downpayment,0,900
zJNvUhKw,2000,3/6/2019,10000,zJNvUhKw,17950,more than downpayment,more than downpayment,0,2000
zJNvUhKw,700,10/5/2019,10000,zJNvUhKw,18650,more than downpayment,more than downpayment,0,700
zJNvUhKw,270,11/25/2019,10000,zJNvUhKw,18920,more than downpayment,more than downpayment,0,270
zJNvUhKw,544,11/30/2019,10000,zJNvUhKw,19464,more than downpayment,more than downpayment,0,544
zJNvUhKw,544,12/18/2019,10000,zJNvUhKw,20008,more than downpayment,more than downpayment,0,544
zJRszf98,8900,3/7/2019,8900,,8900,equal to downpayment,,8900,0
zJRszf98,3900,6/4/2019,8900,zJRszf98,12800,more than downpayment,equal to downpayment,0,3900
zJRszf98,7800,7/9/2019,8900,zJRszf98,20600,more than downpayment,more than downpayment,0,7800
zJRszf98,3900,8/29/2019,8900,zJRszf98,24500,more than downpayment,more than downpayment,0,3900
zJRszf98,7800,10/28/2019,8900,zJRszf98,32300,more than downpayment,more than downpayment,0,7800
zJRszf98,7800,12/5/2019,8900,zJRszf98,40100,more than downpayment,more than downpayment,0,7800
zJRszf98,3900,1/26/2020,8900,zJRszf98,44000,more than downpayment,more than downpayment,0,3900
ZK6CmkS6,8900,1/23/2019,8900,,8900,equal to downpayment,,8900,0
ZK6CmkS6,3900,2/25/2019,8900,ZK6CmkS6,12800,more than downpayment,equal to downpayment,0,3900
ZK6CmkS6,3900,3/25/2019,8900,ZK6CmkS6,16700,more than downpayment,more than downpayment,0,3900
ZK6CmkS6,3900,4/25/2019,8900,ZK6CmkS6,20600,more than downpayment,more than downpayment,0,3900
ZK6CmkS6,3900,5/25/2019,8900,ZK6CmkS6,24500,more than downpayment,more than downpayment,0,3900
ZK6CmkS6,3900,7/4/2019,8900,ZK6CmkS6,28400,more than downpayment,more than downpayment,0,3900
ZK6CmkS6,4000,8/12/2019,8900,ZK6CmkS6,32400,more than downpayment,more than downpayment,0,4000
ZK6CmkS6,3900,8/27/2019,8900,ZK6CmkS6,36300,more than downpayment,more than downpayment,0,3900
ZK6CmkS6,6000,9/26/2019,8900,ZK6CmkS6,42300,more than downpayment,more than downpayment,0,6000
ZK6CmkS6,800,10/12/2019,8900,ZK6CmkS6,43100,more than downpayment,more than downpayment,0,800
ZK6CmkS6,3900,10/31/2019,8900,ZK6CmkS6,47000,more than downpayment,more than downpayment,0,3900
ZK6CmkS6,3900,12/4/2019,8900,ZK6CmkS6,50900,more than downpayment,more than downpayment,0,3900
ZK6CmkS6,3900,1/14/2020,8900,ZK6CmkS6,54800,more than downpayment,more than downpayment,0,3900
ZK6CmkS6,3900,1/31/2020,8900,ZK6CmkS6,58700,more than downpayment,more than downpayment,0,3900
ZkhAz2WM,9900,2/12/2019,9900,,9900,equal to downpayment,,9900,0
ZkhAz2WM,4500,3/12/2019,9900,ZkhAz2WM,14400,more than downpayment,equal to downpayment,0,4500
ZkhAz2WM,4500,4/11/2019,9900,ZkhAz2WM,18900,more than downpayment,more than downpayment,0,4500
ZkhAz2WM,4500,5/13/2019,9900,ZkhAz2WM,23400,more than downpayment,more than downpayment,0,4500
ZkhAz2WM,4500,6/14/2019,9900,ZkhAz2WM,27900,more than downpayment,more than downpayment,0,4500
ZkhAz2WM,4500,7/13/2019,9900,ZkhAz2WM,32400,more than downpayment,more than downpayment,0,4500
ZkhAz2WM,4500,8/15/2019,9900,ZkhAz2WM,36900,more than downpayment,more than downpayment,0,4500
ZkhAz2WM,4500,9/17/2019,9900,ZkhAz2WM,41400,more than downpayment,more than downpayment,0,4500
ZkhAz2WM,4500,10/15/2019,9900,ZkhAz2WM,45900,more than downpayment,more than downpayment,0,4500
ZkhAz2WM,4500,11/18/2019,9900,ZkhAz2WM,50400,more than downpayment,more than downpayment,0,4500
ZkhAz2WM,4500,12/15/2019,9900,ZkhAz2WM,54900,more than downpayment,more than downpayment,0,4500
ZkhAz2WM,4500,1/14/2020,9900,ZkhAz2WM,59400,more than downpayment,more than downpayment,0,4500
ZLGGX9AG,9900,9/21/2019,9900,,9900,equal to downpayment,,9900,0
ZLGGX9AG,3900,11/12/2019,9900,ZLGGX9AG,13800,more than downpayment,equal to downpayment,0,3900
ZLGGX9AG,3900,12/13/2019,9900,ZLGGX9AG,17700,more than downpayment,more than downpayment,0,3900
ZLGGX9AG,3900,1/7/2020,9900,ZLGGX9AG,21600,more than downpayment,more than downpayment,0,3900
ZLxUXEg9,10000,6/15/2017,10000,,10000,equal to downpayment,,10000,0
ZLxUXEg9,3500,7/15/2017,10000,ZLxUXEg9,13500,more than downpayment,equal to downpayment,0,3500
ZLxUXEg9,3500,9/8/2017,10000,ZLxUXEg9,17000,more than downpayment,more than downpayment,0,3500
ZLxUXEg9,3500,9/25/2017,10000,ZLxUXEg9,20500,more than downpayment,more than downpayment,0,3500
ZLxUXEg9,25000,11/25/2017,10000,ZLxUXEg9,45500,more than downpayment,more than downpayment,0,25000
zm8aYqjy,9900,7/2/2019,9900,,9900,equal to downpayment,,9900,0
zm8aYqjy,500,7/17/2019,9900,zm8aYqjy,10400,more than downpayment,equal to downpayment,0,500
zm8aYqjy,1000,8/12/2019,9900,zm8aYqjy,11400,more than downpayment,more than downpayment,0,1000
zm8aYqjy,1000,8/21/2019,9900,zm8aYqjy,12400,more than downpayment,more than downpayment,0,1000
zm8aYqjy,500,8/22/2019,9900,zm8aYqjy,12900,more than downpayment,more than downpayment,0,500
zm8aYqjy,900,8/23/2019,9900,zm8aYqjy,13800,more than downpayment,more than downpayment,0,900
zm8aYqjy,1500,9/20/2019,9900,zm8aYqjy,15300,more than downpayment,more than downpayment,0,1500
zm8aYqjy,2400,9/25/2019,9900,zm8aYqjy,17700,more than downpayment,more than downpayment,0,2400
zm8aYqjy,1900,11/5/2019,9900,zm8aYqjy,19600,more than downpayment,more than downpayment,0,1900
zm8aYqjy,500,11/17/2019,9900,zm8aYqjy,20100,more than downpayment,more than downpayment,0,500
zm8aYqjy,1500,11/20/2019,9900,zm8aYqjy,21600,more than downpayment,more than downpayment,0,1500
zm8aYqjy,3900,12/2/2019,9900,zm8aYqjy,25500,more than downpayment,more than downpayment,0,3900
zm8aYqjy,1000,1/4/2020,9900,zm8aYqjy,26500,more than downpayment,more than downpayment,0,1000
zm8aYqjy,2900,1/8/2020,9900,zm8aYqjy,29400,more than downpayment,more than downpayment,0,2900
zm8aYqjy,500,2/3/2020,9900,zm8aYqjy,29900,more than downpayment,more than downpayment,0,500
zm8aYqjy,1000,2/6/2020,9900,zm8aYqjy,30900,more than downpayment,more than downpayment,0,1000
ZMPwaeh7,8900,3/7/2019,8900,,8900,equal to downpayment,,8900,0
ZMPwaeh7,11700,4/1/2019,8900,ZMPwaeh7,20600,more than downpayment,equal to downpayment,0,11700
ZMPwaeh7,3900,7/5/2019,8900,ZMPwaeh7,24500,more than downpayment,more than downpayment,0,3900
ZMPwaeh7,3900,8/6/2019,8900,ZMPwaeh7,28400,more than downpayment,more than downpayment,0,3900
ZMPwaeh7,3900,9/6/2019,8900,ZMPwaeh7,32300,more than downpayment,more than downpayment,0,3900
ZMPwaeh7,3900,10/7/2019,8900,ZMPwaeh7,36200,more than downpayment,more than downpayment,0,3900
ZMPwaeh7,6500,12/2/2019,8900,ZMPwaeh7,42700,more than downpayment,more than downpayment,0,6500
ZMPwaeh7,9200,1/30/2020,8900,ZMPwaeh7,51900,more than downpayment,more than downpayment,0,9200
zNmgywcY,8900,7/5/2019,8900,,8900,equal to downpayment,,8900,0
zNmgywcY,3900,8/4/2019,8900,zNmgywcY,12800,more than downpayment,equal to downpayment,0,3900
zNmgywcY,3900,9/5/2019,8900,zNmgywcY,16700,more than downpayment,more than downpayment,0,3900
zNmgywcY,3900,10/5/2019,8900,zNmgywcY,20600,more than downpayment,more than downpayment,0,3900
zNmgywcY,3900,11/4/2019,8900,zNmgywcY,24500,more than downpayment,more than downpayment,0,3900
zNmgywcY,3900,12/4/2019,8900,zNmgywcY,28400,more than downpayment,more than downpayment,0,3900
zNmgywcY,3900,1/5/2020,8900,zNmgywcY,32300,more than downpayment,more than downpayment,0,3900
zNmgywcY,3900,2/5/2020,8900,zNmgywcY,36200,more than downpayment,more than downpayment,0,3900
Zo1qbCqo,19500,3/8/2019,8900,,19500,more than downpayment,,8900,10600
Zo1qbCqo,7000,4/5/2019,8900,Zo1qbCqo,26500,more than downpayment,more than downpayment,0,7000
Zo1qbCqo,18000,7/2/2019,8900,Zo1qbCqo,44500,more than downpayment,more than downpayment,0,18000
Zo1qbCqo,15000,8/5/2019,8900,Zo1qbCqo,59500,more than downpayment,more than downpayment,0,15000
ZOG4Y6RB,9900,11/14/2019,9900,,9900,equal to downpayment,,9900,0
ZOG4Y6RB,3900,1/21/2020,9900,ZOG4Y6RB,13800,more than downpayment,equal to downpayment,0,3900
zPhJg0rf,9900,7/10/2019,9900,,9900,equal to downpayment,,9900,0
zPhJg0rf,7106,7/13/2019,9900,zPhJg0rf,17006,more than downpayment,equal to downpayment,0,7106
zPhJg0rf,3900,8/23/2019,9900,zPhJg0rf,20906,more than downpayment,more than downpayment,0,3900
zPhJg0rf,3900,9/21/2019,9900,zPhJg0rf,24806,more than downpayment,more than downpayment,0,3900
zPhJg0rf,3900,10/24/2019,9900,zPhJg0rf,28706,more than downpayment,more than downpayment,0,3900
zPhJg0rf,3900,11/26/2019,9900,zPhJg0rf,32606,more than downpayment,more than downpayment,0,3900
zPhJg0rf,3900,12/26/2019,9900,zPhJg0rf,36506,more than downpayment,more than downpayment,0,3900
zPhJg0rf,1,12/28/2019,9900,zPhJg0rf,36507,more than downpayment,more than downpayment,0,1
zPhJg0rf,3,1/11/2020,9900,zPhJg0rf,36510,more than downpayment,more than downpayment,0,3
zPhJg0rf,3900,1/20/2020,9900,zPhJg0rf,40410,more than downpayment,more than downpayment,0,3900
ZQ3X9SQL,8900,1/10/2020,8900,,8900,equal to downpayment,,8900,0
ZQ99GXZS,9900,11/21/2019,9900,,9900,equal to downpayment,,9900,0
ZQ99GXZS,3900,2/4/2020,9900,ZQ99GXZS,13800,more than downpayment,equal to downpayment,0,3900
ZQDR6REQ,9900,10/25/2019,9900,,9900,equal to downpayment,,9900,0
ZQDR6REQ,4000,12/4/2019,9900,ZQDR6REQ,13900,more than downpayment,equal to downpayment,0,4000
ZQDR6REQ,4000,1/24/2020,9900,ZQDR6REQ,17900,more than downpayment,more than downpayment,0,4000
ZQDR6REQ,1000,2/7/2020,9900,ZQDR6REQ,18900,more than downpayment,more than downpayment,0,1000
ZQGLESWM,9900,10/11/2019,9900,,9900,equal to downpayment,,9900,0
ZQGLESWM,3900,12/7/2019,9900,ZQGLESWM,13800,more than downpayment,equal to downpayment,0,3900
ZQGLESWM,500,1/13/2020,9900,ZQGLESWM,14300,more than downpayment,more than downpayment,0,500
ZQGLESWM,200,1/14/2020,9900,ZQGLESWM,14500,more than downpayment,more than downpayment,0,200
ZQGLESWM,3200,1/15/2020,9900,ZQGLESWM,17700,more than downpayment,more than downpayment,0,3200
ZQGLESWM,200,1/16/2020,9900,ZQGLESWM,17900,more than downpayment,more than downpayment,0,200
ZQGLESWM,200,1/21/2020,9900,ZQGLESWM,18100,more than downpayment,more than downpayment,0,200
ZQGLESWM,200,1/22/2020,9900,ZQGLESWM,18300,more than downpayment,more than downpayment,0,200
ZQGLESWM,250,1/27/2020,9900,ZQGLESWM,18550,more than downpayment,more than downpayment,0,250
ZQGLESWM,250,2/1/2020,9900,ZQGLESWM,18800,more than downpayment,more than downpayment,0,250
zQnIng57,8900,4/12/2019,8900,,8900,equal to downpayment,,8900,0
zQnIng57,4200,6/3/2019,8900,zQnIng57,13100,more than downpayment,equal to downpayment,0,4200
zQnIng57,200,6/4/2019,8900,zQnIng57,13300,more than downpayment,more than downpayment,0,200
zQnIng57,600,6/6/2019,8900,zQnIng57,13900,more than downpayment,more than downpayment,0,600
zQnIng57,130,6/7/2019,8900,zQnIng57,14030,more than downpayment,more than downpayment,0,130
zQnIng57,170,6/11/2019,8900,zQnIng57,14200,more than downpayment,more than downpayment,0,170
zQnIng57,400,6/12/2019,8900,zQnIng57,14600,more than downpayment,more than downpayment,0,400
zQnIng57,200,6/13/2019,8900,zQnIng57,14800,more than downpayment,more than downpayment,0,200
zQnIng57,200,6/14/2019,8900,zQnIng57,15000,more than downpayment,more than downpayment,0,200
zQnIng57,1700,6/29/2019,8900,zQnIng57,16700,more than downpayment,more than downpayment,0,1700
zQnIng57,1900,7/27/2019,8900,zQnIng57,18600,more than downpayment,more than downpayment,0,1900
zQnIng57,400,7/28/2019,8900,zQnIng57,19000,more than downpayment,more than downpayment,0,400
zQnIng57,400,7/30/2019,8900,zQnIng57,19400,more than downpayment,more than downpayment,0,400
zQnIng57,1200,8/16/2019,8900,zQnIng57,20600,more than downpayment,more than downpayment,0,1200
zQnIng57,4900,8/28/2019,8900,zQnIng57,25500,more than downpayment,more than downpayment,0,4900
zQnIng57,200,8/29/2019,8900,zQnIng57,25700,more than downpayment,more than downpayment,0,200
zQnIng57,10,9/4/2019,8900,zQnIng57,25710,more than downpayment,more than downpayment,0,10
zQnIng57,2690,10/4/2019,8900,zQnIng57,28400,more than downpayment,more than downpayment,0,2690
zQnIng57,200,10/26/2019,8900,zQnIng57,28600,more than downpayment,more than downpayment,0,200
zQnIng57,700,10/28/2019,8900,zQnIng57,29300,more than downpayment,more than downpayment,0,700
zQnIng57,3000,11/20/2019,8900,zQnIng57,32300,more than downpayment,more than downpayment,0,3000
zQnIng57,7800,12/28/2019,8900,zQnIng57,40100,more than downpayment,more than downpayment,0,7800
zQnIng57,8800,1/27/2020,8900,zQnIng57,48900,more than downpayment,more than downpayment,0,8800
ZQXL13Z5,9900,1/17/2020,9900,,9900,equal to downpayment,,9900,0
ZQXS9OYV,9900,12/15/2019,9900,,9900,equal to downpayment,,9900,0
ZQXS9OYV,4000,1/25/2020,9900,ZQXS9OYV,13900,more than downpayment,equal to downpayment,0,4000
zrv0duSx,9900,6/20/2019,24400,,9900,less than downpayment,,9900,0
zrv0duSx,14600,7/2/2019,24400,zrv0duSx,24500,more than downpayment,less than downpayment,14500,100
zrv0duSx,7300,8/2/2019,24400,zrv0duSx,31800,more than downpayment,more than downpayment,0,7300
zrv0duSx,7300,9/3/2019,24400,zrv0duSx,39100,more than downpayment,more than downpayment,0,7300
zrv0duSx,7300,10/5/2019,24400,zrv0duSx,46400,more than downpayment,more than downpayment,0,7300
zrv0duSx,7300,11/5/2019,24400,zrv0duSx,53700,more than downpayment,more than downpayment,0,7300
zrv0duSx,7300,12/8/2019,24400,zrv0duSx,61000,more than downpayment,more than downpayment,0,7300
zrv0duSx,7300,1/9/2020,24400,zrv0duSx,68300,more than downpayment,more than downpayment,0,7300
zrv0duSx,7300,2/5/2020,24400,zrv0duSx,75600,more than downpayment,more than downpayment,0,7300
ZRWUPGRV,9900,2/6/2020,9900,,9900,equal to downpayment,,9900,0
ZSUtPunJ,8900,8/21/2019,8900,,8900,equal to downpayment,,8900,0
ZSUtPunJ,3900,10/23/2019,8900,ZSUtPunJ,12800,more than downpayment,equal to downpayment,0,3900
ZSUtPunJ,3900,11/27/2019,8900,ZSUtPunJ,16700,more than downpayment,more than downpayment,0,3900
ZSUtPunJ,3500,12/25/2019,8900,ZSUtPunJ,20200,more than downpayment,more than downpayment,0,3500
ZSUtPunJ,3900,1/24/2020,8900,ZSUtPunJ,24100,more than downpayment,more than downpayment,0,3900
zuI4NRup,8900,9/4/2019,8900,,8900,equal to downpayment,,8900,0
zuI4NRup,3900,10/8/2019,8900,zuI4NRup,12800,more than downpayment,equal to downpayment,0,3900
zuI4NRup,4000,11/21/2019,8900,zuI4NRup,16800,more than downpayment,more than downpayment,0,4000
zuI4NRup,4000,12/7/2019,8900,zuI4NRup,20800,more than downpayment,more than downpayment,0,4000
zuI4NRup,4000,1/20/2020,8900,zuI4NRup,24800,more than downpayment,more than downpayment,0,4000
zuOkRqTl,10000,6/15/2017,10000,,10000,equal to downpayment,,10000,0
zuOkRqTl,3500,9/9/2017,10000,zuOkRqTl,13500,more than downpayment,equal to downpayment,0,3500
zuOkRqTl,3500,10/20/2017,10000,zuOkRqTl,17000,more than downpayment,more than downpayment,0,3500
zuOkRqTl,3500,11/24/2017,10000,zuOkRqTl,20500,more than downpayment,more than downpayment,0,3500
zuOkRqTl,3500,1/12/2018,10000,zuOkRqTl,24000,more than downpayment,more than downpayment,0,3500
zuOkRqTl,3500,2/14/2018,10000,zuOkRqTl,27500,more than downpayment,more than downpayment,0,3500
zuOkRqTl,3500,3/30/2018,10000,zuOkRqTl,31000,more than downpayment,more than downpayment,0,3500
zuOkRqTl,3500,5/3/2018,10000,zuOkRqTl,34500,more than downpayment,more than downpayment,0,3500
zuOkRqTl,9000,8/20/2018,10000,zuOkRqTl,43500,more than downpayment,more than downpayment,0,9000
zuOkRqTl,2000,12/17/2018,10000,zuOkRqTl,45500,more than downpayment,more than downpayment,0,2000
zuOkRqTl,3000,2/8/2019,10000,zuOkRqTl,48500,more than downpayment,more than downpayment,0,3000
zuOkRqTl,1500,7/19/2019,10000,zuOkRqTl,50000,more than downpayment,more than downpayment,0,1500
zuOkRqTl,2000,12/18/2019,10000,zuOkRqTl,52000,more than downpayment,more than downpayment,0,2000
ZURN8GQ6,9900,6/10/2019,8900,,9900,more than downpayment,,8900,1000
ZURN8GQ6,3900,7/24/2019,8900,ZURN8GQ6,13800,more than downpayment,more than downpayment,0,3900
ZURN8GQ6,3900,8/30/2019,8900,ZURN8GQ6,17700,more than downpayment,more than downpayment,0,3900
ZURN8GQ6,3900,10/14/2019,8900,ZURN8GQ6,21600,more than downpayment,more than downpayment,0,3900
ZURN8GQ6,3900,11/20/2019,8900,ZURN8GQ6,25500,more than downpayment,more than downpayment,0,3900
ZURN8GQ6,3900,12/5/2019,8900,ZURN8GQ6,29400,more than downpayment,more than downpayment,0,3900
ZURN8GQ6,3900,1/18/2020,8900,ZURN8GQ6,33300,more than downpayment,more than downpayment,0,3900
ZURN8GQ6,2900,2/8/2020,8900,ZURN8GQ6,36200,more than downpayment,more than downpayment,0,2900
ZVOMBGZC,9900,7/12/2019,8900,,9900,more than downpayment,,8900,1000
ZVOMBGZC,3900,9/26/2019,8900,ZVOMBGZC,13800,more than downpayment,more than downpayment,0,3900
ZVOMBGZC,3900,10/7/2019,8900,ZVOMBGZC,17700,more than downpayment,more than downpayment,0,3900
ZVOMBGZC,3900,11/12/2019,8900,ZVOMBGZC,21600,more than downpayment,more than downpayment,0,3900
ZVOMBGZC,3900,12/18/2019,8900,ZVOMBGZC,25500,more than downpayment,more than downpayment,0,3900
ZVOMBGZC,3900,1/14/2020,8900,ZVOMBGZC,29400,more than downpayment,more than downpayment,0,3900
ZW4HG2E6,9900,11/18/2019,9900,,9900,equal to downpayment,,9900,0
zWjN0Wrd,10000,11/26/2018,10000,,10000,equal to downpayment,,10000,0
zWjN0Wrd,1000,12/18/2018,10000,zWjN0Wrd,11000,more than downpayment,equal to downpayment,0,1000
zWjN0Wrd,1500,12/19/2018,10000,zWjN0Wrd,12500,more than downpayment,more than downpayment,0,1500
zWjN0Wrd,2000,12/23/2018,10000,zWjN0Wrd,14500,more than downpayment,more than downpayment,0,2000
zWjN0Wrd,4500,1/24/2019,10000,zWjN0Wrd,19000,more than downpayment,more than downpayment,0,4500
zWjN0Wrd,1700,3/4/2019,10000,zWjN0Wrd,20700,more than downpayment,more than downpayment,0,1700
zWjN0Wrd,2800,3/6/2019,10000,zWjN0Wrd,23500,more than downpayment,more than downpayment,0,2800
zWjN0Wrd,4500,3/25/2019,10000,zWjN0Wrd,28000,more than downpayment,more than downpayment,0,4500
zWjN0Wrd,800,4/25/2019,10000,zWjN0Wrd,28800,more than downpayment,more than downpayment,0,800
zWjN0Wrd,3700,4/26/2019,10000,zWjN0Wrd,32500,more than downpayment,more than downpayment,0,3700
zWjN0Wrd,4500,5/22/2019,10000,zWjN0Wrd,37000,more than downpayment,more than downpayment,0,4500
zWjN0Wrd,1000,7/3/2019,10000,zWjN0Wrd,38000,more than downpayment,more than downpayment,0,1000
zWjN0Wrd,3500,7/17/2019,10000,zWjN0Wrd,41500,more than downpayment,more than downpayment,0,3500
zWjN0Wrd,4500,7/26/2019,10000,zWjN0Wrd,46000,more than downpayment,more than downpayment,0,4500
zWjN0Wrd,4500,8/29/2019,10000,zWjN0Wrd,50500,more than downpayment,more than downpayment,0,4500
zWjN0Wrd,1500,10/1/2019,10000,zWjN0Wrd,52000,more than downpayment,more than downpayment,0,1500
zWjN0Wrd,1500,10/6/2019,10000,zWjN0Wrd,53500,more than downpayment,more than downpayment,0,1500
zWjN0Wrd,1500,10/14/2019,10000,zWjN0Wrd,55000,more than downpayment,more than downpayment,0,1500
zWjN0Wrd,4500,11/4/2019,10000,zWjN0Wrd,59500,more than downpayment,more than downpayment,0,4500
zWjN0Wrd,3500,12/16/2019,10000,zWjN0Wrd,63000,more than downpayment,more than downpayment,0,3500
zWjN0Wrd,1000,12/26/2019,10000,zWjN0Wrd,64000,more than downpayment,more than downpayment,0,1000
ZwmjbyPh,10000,5/27/2017,10000,,10000,equal to downpayment,,10000,0
ZwmjbyPh,10000,6/16/2017,10000,ZwmjbyPh,20000,more than downpayment,equal to downpayment,0,10000
ZwmjbyPh,10000,7/7/2017,10000,ZwmjbyPh,30000,more than downpayment,more than downpayment,0,10000
ZwmjbyPh,10000,7/24/2017,10000,ZwmjbyPh,40000,more than downpayment,more than downpayment,0,10000
ZwmjbyPh,4000,11/21/2017,10000,ZwmjbyPh,44000,more than downpayment,more than downpayment,0,4000
ZwmjbyPh,4000,8/20/2018,10000,ZwmjbyPh,48000,more than downpayment,more than downpayment,0,4000
ZWqd2N9P,8900,4/11/2019,8900,,8900,equal to downpayment,,8900,0
ZWqd2N9P,130,5/18/2019,8900,ZWqd2N9P,9030,more than downpayment,equal to downpayment,0,130
ZWqd2N9P,990,5/28/2019,8900,ZWqd2N9P,10020,more than downpayment,more than downpayment,0,990
ZWqd2N9P,910,6/13/2019,8900,ZWqd2N9P,10930,more than downpayment,more than downpayment,0,910
ZWqd2N9P,1000,6/22/2019,8900,ZWqd2N9P,11930,more than downpayment,more than downpayment,0,1000
ZWqd2N9P,2000,6/30/2019,8900,ZWqd2N9P,13930,more than downpayment,more than downpayment,0,2000
ZWqd2N9P,4936,7/1/2019,8900,ZWqd2N9P,18866,more than downpayment,more than downpayment,0,4936
ZWqd2N9P,1030,7/5/2019,8900,ZWqd2N9P,19896,more than downpayment,more than downpayment,0,1030
ZWqd2N9P,500,7/19/2019,8900,ZWqd2N9P,20396,more than downpayment,more than downpayment,0,500
ZWqd2N9P,113,7/24/2019,8900,ZWqd2N9P,20509,more than downpayment,more than downpayment,0,113
ZWqd2N9P,760,7/29/2019,8900,ZWqd2N9P,21269,more than downpayment,more than downpayment,0,760
ZWqd2N9P,207,9/2/2019,8900,ZWqd2N9P,21476,more than downpayment,more than downpayment,0,207
ZWqd2N9P,195,9/8/2019,8900,ZWqd2N9P,21671,more than downpayment,more than downpayment,0,195
ZWqd2N9P,1000,9/29/2019,8900,ZWqd2N9P,22671,more than downpayment,more than downpayment,0,1000
ZWqd2N9P,390,10/1/2019,8900,ZWqd2N9P,23061,more than downpayment,more than downpayment,0,390
ZWqd2N9P,600,10/6/2019,8900,ZWqd2N9P,23661,more than downpayment,more than downpayment,0,600
ZWqd2N9P,750,10/11/2019,8900,ZWqd2N9P,24411,more than downpayment,more than downpayment,0,750
ZWqd2N9P,1500,10/24/2019,8900,ZWqd2N9P,25911,more than downpayment,more than downpayment,0,1500
ZWqd2N9P,2500,11/7/2019,8900,ZWqd2N9P,28411,more than downpayment,more than downpayment,0,2500
ZWqd2N9P,1500,12/3/2019,8900,ZWqd2N9P,29911,more than downpayment,more than downpayment,0,1500
ZWqd2N9P,6300,12/28/2019,8900,ZWqd2N9P,36211,more than downpayment,more than downpayment,0,6300
ZWqd2N9P,1250,1/3/2020,8900,ZWqd2N9P,37461,more than downpayment,more than downpayment,0,1250
ZWqd2N9P,2600,1/10/2020,8900,ZWqd2N9P,40061,more than downpayment,more than downpayment,0,2600
ZWqd2N9P,1350,1/13/2020,8900,ZWqd2N9P,41411,more than downpayment,more than downpayment,0,1350
ZWqd2N9P,1350,1/23/2020,8900,ZWqd2N9P,42761,more than downpayment,more than downpayment,0,1350
ZWqd2N9P,1350,2/2/2020,8900,ZWqd2N9P,44111,more than downpayment,more than downpayment,0,1350
ZWYCXTQD,8900,11/18/2019,8900,,8900,equal to downpayment,,8900,0
ZWYCXTQD,3900,1/4/2020,8900,ZWYCXTQD,12800,more than downpayment,equal to downpayment,0,3900
ZWYCXTQD,3900,2/4/2020,8900,ZWYCXTQD,16700,more than downpayment,more than downpayment,0,3900
zxlDKdrE,9900,7/17/2019,8900,,9900,more than downpayment,,8900,1000
zxlDKdrE,2900,9/4/2019,8900,zxlDKdrE,12800,more than downpayment,more than downpayment,0,2900
zxlDKdrE,3900,10/5/2019,8900,zxlDKdrE,16700,more than downpayment,more than downpayment,0,3900
zxlDKdrE,3900,11/12/2019,8900,zxlDKdrE,20600,more than downpayment,more than downpayment,0,3900
zxlDKdrE,3900,1/2/2020,8900,zxlDKdrE,24500,more than downpayment,more than downpayment,0,3900
zxlDKdrE,3900,1/29/2020,8900,zxlDKdrE,28400,more than downpayment,more than downpayment,0,3900
Zy6VWXMD,10000,11/28/2018,9900,,10000,more than downpayment,,9900,100
Zy6VWXMD,4500,1/5/2019,9900,Zy6VWXMD,14500,more than downpayment,more than downpayment,0,4500
Zy6VWXMD,4500,2/4/2019,9900,Zy6VWXMD,19000,more than downpayment,more than downpayment,0,4500
Zy6VWXMD,4500,2/20/2019,9900,Zy6VWXMD,23500,more than downpayment,more than downpayment,0,4500
Zy6VWXMD,4500,3/22/2019,9900,Zy6VWXMD,28000,more than downpayment,more than downpayment,0,4500
Zy6VWXMD,4500,4/21/2019,9900,Zy6VWXMD,32500,more than downpayment,more than downpayment,0,4500
Zy6VWXMD,4500,5/23/2019,9900,Zy6VWXMD,37000,more than downpayment,more than downpayment,0,4500
Zy6VWXMD,4500,6/21/2019,9900,Zy6VWXMD,41500,more than downpayment,more than downpayment,0,4500
Zy6VWXMD,4500,7/11/2019,9900,Zy6VWXMD,46000,more than downpayment,more than downpayment,0,4500
Zy6VWXMD,4500,8/18/2019,9900,Zy6VWXMD,50500,more than downpayment,more than downpayment,0,4500
Zy6VWXMD,4500,9/20/2019,9900,Zy6VWXMD,55000,more than downpayment,more than downpayment,0,4500
Zy6VWXMD,4500,10/22/2019,9900,Zy6VWXMD,59500,more than downpayment,more than downpayment,0,4500
Zy6VWXMD,5000,11/22/2019,9900,Zy6VWXMD,64500,more than downpayment,more than downpayment,0,5000
Zy6VWXMD,5000,12/12/2019,9900,Zy6VWXMD,69500,more than downpayment,more than downpayment,0,5000
Zy6VWXMD,5000,1/23/2020,9900,Zy6VWXMD,74500,more than downpayment,more than downpayment,0,5000
Zy6VWXMD,2900,2/7/2020,9900,Zy6VWXMD,77400,more than downpayment,more than downpayment,0,2900
ZY92Hb2S,10000,6/12/2019,26250,,10000,less than downpayment,,10000,0
ZY92Hb2S,3900,7/24/2019,26250,ZY92Hb2S,13900,less than downpayment,less than downpayment,3900,0
ZY92Hb2S,4000,9/3/2019,26250,ZY92Hb2S,17900,less than downpayment,less than downpayment,4000,0
ZY92Hb2S,3900,10/4/2019,26250,ZY92Hb2S,21800,less than downpayment,less than downpayment,3900,0
ZY92Hb2S,3900,11/7/2019,26250,ZY92Hb2S,25700,less than downpayment,less than downpayment,3900,0
ZY92Hb2S,3900,12/4/2019,26250,ZY92Hb2S,29600,more than downpayment,less than downpayment,550,3350
ZY92Hb2S,75600,12/12/2019,26250,ZY92Hb2S,105200,more than downpayment,more than downpayment,0,75600
zYqcnvHm,10000,12/8/2018,9900,,10000,more than downpayment,,9900,100
zYqcnvHm,4500,1/5/2019,9900,zYqcnvHm,14500,more than downpayment,more than downpayment,0,4500
zYqcnvHm,4500,2/2/2019,9900,zYqcnvHm,19000,more than downpayment,more than downpayment,0,4500
zYqcnvHm,5000,3/9/2019,9900,zYqcnvHm,24000,more than downpayment,more than downpayment,0,5000
zYqcnvHm,4500,4/10/2019,9900,zYqcnvHm,28500,more than downpayment,more than downpayment,0,4500
zYqcnvHm,4500,5/5/2019,9900,zYqcnvHm,33000,more than downpayment,more than downpayment,0,4500
zYqcnvHm,4500,6/7/2019,9900,zYqcnvHm,37500,more than downpayment,more than downpayment,0,4500
zYqcnvHm,9000,8/7/2019,9900,zYqcnvHm,46500,more than downpayment,more than downpayment,0,9000
zYqcnvHm,4500,9/6/2019,9900,zYqcnvHm,51000,more than downpayment,more than downpayment,0,4500
zYqcnvHm,4500,10/11/2019,9900,zYqcnvHm,55500,more than downpayment,more than downpayment,0,4500
zYqcnvHm,4500,12/17/2019,9900,zYqcnvHm,60000,more than downpayment,more than downpayment,0,4500
ZYV7POJC,9900,11/21/2019,9900,,9900,equal to downpayment,,9900,0
ZYV7POJC,3900,2/5/2020,9900,ZYV7POJC,13800,more than downpayment,equal to downpayment,0,3900
zywwPigj,10000,9/28/2017,10000,,10000,equal to downpayment,,10000,0
zywwPigj,3500,11/4/2017,10000,zywwPigj,13500,more than downpayment,equal to downpayment,0,3500
zywwPigj,36500,11/6/2017,10000,zywwPigj,50000,more than downpayment,more than downpayment,0,36500
zZgz52OW,10000,12/5/2018,9900,,10000,more than downpayment,,9900,100
zZgz52OW,4500,2/15/2019,9900,zZgz52OW,14500,more than downpayment,more than downpayment,0,4500
zZgz52OW,4500,3/16/2019,9900,zZgz52OW,19000,more than downpayment,more than downpayment,0,4500
zZgz52OW,4500,4/11/2019,9900,zZgz52OW,23500,more than downpayment,more than downpayment,0,4500
zZgz52OW,4500,5/16/2019,9900,zZgz52OW,28000,more than downpayment,more than downpayment,0,4500
zZgz52OW,4500,6/20/2019,9900,zZgz52OW,32500,more than downpayment,more than downpayment,0,4500
zZgz52OW,4500,7/16/2019,9900,zZgz52OW,37000,more than downpayment,more than downpayment,0,4500
zZgz52OW,4500,8/15/2019,9900,zZgz52OW,41500,more than downpayment,more than downpayment,0,4500
zZgz52OW,4500,9/16/2019,9900,zZgz52OW,46000,more than downpayment,more than downpayment,0,4500
zZgz52OW,4500,10/18/2019,9900,zZgz52OW,50500,more than downpayment,more than downpayment,0,4500
zZgz52OW,4500,11/17/2019,9900,zZgz52OW,55000,more than downpayment,more than downpayment,0,4500
zZgz52OW,4500,12/16/2019,9900,zZgz52OW,59500,more than downpayment,more than downpayment,0,4500
zZgz52OW,4500,1/28/2020,9900,zZgz52OW,64000,more than downpayment,more than downpayment,0,4500
zzhWPmzi,9900,6/6/2019,8900,,9900,more than downpayment,,8900,1000
zzhWPmzi,3900,7/16/2019,8900,zzhWPmzi,13800,more than downpayment,more than downpayment,0,3900
zzhWPmzi,3900,8/26/2019,8900,zzhWPmzi,17700,more than downpayment,more than downpayment,0,3900
zzhWPmzi,3900,9/25/2019,8900,zzhWPmzi,21600,more than downpayment,more than downpayment,0,3900
zzhWPmzi,3900,10/25/2019,8900,zzhWPmzi,25500,more than downpayment,more than downpayment,0,3900
zzhWPmzi,3900,11/25/2019,8900,zzhWPmzi,29400,more than downpayment,more than downpayment,0,3900
zzhWPmzi,3900,12/24/2019,8900,zzhWPmzi,33300,more than downpayment,more than downpayment,0,3900
zzhWPmzi,3900,1/25/2020,8900,zzhWPmzi,37200,more than downpayment,more than downpayment,0,3900
zZKqEyT0,76000,1/29/2019,34000,,76000,more than downpayment,,34000,42000
zZKqEyT0,10000,7/26/2019,34000,zZKqEyT0,86000,more than downpayment,more than downpayment,0,10000
zZKqEyT0,50000,8/22/2019,34000,zZKqEyT0,136000,more than downpayment,more than downpayment,0,50000
ZZPQYDDO,8900,11/26/2019,8900,,8900,equal to downpayment,,8900,0
ZZRTCXBT,8900,1/23/2020,8900,,8900,equal to downpayment,,8900,0
ZZZTJN7V,8900,10/9/2019,8900,,8900,equal to downpayment,,8900,0
ZZZTJN7V,40000,11/8/2019,8900,ZZZTJN7V,48900,more than downpayment,equal to downpayment,0,40000
ZZZTJN7V,4000,1/22/2020,8900,ZZZTJN7V,52900,more than downpayment,more than downpayment,0,4000
